ssbid_5000m,pop_tot,pop_mal,pop_fem,pop_ave2,geom_wkt
20550006450000,647,328,319,41.2,"MULTIPOLYGON(((7.468741068492247 57.968023542197926,7.459336543630983 58.01254577928637,7.543237091522114 58.017516987818,7.552539360942586 57.97298620923243,7.468741068492247 57.968023542197926)))"
20600006450000,267,132,135,40.5,"MULTIPOLYGON(((7.552539360942586 57.97298620923243,7.543237091522114 58.017516987818,7.62716530687252 58.022433139216076,7.636365207451433 57.97789391140458,7.552539360942586 57.97298620923243)))"
20650006450000,30,19,11,37.1,"MULTIPOLYGON(((7.636365207451433 57.97789391140458,7.62716530687252 58.022433139216076,7.711120893951993 58.02729419601835,7.720218313448446 57.98274661139332,7.636365207451433 57.97789391140458)))"
20250006455000,114,62,52,50.2,"MULTIPOLYGON(((6.956530753989718 57.981564476031835,6.946485422533664 58.02603212189646,7.030315633032766 58.03134197876644,7.040259122354907 57.986865218514616,6.956530753989718 57.981564476031835)))"
20300006455000,107,58,49,47,"MULTIPOLYGON(((7.040259122354907 57.986865218514616,7.030315633032766 58.03134197876644,7.114175392915725 58.03659691996527,7.124016919171879 57.99211113693188,7.040259122354907 57.986865218514616)))"
20400006455000,86,49,37,50.9,"MULTIPOLYGON(((7.207803852565544 57.99730219145673,7.198064409167948 58.04179690551575,7.281982388112998 58.04694189583364,7.291619630003467 58.002438342653754,7.207803852565544 57.99730219145673)))"
20450006455000,204,106,98,42,"MULTIPOLYGON(((7.291619630003467 58.002438342653754,7.281982388112998 58.04694189583364,7.365929035418526 58.05203185172856,7.37546395830176 58.00751955148006,7.291619630003467 58.002438342653754)))"
20500006455000,7016,3469,3547,42.6,"MULTIPOLYGON(((7.37546395830176 58.00751955148006,7.365929035418526 58.05203185172856,7.449904056102213 58.05706673440513,7.459336543630983 58.01254577928637,7.37546395830176 58.00751955148006)))"
20550006455000,5849,2923,2926,40.7,"MULTIPOLYGON(((7.459336543630983 58.01254577928637,7.449904056102213 58.05706673440513,7.533907154537768 58.06204650546402,7.543237091522114 58.017516987818,7.459336543630983 58.01254577928637)))"
20600006455000,456,247,209,40.2,"MULTIPOLYGON(((7.543237091522114 58.017516987818,7.533907154537768 58.06204650546402,7.61793803446094 58.06697112690305,7.62716530687252 58.022433139216076,7.543237091522114 58.017516987818)))"
20650006455000,302,166,136,45.4,"MULTIPOLYGON(((7.62716530687252 58.022433139216076,7.61793803446094 58.06697112690305,7.701996398975612 58.071840561118115,7.711120893951993 58.02729419601835,7.62716530687252 58.022433139216076)))"
20700006455000,551,290,261,42.2,"MULTIPOLYGON(((7.711120893951993 58.02729419601835,7.701996398975612 58.071840561118115,7.786081950559869 58.076654770904334,7.795103556408816 58.03210012116034,7.711120893951993 58.02729419601835)))"
20750006455000,1891,952,939,39.2,"MULTIPOLYGON(((7.795103556408816 58.03210012116034,7.786081950559869 58.076654770904334,7.870194391072143 58.081413719456954,7.879112997275838 58.03685087797637,7.795103556408816 58.03210012116034)))"
20800006455000,165,84,81,43.3,"MULTIPOLYGON(((7.879112997275838 58.03685087797637,7.870194391072143 58.081413719456954,7.954333421757378 58.08611737037251,7.963148918976623 58.041546430200476,7.879112997275838 58.03685087797637)))"
20850006455000,3673,1819,1854,37.3,"MULTIPOLYGON(((7.963148918976623 58.041546430200476,7.954333421757378 58.08611737037251,8.038498743253243 58.090765687649686,8.047211023331595 58.046186741967475,7.963148918976623 58.041546430200476)))"
20200006460000,2,1,1,0,"MULTIPOLYGON(((6.862685053765284 58.02066738972421,6.852507868725104 58.065124390143446,6.936410249234622 58.07049835076452,6.946485422533664 58.02603212189646,6.862685053765284 58.02066738972421)))"
20250006460000,137,67,70,36.1,"MULTIPOLYGON(((6.946485422533664 58.02603212189646,6.936410249234622 58.07049835076452,7.020342594215487 58.075817344418766,7.030315633032766 58.03134197876644,6.946485422533664 58.02603212189646)))"
20300006460000,86,49,37,44.7,"MULTIPOLYGON(((7.030315633032766 58.03134197876644,7.020342594215487 58.075817344418766,7.104304610180011 58.08108133058491,7.114175392915725 58.03659691996527,7.030315633032766 58.03134197876644)))"
20350006460000,966,497,469,40.7,"MULTIPOLYGON(((7.114175392915725 58.03659691996527,7.104304610180011 58.08108133058491,7.188296002968205 58.086290269134786,7.198064409167948 58.04179690551575,7.114175392915725 58.03659691996527)))"
20400006460000,527,282,245,41.1,"MULTIPOLYGON(((7.198064409167948 58.04179690551575,7.188296002968205 58.086290269134786,7.272316477753732 58.091444120334415,7.281982388112998 58.04694189583364,7.198064409167948 58.04179690551575)))"
20450006460000,2112,1050,1062,41,"MULTIPOLYGON(((7.281982388112998 58.04694189583364,7.272316477753732 58.091444120334415,7.356365739049812 58.09654284484521,7.365929035418526 58.05203185172856,7.281982388112998 58.04694189583364)))"
20500006460000,273,149,124,39.9,"MULTIPOLYGON(((7.365929035418526 58.05203185172856,7.356365739049812 58.09654284484521,7.440443490715256 58.10158640372495,7.449904056102213 58.05706673440513,7.365929035418526 58.05203185172856)))"
20550006460000,852,427,425,38.5,"MULTIPOLYGON(((7.449904056102213 58.05706673440513,7.440443490715256 58.10158640372495,7.524549435960483 58.10657475842886,7.533907154537768 58.06204650546402,7.449904056102213 58.05706673440513)))"
20600006460000,319,166,153,40.1,"MULTIPOLYGON(((7.533907154537768 58.06204650546402,7.524549435960483 58.10657475842886,7.608683277353574 58.11150787081071,7.61793803446094 58.06697112690305,7.533907154537768 58.06204650546402)))"
20650006460000,153,78,75,46.6,"MULTIPOLYGON(((7.61793803446094 58.06697112690305,7.608683277353574 58.11150787081071,7.692844716826381 58.116385703123804,7.701996398975612 58.071840561118115,7.61793803446094 58.06697112690305)))"
20700006460000,2974,1537,1437,32.9,"MULTIPOLYGON(((7.701996398975612 58.071840561118115,7.692844716826381 58.116385703123804,7.777033455680666 58.121208218022076,7.786081950559869 58.076654770904334,7.701996398975612 58.071840561118115)))"
20750006460000,6804,3349,3455,42,"MULTIPOLYGON(((7.786081950559869 58.076654770904334,7.777033455680666 58.121208218022076,7.861249194594276 58.12597537856108,7.870194391072143 58.081413719456954,7.786081950559869 58.076654770904334)))"
20800006460000,5062,2497,2565,38.6,"MULTIPOLYGON(((7.870194391072143 58.081413719456954,7.861249194594276 58.12597537856108,7.945491633627337 58.13068714819901,7.954333421757378 58.08611737037251,7.870194391072143 58.081413719456954)))"
20850006460000,11261,5585,5676,41.6,"MULTIPOLYGON(((7.954333421757378 58.08611737037251,7.945491633627337 58.13068714819901,8.029760472228517 58.13534349079768,8.038498743253243 58.090765687649686,7.954333421757378 58.08611737037251)))"
20900006460000,5477,2725,2752,34.3,"MULTIPOLYGON(((8.038498743253243 58.090765687649686,8.029760472228517 58.13534349079768,8.114055409241283 58.13994437062362,8.122690055596346 58.09535863569035,8.038498743253243 58.090765687649686)))"
20950006460000,386,208,178,44.3,"MULTIPOLYGON(((8.122690055596346 58.09535863569035,8.114055409241283 58.13994437062362,8.198376142910217 58.14448975234895,8.206907058228536 58.09989617930056,8.122690055596346 58.09535863569035)))"
21000006460000,420,211,209,43.6,"MULTIPOLYGON(((8.206907058228536 58.09989617930056,8.198376142910217 58.14448975234895,8.282722370887372 58.148979601052396,8.291149450003171 58.10437828369153,8.206907058228536 58.09989617930056)))"
20050006465000,506,261,245,39.8,"MULTIPOLYGON(((6.60098343869392 58.04867311756658,6.590469834513851 58.09310037073804,6.674382494955767 58.09864851106132,6.68479417167416 58.054211732045296,6.60098343869392 58.04867311756658)))"
20100006465000,1910,934,976,43.6,"MULTIPOLYGON(((6.68479417167416 58.054211732045296,6.674382494955767 58.09864851106132,6.758326123070616 58.10414171692163,6.768635745496451 58.05969550346895,6.68479417167416 58.054211732045296)))"
20150006465000,3559,1748,1811,43.6,"MULTIPOLYGON(((6.768635745496451 58.05969550346895,6.758326123070616 58.10414171692163,6.842300426290053 58.10957994646753,6.852507868725104 58.065124390143446,6.768635745496451 58.05969550346895)))"
20200006465000,291,152,139,43.5,"MULTIPOLYGON(((6.852507868725104 58.065124390143446,6.842300426290053 58.10957994646753,6.926305111351207 58.11496315823881,6.936410249234622 58.07049835076452,6.852507868725104 58.065124390143446)))"
20250006465000,287,153,134,41.2,"MULTIPOLYGON(((6.936410249234622 58.07049835076452,6.926305111351207 58.11496315823881,7.010339884302499 58.120291311167485,7.020342594215487 58.075817344418766,6.936410249234622 58.07049835076452)))"
20300006465000,982,494,488,35.2,"MULTIPOLYGON(((7.020342594215487 58.075817344418766,7.010339884302499 58.120291311167485,7.09440445050955 58.12556436457902,7.104304610180011 58.08108133058491,7.020342594215487 58.075817344418766)))"
20350006465000,82,42,40,42.9,"MULTIPOLYGON(((7.104304610180011 58.08108133058491,7.09440445050955 58.12556436457902,7.178498514661064 58.130782278193436,7.188296002968205 58.086290269134786,7.104304610180011 58.08108133058491)))"
20400006465000,119,66,53,43.5,"MULTIPOLYGON(((7.188296002968205 58.086290269134786,7.178498514661064 58.130782278193436,7.26262178077483 58.13594501212634,7.272316477753732 58.091444120334415,7.188296002968205 58.086290269134786)))"
20450006465000,441,239,202,41.2,"MULTIPOLYGON(((7.272316477753732 58.091444120334415,7.26262178077483 58.13594501212634,7.346773952203659 58.1410525268901,7.356365739049812 58.09654284484521,7.272316477753732 58.091444120334415)))"
20500006465000,94,57,37,42,"MULTIPOLYGON(((7.356365739049812 58.09654284484521,7.346773952203659 58.1410525268901,7.430954731641466 58.14610478339486,7.440443490715256 58.10158640372495,7.356365739049812 58.09654284484521)))"
20550006465000,89,46,43,41.7,"MULTIPOLYGON(((7.440443490715256 58.10158640372495,7.430954731641466 58.14610478339486,7.5151638211293 58.15110174294967,7.524549435960483 58.10657475842886,7.440443490715256 58.10158640372495)))"
20600006465000,257,137,120,39.8,"MULTIPOLYGON(((7.524549435960483 58.10657475842886,7.5151638211293 58.15110174294967,7.599400922061467 58.15604336726349,7.608683277353574 58.11150787081071,7.524549435960483 58.10657475842886)))"
20650006465000,65,34,31,35.2,"MULTIPOLYGON(((7.608683277353574 58.11150787081071,7.599400922061467 58.15604336726349,7.683665735191674 58.160929618446296,7.692844716826381 58.116385703123804,7.608683277353574 58.11150787081071)))"
20700006465000,50,30,20,44.1,"MULTIPOLYGON(((7.692844716826381 58.116385703123804,7.683665735191674 58.160929618446296,7.767957960639182 58.165760459010095,7.777033455680666 58.121208218022076,7.692844716826381 58.116385703123804)))"
20750006465000,2830,1391,1439,40.7,"MULTIPOLYGON(((7.777033455680666 58.121208218022076,7.767957960639182 58.165760459010095,7.852277297895037 58.17053585186994,7.861249194594276 58.12597537856108,7.777033455680666 58.121208218022076)))"
20800006465000,5832,2962,2870,35.7,"MULTIPOLYGON(((7.861249194594276 58.12597537856108,7.852277297895037 58.17053585186994,7.936623445828313 58.17525576034502,7.945491633627337 58.13068714819901,7.861249194594276 58.12597537856108)))"
20850006465000,34666,17085,17581,41.2,"MULTIPOLYGON(((7.945491633627337 58.13068714819901,7.936623445828313 58.17525576034502,8.020996102692393 58.179920148159596,8.029760472228517 58.13534349079768,7.945491633627337 58.13068714819901)))"
20900006465000,17249,8501,8748,38.4,"MULTIPOLYGON(((8.029760472228517 58.13534349079768,8.020996102692393 58.179920148159596,8.105394966131287 58.18452897944407,8.114055409241283 58.13994437062362,8.029760472228517 58.13534349079768)))"
20950006465000,231,123,108,47.2,"MULTIPOLYGON(((8.114055409241283 58.13994437062362,8.105394966131287 58.18452897944407,8.189819733185985 58.1890822187359,8.198376142910217 58.14448975234895,8.114055409241283 58.13994437062362)))"
21000006465000,1058,530,528,41.6,"MULTIPOLYGON(((8.198376142910217 58.14448975234895,8.189819733185985 58.1890822187359,8.274270100300836 58.193579830980696,8.282722370887372 58.148979601052396,8.198376142910217 58.14448975234895)))"
21050006465000,209,107,102,44.5,"MULTIPOLYGON(((8.282722370887372 58.148979601052396,8.274270100300836 58.193579830980696,8.358745763329981 58.198021781533065,8.36709379023864 58.15341388222028,8.282722370887372 58.148979601052396)))"
20000006470000,463,230,233,42.2,"MULTIPOLYGON(((6.506588433612872 58.08749733819323,6.49594147910845 58.131913432371334,6.57992497067517 58.13752610564591,6.590469834513851 58.09310037073804,6.506588433612872 58.08749733819323)))"
20050006470000,1278,663,615,40.7,"MULTIPOLYGON(((6.590469834513851 58.09310037073804,6.57992497067517 58.13752610564591,6.663939850447721 58.143083795240955,6.674382494955767 58.09864851106132,6.590469834513851 58.09310037073804)))"
20100006470000,1229,628,601,37.9,"MULTIPOLYGON(((6.674382494955767 58.09864851106132,6.663939850447721 58.143083795240955,6.747985825424434 58.148586458755474,6.758326123070616 58.10414171692163,6.674382494955767 58.09864851106132)))"
20150006470000,87,52,35,41.9,"MULTIPOLYGON(((6.758326123070616 58.10414171692163,6.747985825424434 58.148586458755474,6.832062601898506 58.15403405417989,6.842300426290053 58.10957994646753,6.758326123070616 58.10414171692163)))"
20200006470000,71,41,30,39.6,"MULTIPOLYGON(((6.842300426290053 58.10957994646753,6.832062601898506 58.15403405417989,6.916169885463845 58.159426539897176,6.926305111351207 58.11496315823881,6.842300426290053 58.10957994646753)))"
20250006470000,101,61,40,34.5,"MULTIPOLYGON(((6.926305111351207 58.11496315823881,6.916169885463845 58.159426539897176,7.000307381020942 58.16476387468397,7.010339884302499 58.120291311167485,6.926305111351207 58.11496315823881)))"
20300006470000,3921,1922,1999,41.4,"MULTIPOLYGON(((7.010339884302499 58.120291311167485,7.000307381020942 58.16476387468397,7.084474792782799 58.170046017711705,7.09440445050955 58.12556436457902,7.010339884302499 58.120291311167485)))"
20350006470000,2476,1256,1220,36,"MULTIPOLYGON(((7.09440445050955 58.12556436457902,7.084474792782799 58.170046017711705,7.168671824280858 58.17527292854779,7.178498514661064 58.130782278193436,7.09440445050955 58.12556436457902)))"
20400006470000,68,33,35,38.8,"MULTIPOLYGON(((7.178498514661064 58.130782278193436,7.168671824280858 58.17527292854779,7.252898178371041 58.18044456715662,7.26262178077483 58.13594501212634,7.178498514661064 58.130782278193436)))"
20450006470000,39,19,20,36.8,"MULTIPOLYGON(((7.26262178077483 58.13594501212634,7.252898178371041 58.18044456715662,7.337153557239724 58.185560893900686,7.346773952203659 58.1410525268901,7.26262178077483 58.13594501212634)))"
20500006470000,167,79,88,38.9,"MULTIPOLYGON(((7.346773952203659 58.1410525268901,7.337153557239724 58.185560893900686,7.421437662409852 58.19062186954182,7.430954731641466 58.14610478339486,7.346773952203659 58.1410525268901)))"
20550006470000,70,37,33,43.3,"MULTIPOLYGON(((7.430954731641466 58.14610478339486,7.421437662409852 58.19062186954182,7.505750194747012 58.19562745524203,7.5151638211293 58.15110174294967,7.430954731641466 58.14610478339486)))"
20600006470000,627,327,300,40.8,"MULTIPOLYGON(((7.5151638211293 58.15110174294967,7.505750194747012 58.19562745524203,7.590090854465595 58.200577612564764,7.599400922061467 58.15604336726349,7.5151638211293 58.15110174294967)))"
20650006470000,70,34,36,43,"MULTIPOLYGON(((7.599400922061467 58.15604336726349,7.590090854465595 58.200577612564764,7.674459341134971 58.20547230347586,7.683665735191674 58.160929618446296,7.599400922061467 58.15604336726349)))"
20700006470000,70,35,35,47.9,"MULTIPOLYGON(((7.683665735191674 58.160929618446296,7.674459341134971 58.20547230347586,7.75885535368569 58.210311490344694,7.767957960639182 58.165760459010095,7.683665735191674 58.160929618446296)))"
20750006470000,1171,620,551,37.5,"MULTIPOLYGON(((7.767957960639182 58.165760459010095,7.75885535368569 58.210311490344694,7.843278590415763 58.2150951359451,7.852277297895037 58.17053585186994,7.767957960639182 58.165760459010095)))"
20800006470000,2326,1198,1128,37.4,"MULTIPOLYGON(((7.852277297895037 58.17053585186994,7.843278590415763 58.2150951359451,7.927728748996921 58.219823203456464,7.936623445828313 58.17525576034502,7.852277297895037 58.17053585186994)))"
20850006470000,967,495,472,37.9,"MULTIPOLYGON(((7.936623445828313 58.17525576034502,7.927728748996921 58.219823203456464,8.012205526480953 58.22449565646479,8.020996102692393 58.179920148159596,7.936623445828313 58.17525576034502)))"
20900006470000,6614,3338,3276,33.6,"MULTIPOLYGON(((8.020996102692393 58.179920148159596,8.012205526480953 58.22449565646479,8.09670861930605 58.22911245896363,8.105394966131287 58.18452897944407,8.020996102692393 58.179920148159596)))"
20950006470000,1151,589,562,38.5,"MULTIPOLYGON(((8.105394966131287 58.18452897944407,8.09670861930605 58.22911245896363,8.181237723303228 58.2336735753551,8.189819733185985 58.1890822187359,8.105394966131287 58.18452897944407)))"
21000006470000,237,131,106,39.6,"MULTIPOLYGON(((8.189819733185985 58.1890822187359,8.181237723303228 58.2336735753551,8.265792533702715 58.23817897045093,8.274270100300836 58.193579830980696,8.189819733185985 58.1890822187359)))"
21050006470000,687,362,325,36.8,"MULTIPOLYGON(((8.274270100300836 58.193579830980696,8.265792533702715 58.23817897045093,8.350372745140444 58.24262860947337,8.358745763329981 58.198021781533065,8.274270100300836 58.193579830980696)))"
21100006470000,2065,993,1072,40.5,"MULTIPOLYGON(((8.358745763329981 58.198021781533065,8.350372745140444 58.24262860947337,8.434978051664533 58.24702245805618,8.443246417543794 58.20240803615768,8.358745763329981 58.198021781533065)))"
20050006475000,43,24,19,40.4,"MULTIPOLYGON(((6.57992497067517 58.13752610564591,6.569348718512155 58.181950317458586,6.653466110617987 58.187517579849874,6.663939850447721 58.143083795240955,6.57992497067517 58.13752610564591)))"
20100006475000,60,24,36,42.7,"MULTIPOLYGON(((6.663939850447721 58.143083795240955,6.653466110617987 58.187517579849874,6.737614726164341 58.193029724332675,6.747985825424434 58.148586458755474,6.663939850447721 58.143083795240955)))"
20150006475000,123,60,63,38.7,"MULTIPOLYGON(((6.747985825424434 58.148586458755474,6.737614726164341 58.193029724332675,6.82179427030012 58.19848670873838,6.832062601898506 58.15403405417989,6.747985825424434 58.148586458755474)))"
20200006475000,28,16,12,50.1,"MULTIPOLYGON(((6.832062601898506 58.15403405417989,6.82179427030012 58.19848670873838,6.906004447470138 58.20388849129238,6.916169885463845 58.159426539897176,6.832062601898506 58.15403405417989)))"
20250006475000,40,24,16,41.2,"MULTIPOLYGON(((6.916169885463845 58.159426539897176,6.906004447470138 58.20388849129238,6.990244961421036 58.20923503061506,7.000307381020942 58.16476387468397,6.916169885463845 58.159426539897176)))"
20300006475000,236,126,110,35.8,"MULTIPOLYGON(((7.000307381020942 58.16476387468397,6.990244961421036 58.20923503061506,7.074515515207238 58.214526285723096,7.084474792782799 58.170046017711705,7.000307381020942 58.16476387468397)))"
20350006475000,141,69,72,35.9,"MULTIPOLYGON(((7.084474792782799 58.170046017711705,7.074515515207238 58.214526285723096,7.158815811196948 58.21976221603039,7.168671824280858 58.17527292854779,7.084474792782799 58.170046017711705)))"
20400006475000,16,6,10,37,"MULTIPOLYGON(((7.168671824280858 58.17527292854779,7.158815811196948 58.21976221603039,7.243145551078168 58.22494278134937,7.252898178371041 58.18044456715662,7.168671824280858 58.17527292854779)))"
20450006475000,30,15,15,38,"MULTIPOLYGON(((7.252898178371041 58.18044456715662,7.243145551078168 58.22494278134937,7.32750443586479 58.23006794189192,7.337153557239724 58.185560893900686,7.252898178371041 58.18044456715662)))"
20500006475000,232,121,111,39.1,"MULTIPOLYGON(((7.337153557239724 58.185560893900686,7.32750443586479 58.23006794189192,7.411892165902668 58.23513765827067,7.421437662409852 58.19062186954182,7.337153557239724 58.185560893900686)))"
20550006475000,65,31,34,44.6,"MULTIPOLYGON(((7.421437662409852 58.19062186954182,7.411892165902668 58.23513765827067,7.496308440875793 58.240151891499885,7.505750194747012 58.19562745524203,7.421437662409852 58.19062186954182)))"
20600006475000,425,223,202,41.7,"MULTIPOLYGON(((7.505750194747012 58.19562745524203,7.496308440875793 58.240151891499885,7.58075295981246 58.2451106029967,7.590090854465595 58.200577612564764,7.505750194747012 58.19562745524203)))"
20650006475000,80,38,42,46.5,"MULTIPOLYGON(((7.590090854465595 58.200577612564764,7.58075295981246 58.2451106029967,7.665225421091481 58.25001375458212,7.674459341134971 58.20547230347586,7.590090854465595 58.200577612564764)))"
20700006475000,65,37,28,36.5,"MULTIPOLYGON(((7.674459341134971 58.20547230347586,7.665225421091481 58.25001375458212,7.749725522448466 58.254861308482035,7.75885535368569 58.210311490344694,7.674459341134971 58.20547230347586)))"
20750006475000,181,93,88,40.4,"MULTIPOLYGON(((7.75885535368569 58.210311490344694,7.749725522448466 58.254861308482035,7.834252960982076 58.25965322732833,7.843278590415763 58.2150951359451,7.75885535368569 58.210311490344694)))"
20800006475000,930,495,435,38.3,"MULTIPOLYGON(((7.843278590415763 58.2150951359451,7.834252960982076 58.25965322732833,7.918807433160391 58.264389474159934,7.927728748996921 58.219823203456464,7.843278590415763 58.2150951359451)))"
20850006475000,6732,3442,3290,36.6,"MULTIPOLYGON(((7.927728748996921 58.219823203456464,7.918807433160391 58.264389474159934,8.003388634827237 58.269070012423796,8.012205526480953 58.22449565646479,7.927728748996921 58.219823203456464)))"
20900006475000,265,137,128,43.1,"MULTIPOLYGON(((8.012205526480953 58.22449565646479,8.003388634827237 58.269070012423796,8.08799626120861 58.27369480597588,8.09670861930605 58.22911245896363,8.012205526480953 58.22449565646479)))"
20950006475000,1112,575,537,37.4,"MULTIPOLYGON(((8.09670861930605 58.22911245896363,8.08799626120861 58.27369480597588,8.172630006919102 58.27826381908232,8.181237723303228 58.2336735753551,8.09670861930605 58.22911245896363)))"
21000006475000,55,32,23,43.9,"MULTIPOLYGON(((8.181237723303228 58.2336735753551,8.172630006919102 58.27826381908232,8.25728956596838 58.28277701642015,8.265792533702715 58.23817897045093,8.181237723303228 58.2336735753551)))"
21050006475000,230,117,113,35.8,"MULTIPOLYGON(((8.265792533702715 58.23817897045093,8.25728956596838 58.28277701642015,8.341974631767663 58.28723436307862,8.350372745140444 58.24262860947337,8.265792533702715 58.23817897045093)))"
21100006475000,6268,3141,3127,41.5,"MULTIPOLYGON(((8.350372745140444 58.24262860947337,8.341974631767663 58.28723436307862,8.426684897136285 58.29163582455987,8.434978051664533 58.24702245805618,8.350372745140444 58.24262860947337)))"
21150006475000,984,476,508,40.1,"MULTIPOLYGON(((8.434978051664533 58.24702245805618,8.426684897136285 58.29163582455987,8.511420054308264 58.295981366780104,8.519608146741824 58.251360482245595,8.434978051664533 58.24702245805618)))"
21200006475000,107,53,54,38.7,"MULTIPOLYGON(((8.519608146741824 58.251360482245595,8.511420054308264 58.295981366780104,8.5961797949389 58.30027095607037,8.604262723264435 58.25564264850128,8.519608146741824 58.251360482245595)))"
20000006480000,4,3,1,0,"MULTIPOLYGON(((6.485262843987998 58.176327979720135,6.474552397740261 58.220740975282,6.558740948648174 58.22637300131704,6.569348718512155 58.181950317458586,6.485262843987998 58.176327979720135)))"
20050006480000,156,78,78,44.5,"MULTIPOLYGON(((6.569348718512155 58.181950317458586,6.558740948648174 58.22637300131704,6.642961147229396 58.23194986012688,6.653466110617987 58.187517579849874,6.569348718512155 58.181950317458586)))"
20100006480000,77,43,34,50.3,"MULTIPOLYGON(((6.653466110617987 58.187517579849874,6.642961147229396 58.23194986012688,6.727212698197476 58.23747150898899,6.737614726164341 58.193029724332675,6.653466110617987 58.187517579849874)))"
20150006480000,39,18,21,52.9,"MULTIPOLYGON(((6.737614726164341 58.193029724332675,6.727212698197476 58.23747150898899,6.811495305551138 58.24293790557498,6.82179427030012 58.19848670873838,6.737614726164341 58.193029724332675)))"
20200006480000,32,16,16,48.7,"MULTIPOLYGON(((6.82179427030012 58.19848670873838,6.811495305551138 58.24293790557498,6.895808672580185 58.24834900795178,6.906004447470138 58.20388849129238,6.82179427030012 58.19848670873838)))"
20250006480000,21,12,9,24.1,"MULTIPOLYGON(((6.906004447470138 58.20388849129238,6.895808672580185 58.24834900795178,6.980152501871451 58.25370477458278,6.990244961421036 58.20923503061506,6.906004447470138 58.20388849129238)))"
20300006480000,16,10,6,37.4,"MULTIPOLYGON(((6.990244961421036 58.20923503061506,6.980152501871451 58.25370477458278,7.064526495314807 58.259005164328926,7.074515515207238 58.214526285723096,6.990244961421036 58.20923503061506)))"
20350006480000,61,33,28,43,"MULTIPOLYGON(((7.074515515207238 58.214526285723096,7.064526495314807 58.259005164328926,7.148930354109164 58.26425013644996,7.158815811196948 58.21976221603039,7.074515515207238 58.214526285723096)))"
20400006480000,329,173,156,37.4,"MULTIPOLYGON(((7.158815811196948 58.21976221603039,7.148930354109164 58.26425013644996,7.233363778768565 58.269439650605435,7.243145551078168 58.22494278134937,7.158815811196948 58.21976221603039)))"
20450006480000,40,20,20,43.9,"MULTIPOLYGON(((7.243145551078168 58.22494278134937,7.233363778768565 58.269439650605435,7.317826469128282 58.274573666855886,7.32750443586479 58.23006794189192,7.243145551078168 58.22494278134937)))"
20500006480000,166,89,77,39.8,"MULTIPOLYGON(((7.32750443586479 58.23006794189192,7.317826469128282 58.274573666855886,7.402318124350956 58.27965214566393,7.411892165902668 58.23513765827067,7.32750443586479 58.23006794189192)))"
20550006480000,104,60,44,40.7,"MULTIPOLYGON(((7.411892165902668 58.23513765827067,7.402318124350956 58.27965214566393,7.486838442932787 58.28467504789535,7.496308440875793 58.240151891499885,7.411892165902668 58.23513765827067)))"
20600006480000,230,117,113,42.8,"MULTIPOLYGON(((7.496308440875793 58.240151891499885,7.486838442932787 58.28467504789535,7.571387122709757 58.28964233482016,7.58075295981246 58.2451106029967,7.496308440875793 58.240151891499885)))"
20650006480000,517,276,241,37.1,"MULTIPOLYGON(((7.58075295981246 58.2451106029967,7.571387122709757 58.28964233482016,7.655963860863881 58.294553968113746,7.665225421091481 58.25001375458212,7.58075295981246 58.2451106029967)))"
20700006480000,234,123,111,38.2,"MULTIPOLYGON(((7.665225421091481 58.25001375458212,7.655963860863881 58.294553968113746,7.740568353929509 58.29940990985781,7.749725522448466 58.254861308482035,7.665225421091481 58.25001375458212)))"
20750006480000,459,237,222,37.3,"MULTIPOLYGON(((7.749725522448466 58.254861308482035,7.740568353929509 58.29940990985781,7.825200297799651 58.30421012254152,7.834252960982076 58.25965322732833,7.749725522448466 58.254861308482035)))"
20800006480000,1085,560,525,33.8,"MULTIPOLYGON(((7.834252960982076 58.25965322732833,7.825200297799651 58.30421012254152,7.909859387732354 58.308954569062564,7.918807433160391 58.264389474159934,7.834252960982076 58.25965322732833)))"
20850006480000,5679,2794,2885,42.5,"MULTIPOLYGON(((7.918807433160391 58.264389474159934,7.909859387732354 58.308954569062564,7.99454531835709 58.31364321272811,8.003388634827237 58.269070012423796,7.918807433160391 58.264389474159934)))"
20900006480000,255,131,124,36.8,"MULTIPOLYGON(((8.003388634827237 58.269070012423796,7.99454531835709 58.31364321272811,8.079257783681223 58.31827601725588,8.08799626120861 58.27369480597588,8.003388634827237 58.269070012423796)))"
20950006480000,92,43,49,36.9,"MULTIPOLYGON(((8.08799626120861 58.27369480597588,8.079257783681223 58.31827601725588,8.163996477096466 58.32285294677516,8.172630006919102 58.27826381908232,8.08799626120861 58.27369480597588)))"
21000006480000,1663,864,799,35.1,"MULTIPOLYGON(((8.172630006919102 58.27826381908232,8.163996477096466 58.32285294677516,8.248761091385386 58.327373965827725,8.25728956596838 58.28277701642015,8.172630006919102 58.27826381908232)))"
21050006480000,59,28,31,38.7,"MULTIPOLYGON(((8.25728956596838 58.28277701642015,8.248761091385386 58.327373965827725,8.333551318727983 58.331839039369015,8.341974631767663 58.28723436307862,8.25728956596838 58.28277701642015)))"
21100006480000,52,30,22,36.4,"MULTIPOLYGON(((8.341974631767663 58.28723436307862,8.333551318727983 58.331839039369015,8.418366850708226 58.336248132768894,8.426684897136285 58.29163582455987,8.341974631767663 58.28723436307862)))"
21150006480000,228,112,116,40.2,"MULTIPOLYGON(((8.426684897136285 58.29163582455987,8.418366850708226 58.336248132768894,8.503207378320699 58.340601211812796,8.511420054308264 58.295981366780104,8.426684897136285 58.29163582455987)))"
21200006480000,8444,4324,4120,37.8,"MULTIPOLYGON(((8.511420054308264 58.295981366780104,8.503207378320699 58.340601211812796,8.588072591977252 58.34489824270254,8.5961797949389 58.30027095607037,8.511420054308264 58.295981366780104)))"
21250006480000,2022,1014,1008,45.1,"MULTIPOLYGON(((8.5961797949389 58.30027095607037,8.588072591977252 58.34489824270254,8.672962181513657 58.34913919205745,8.68096381011142 58.30450455917773,8.5961797949389 58.30027095607037)))"
20000006485000,277,139,138,43.9,"MULTIPOLYGON(((6.474552397740261 58.220740975282,6.463810009132374 58.26515241407114,6.548101530990764 58.270794152334624,6.558740948648174 58.22637300131704,6.474552397740261 58.220740975282)))"
20050006485000,125,68,57,48.9,"MULTIPOLYGON(((6.558740948648174 58.22637300131704,6.548101530990764 58.270794152334624,6.632424831334807 58.27638063128368,6.642961147229396 58.23194986012688,6.558740948648174 58.22637300131704)))"
20100006485000,215,114,101,43.2,"MULTIPOLYGON(((6.642961147229396 58.23194986012688,6.632424831334807 58.27638063128368,6.716779613726875 58.28191180803375,6.727212698197476 58.23747150898899,6.642961147229396 58.23194986012688)))"
20150006485000,69,35,34,39.2,"MULTIPOLYGON(((6.727212698197476 58.23747150898899,6.716779613726875 58.28191180803375,6.801165581009605 58.28738764009577,6.811495305551138 58.24293790557498,6.727212698197476 58.23747150898899)))"
20200006485000,646,326,320,42.6,"MULTIPOLYGON(((6.811495305551138 58.24293790557498,6.801165581009605 58.28738764009577,6.88558243531184 58.292808085377395,6.895808672580185 58.24834900795178,6.811495305551138 58.24293790557498)))"
20250006485000,469,249,220,38.8,"MULTIPOLYGON(((6.895808672580185 58.24834900795178,6.88558243531184 58.292808085377395,6.970029878054621 58.29817310218414,6.980152501871451 58.25370477458278,6.895808672580185 58.24834900795178)))"
20300006485000,35,15,20,39.5,"MULTIPOLYGON(((6.980152501871451 58.25370477458278,6.970029878054621 58.29817310218414,7.054507609957224 58.30348264922052,7.064526495314807 58.259005164328926,6.980152501871451 58.25370477458278)))"
20350006485000,12,9,3,38.3,"MULTIPOLYGON(((7.064526495314807 58.259005164328926,7.054507609957224 58.30348264922052,7.139015331043205 58.30873668559122,7.148930354109164 58.26425013644996,7.064526495314807 58.259005164328926)))"
20400006485000,49,25,24,43.7,"MULTIPOLYGON(((7.148930354109164 58.26425013644996,7.139015331043205 58.30873668559122,7.223552740646544 58.31393517080216,7.233363778768565 58.269439650605435,7.148930354109164 58.26425013644996)))"
20450006485000,8,4,4,48.9,"MULTIPOLYGON(((7.233363778768565 58.269439650605435,7.223552740646544 58.31393517080216,7.308119537417738 58.319078064761705,7.317826469128282 58.274573666855886,7.233363778768565 58.269439650605435)))"
20500006485000,579,297,282,41.4,"MULTIPOLYGON(((7.317826469128282 58.274573666855886,7.308119537417738 58.319078064761705,7.392715419330044 58.32416532778166,7.402318124350956 58.27965214566393,7.317826469128282 58.274573666855886)))"
20550006485000,64,36,28,38.9,"MULTIPOLYGON(((7.402318124350956 58.27965214566393,7.392715419330044 58.32416532778166,7.477340083685646 58.32919692057854,7.486838442932787 58.28467504789535,7.402318124350956 58.27965214566393)))"
20600006485000,96,57,39,42.8,"MULTIPOLYGON(((7.486838442932787 58.28467504789535,7.477340083685646 58.32919692057854,7.561993227121956 58.33417280427449,7.571387122709757 58.28964233482016,7.486838442932787 58.28467504789535)))"
20650006485000,179,93,86,38.5,"MULTIPOLYGON(((7.571387122709757 58.28964233482016,7.561993227121956 58.33417280427449,7.64667454561789 58.33909294039842,7.655963860863881 58.294553968113746,7.571387122709757 58.28964233482016)))"
20700006485000,97,47,50,36.7,"MULTIPOLYGON(((7.655963860863881 58.294553968113746,7.64667454561789 58.33909294039842,7.731383734500213 58.343957290887175,7.740568353929509 58.29940990985781,7.655963860863881 58.294553968113746)))"
20750006485000,184,97,87,37.5,"MULTIPOLYGON(((7.740568353929509 58.29940990985781,7.731383734500213 58.343957290887175,7.816120488449907 58.34876581808645,7.825200297799651 58.30421012254152,7.740568353929509 58.29940990985781)))"
20800006485000,165,82,83,37,"MULTIPOLYGON(((7.825200297799651 58.30421012254152,7.816120488449907 58.34876581808645,7.900884501508588 58.353518484751866,7.909859387732354 58.308954569062564,7.825200297799651 58.30421012254152)))"
20850006485000,170,86,84,39.2,"MULTIPOLYGON(((7.909859387732354 58.308954569062564,7.900884501508588 58.353518484751866,7.985675467084941 58.35821525405012,7.99454531835709 58.31364321272811,7.909859387732354 58.308954569062564)))"
20900006485000,348,192,156,38.1,"MULTIPOLYGON(((7.99454531835709 58.31364321272811,7.985675467084941 58.35821525405012,8.070493077961206 58.36285608955995,8.079257783681223 58.31827601725588,7.99454531835709 58.31364321272811)))"
20950006485000,25,12,13,36.5,"MULTIPOLYGON(((8.079257783681223 58.31827601725588,8.070493077961206 58.36285608955995,8.155337026299708 58.36744095527303,8.163996477096466 58.32285294677516,8.079257783681223 58.31827601725588)))"
21000006485000,2091,1054,1037,40.8,"MULTIPOLYGON(((8.163996477096466 58.32285294677516,8.155337026299708 58.36744095527303,8.240207003649394 58.37196981559524,8.248761091385386 58.327373965827725,8.163996477096466 58.32285294677516)))"
21050006485000,179,87,92,38.8,"MULTIPOLYGON(((8.248761091385386 58.327373965827725,8.240207003649394 58.37196981559524,8.325102700952423 58.37644263534741,8.333551318727983 58.331839039369015,8.248761091385386 58.327373965827725)))"
21100006485000,66,37,29,37.6,"MULTIPOLYGON(((8.333551318727983 58.331839039369015,8.325102700952423 58.37644263534741,8.410023808550806 58.38085937976648,8.418366850708226 58.336248132768894,8.333551318727983 58.331839039369015)))"
21150006485000,210,104,106,36.5,"MULTIPOLYGON(((8.418366850708226 58.336248132768894,8.410023808550806 58.38085937976648,8.494970016193053 58.385220014506366,8.503207378320699 58.340601211812796,8.418366850708226 58.336248132768894)))"
21200006485000,3162,1618,1544,37.7,"MULTIPOLYGON(((8.503207378320699 58.340601211812796,8.494970016193053 58.385220014506366,8.579941013040854 58.38952450563902,8.588072591977252 58.34489824270254,8.503207378320699 58.340601211812796)))"
21250006485000,4981,2490,2491,39,"MULTIPOLYGON(((8.588072591977252 58.34489824270254,8.579941013040854 58.38952450563902,8.664936487675838 58.3937728196553,8.672962181513657 58.34913919205745,8.588072591977252 58.34489824270254)))"
21300006485000,3578,1757,1821,41.7,"MULTIPOLYGON(((8.672962181513657 58.34913919205745,8.664936487675838 58.3937728196553,8.749956128106296 58.39796492346597,8.75787583619635 58.3533240269151,8.672962181513657 58.34913919205745)))"
19950006490000,201,98,103,46.1,"MULTIPOLYGON(((6.379550561471623 58.25945545977219,6.368672964570835 58.30385550837769,6.453035546204929 58.309562291073526,6.463810009132374 58.26515241407114,6.379550561471623 58.25945545977219)))"
20000006490000,72,41,31,40.3,"MULTIPOLYGON(((6.463810009132374 58.26515241407114,6.453035546204929 58.309562291073526,6.537430334726758 58.31521376559695,6.548101530990764 58.270794152334624,6.463810009132374 58.26515241407114)))"
20050006490000,47,27,20,43.7,"MULTIPOLYGON(((6.548101530990764 58.270794152334624,6.537430334726758 58.31521376559695,6.621857033272236 58.32080988850478,6.632424831334807 58.27638063128368,6.548101530990764 58.270794152334624)))"
20100006490000,6427,3178,3249,41.5,"MULTIPOLYGON(((6.632424831334807 58.27638063128368,6.621857033272236 58.32080988850478,6.706315344246652 58.326350616749494,6.716779613726875 58.28191180803375,6.632424831334807 58.27638063128368)))"
20150006490000,51,28,23,39.7,"MULTIPOLYGON(((6.716779613726875 58.28191180803375,6.706315344246652 58.326350616749494,6.790804969330605 58.331835907680514,6.801165581009605 58.28738764009577,6.716779613726875 58.28191180803375)))"
20200006490000,18,7,11,33.8,"MULTIPOLYGON(((6.801165581009605 58.28738764009577,6.790804969330605 58.331835907680514,6.875325609485987 58.337265719045426,6.88558243531184 58.292808085377395,6.801165581009605 58.28738764009577)))"
20250006490000,1533,718,815,43.7,"MULTIPOLYGON(((6.88558243531184 58.292808085377395,6.875325609485987 58.337265719045426,6.95987696496202 58.34264000899105,6.970029878054621 58.29817310218414,6.88558243531184 58.292808085377395)))"
20300006490000,1498,764,734,41,"MULTIPOLYGON(((6.970029878054621 58.29817310218414,6.95987696496202 58.34264000899105,7.044458735301321 58.34795873606456,7.054507609957224 58.30348264922052,6.970029878054621 58.29817310218414)))"
20350006490000,26,13,13,36.8,"MULTIPOLYGON(((7.054507609957224 58.30348264922052,7.044458735301321 58.34795873606456,7.129070619345991 58.353221859214834,7.139015331043205 58.30873668559122,7.054507609957224 58.30348264922052)))"
20400006490000,162,75,87,41.1,"MULTIPOLYGON(((7.139015331043205 58.30873668559122,7.129070619345991 58.353221859214834,7.213712315243779 58.35842933779331,7.223552740646544 58.31393517080216,7.139015331043205 58.30873668559122)))"
20450006490000,58,30,28,34.6,"MULTIPOLYGON(((7.223552740646544 58.31393517080216,7.213712315243779 58.35842933779331,7.298383520454256 58.36358113155536,7.308119537417738 58.319078064761705,7.223552740646544 58.31393517080216)))"
20500006490000,108,61,47,38.1,"MULTIPOLYGON(((7.308119537417738 58.319078064761705,7.298383520454256 58.36358113155536,7.383083931755038 58.36867720066129,7.392715419330044 58.32416532778166,7.308119537417738 58.319078064761705)))"
20550006490000,104,51,53,35.3,"MULTIPOLYGON(((7.392715419330044 58.32416532778166,7.383083931755038 58.36867720066129,7.467813245248051 58.373717505677455,7.477340083685646 58.32919692057854,7.392715419330044 58.32416532778166)))"
20600006490000,50,26,24,47.5,"MULTIPOLYGON(((7.477340083685646 58.32919692057854,7.467813245248051 58.373717505677455,7.552571156365833 58.37870200757735,7.561993227121956 58.33417280427449,7.477340083685646 58.32919692057854)))"
20650006490000,59,37,22,37.7,"MULTIPOLYGON(((7.561993227121956 58.33417280427449,7.552571156365833 58.37870200757735,7.637357359877877 58.38363066774272,7.64667454561789 58.33909294039842,7.561993227121956 58.33417280427449)))"
20700006490000,71,40,31,43.8,"MULTIPOLYGON(((7.64667454561789 58.33909294039842,7.637357359877877 58.38363066774272,7.72217154989698 58.38850344796468,7.731383734500213 58.343957290887175,7.64667454561789 58.33909294039842)))"
20750006490000,435,208,227,42,"MULTIPOLYGON(((7.731383734500213 58.343957290887175,7.72217154989698 58.38850344796468,7.807013419885688 58.3933203104447,7.816120488449907 58.34876581808645,7.731383734500213 58.343957290887175)))"
20800006490000,17,11,6,41.1,"MULTIPOLYGON(((7.816120488449907 58.34876581808645,7.807013419885688 58.3933203104447,7.891882662662742 58.398081217795635,7.900884501508588 58.353518484751866,7.816120488449907 58.34876581808645)))"
20850006490000,131,65,66,42,"MULTIPOLYGON(((7.900884501508588 58.353518484751866,7.891882662662742 58.398081217795635,7.97677897040955 58.40278613304297,7.985675467084941 58.35821525405012,7.900884501508588 58.353518484751866)))"
20900006490000,66,35,31,41.3,"MULTIPOLYGON(((7.985675467084941 58.35821525405012,7.97677897040955 58.40278613304297,8.061702034676728 58.4074350196256,8.070493077961206 58.36285608955995,7.985675467084941 58.35821525405012)))"
20950006490000,39,21,18,44,"MULTIPOLYGON(((8.070493077961206 58.36285608955995,8.061702034676728 58.4074350196256,8.146651546390638 58.41202784139707,8.155337026299708 58.36744095527303,8.070493077961206 58.36285608955995)))"
21000006490000,62,33,29,40.2,"MULTIPOLYGON(((8.155337026299708 58.36744095527303,8.146651546390638 58.41202784139707,8.231627195860021 58.41656456262639,8.240207003649394 58.37196981559524,8.155337026299708 58.36744095527303)))"
21050006490000,77,42,35,41.4,"MULTIPOLYGON(((8.240207003649394 58.37196981559524,8.231627195860021 58.41656456262639,8.316628672782592 58.42104514799922,8.325102700952423 58.37644263534741,8.240207003649394 58.37196981559524)))"
21100006490000,19,10,9,42.4,"MULTIPOLYGON(((8.325102700952423 58.37644263534741,8.316628672782592 58.42104514799922,8.401655666251727 58.42546956261883,8.410023808550806 58.38085937976648,8.325102700952423 58.37644263534741)))"
21150006490000,47,20,27,37.5,"MULTIPOLYGON(((8.410023808550806 58.38085937976648,8.401655666251727 58.42546956261883,8.486707864763158 58.42983777200695,8.494970016193053 58.385220014506366,8.410023808550806 58.38085937976648)))"
21200006490000,132,73,59,39.2,"MULTIPOLYGON(((8.494970016193053 58.385220014506366,8.486707864763158 58.42983777200695,8.571784956221725 58.43414974210488,8.579941013040854 58.38952450563902,8.494970016193053 58.385220014506366)))"
21250006490000,1542,801,741,39.2,"MULTIPOLYGON(((8.579941013040854 58.38952450563902,8.571784956221725 58.43414974210488,8.656886627948117 58.438405439274405,8.664936487675838 58.3937728196553,8.579941013040854 58.38952450563902)))"
21300006490000,7185,3564,3621,41,"MULTIPOLYGON(((8.664936487675838 58.3937728196553,8.656886627948117 58.438405439274405,8.74201256668571 58.44260483029879,8.749956128106296 58.39796492346597,8.664936487675838 58.3937728196553)))"
21350006490000,2605,1298,1307,43.9,"MULTIPOLYGON(((8.749956128106296 58.39796492346597,8.74201256668571 58.44260483029879,8.827162458607383 58.446747882383605,8.834999621774006 58.40210078440262,8.749956128106296 58.39796492346597)))"
21400006490000,70,32,38,44.8,"MULTIPOLYGON(((8.834999621774006 58.40210078440262,8.827162458607383 58.446747882383605,8.9123359893224 58.450834563157784,8.920066655561042 58.40618037021858,8.834999621774006 58.40210078440262)))"
19850006495000,170,88,82,46.5,"MULTIPOLYGON(((6.200045605733663 58.29227619421317,6.188929050376707 58.336654669785325,6.27332949038994 58.34248197385671,6.284342885952032 58.29809346134719,6.200045605733663 58.29227619421317)))"
19900006495000,1309,659,650,39.7,"MULTIPOLYGON(((6.284342885952032 58.29809346134719,6.27332949038994 58.34248197385671,6.357762864531033 58.34825396581013,6.368672964570835 58.30385550837769,6.284342885952032 58.29809346134719)))"
20000006495000,2,1,1,0,"MULTIPOLYGON(((6.453035546204929 58.309562291073526,6.442228876266996 58.353970601246566,6.52672722831733 58.35963183616172,6.537430334726758 58.31521376559695,6.453035546204929 58.309562291073526)))"
20050006495000,5,3,2,36,"MULTIPOLYGON(((6.537430334726758 58.31521376559695,6.52672722831733 58.35963183616172,6.611257622659952 58.36523762694721,6.621857033272236 58.32080988850478,6.537430334726758 58.31521376559695)))"
20100006495000,282,155,127,47.6,"MULTIPOLYGON(((6.621857033272236 58.32080988850478,6.611257622659952 58.36523762694721,6.695819760537112 58.37078793039185,6.706315344246652 58.326350616749494,6.621857033272236 58.32080988850478)))"
20150006495000,65,33,32,40,"MULTIPOLYGON(((6.706315344246652 58.326350616749494,6.695819760537112 58.37078793039185,6.78041334246139 58.37628270368268,6.790804969330605 58.331835907680514,6.706315344246652 58.326350616749494)))"
20200006495000,169,94,75,38.6,"MULTIPOLYGON(((6.790804969330605 58.331835907680514,6.78041334246139 58.37628270368268,6.865038068221711 58.38172190440631,6.875325609485987 58.337265719045426,6.790804969330605 58.331835907680514)))"
20250006495000,25,16,9,41.6,"MULTIPOLYGON(((6.875325609485987 58.337265719045426,6.865038068221711 58.38172190440631,6.949693636889407 58.38710549055001,6.95987696496202 58.34264000899105,6.875325609485987 58.337265719045426)))"
20300006495000,710,373,337,38.6,"MULTIPOLYGON(((6.95987696496202 58.34264000899105,6.949693636889407 58.38710549055001,7.034379746824325 58.39243342050288,7.044458735301321 58.34795873606456,6.95987696496202 58.34264000899105)))"
20350006495000,72,41,31,34.3,"MULTIPOLYGON(((7.044458735301321 58.34795873606456,7.034379746824325 58.39243342050288,7.119096095680962 58.39770565305706,7.129070619345991 58.353221859214834,7.044458735301321 58.34795873606456)))"
20400006495000,43,28,15,42.1,"MULTIPOLYGON(((7.129070619345991 58.353221859214834,7.119096095680962 58.39770565305706,7.203842380414668 58.40292214740881,7.213712315243779 58.35842933779331,7.129070619345991 58.353221859214834)))"
20450006495000,393,209,184,39.7,"MULTIPOLYGON(((7.213712315243779 58.35842933779331,7.203842380414668 58.40292214740881,7.288618297287846 58.408082863159635,7.298383520454256 58.36358113155536,7.213712315243779 58.35842933779331)))"
20500006495000,139,73,66,35.2,"MULTIPOLYGON(((7.298383520454256 58.36358113155536,7.288618297287846 58.408082863159635,7.373423541876229 58.41318776031746,7.383083931755038 58.36867720066129,7.298383520454256 58.36358113155536)))"
20550006495000,47,26,21,44.2,"MULTIPOLYGON(((7.383083931755038 58.36867720066129,7.373423541876229 58.41318776031746,7.458257809075176 58.41823679929778,7.467813245248051 58.373717505677455,7.383083931755038 58.36867720066129)))"
20600006495000,120,60,60,42.5,"MULTIPOLYGON(((7.467813245248051 58.373717505677455,7.458257809075176 58.41823679929778,7.543120793106016 58.423229940924635,7.552571156365833 58.37870200757735,7.467813245248051 58.373717505677455)))"
20650006495000,69,32,37,42.2,"MULTIPOLYGON(((7.552571156365833 58.37870200757735,7.543120793106016 58.423229940924635,7.628012187522425 58.42816714643183,7.637357359877877 58.38363066774272,7.552571156365833 58.37870200757735)))"
20700006495000,11,6,5,36.9,"MULTIPOLYGON(((7.637357359877877 58.38363066774272,7.628012187522425 58.42816714643183,7.712931685216834 58.43304837746394,7.72217154989698 58.38850344796468,7.637357359877877 58.38363066774272)))"
20750006495000,175,86,89,38.8,"MULTIPOLYGON(((7.72217154989698 58.38850344796468,7.712931685216834 58.43304837746394,7.79787897842691 58.43787359607745,7.807013419885688 58.3933203104447,7.72217154989698 58.38850344796468)))"
20800006495000,32,17,15,33.2,"MULTIPOLYGON(((7.807013419885688 58.3933203104447,7.79787897842691 58.43787359607745,7.88285375874201 58.44264276474177,7.891882662662742 58.398081217795635,7.807013419885688 58.3933203104447)))"
20850006495000,198,97,101,36,"MULTIPOLYGON(((7.891882662662742 58.398081217795635,7.88285375874201 58.44264276474177,7.967855717109758 58.44735584634029,7.97677897040955 58.40278613304297,7.891882662662742 58.398081217795635)))"
20900006495000,83,42,41,37.4,"MULTIPOLYGON(((7.97677897040955 58.40278613304297,7.967855717109758 58.44735584634029,8.052884543842572 58.45201280417145,8.061702034676728 58.4074350196256,7.97677897040955 58.40278613304297)))"
20950006495000,223,126,97,41.3,"MULTIPOLYGON(((8.061702034676728 58.4074350196256,8.052884543842572 58.45201280417145,8.13793992862427 58.45661360194975,8.146651546390638 58.41202784139707,8.061702034676728 58.4074350196256)))"
21050006495000,57,33,24,41,"MULTIPOLYGON(((8.231627195860021 58.41656456262639,8.223021560516743 58.46115820380679,8.308129127966591 58.465646574292286,8.316628672782592 58.42104514799922,8.231627195860021 58.41656456262639)))"
21100006495000,54,29,25,39.1,"MULTIPOLYGON(((8.316628672782592 58.42104514799922,8.308129127966591 58.465646574292286,8.393262318811866 58.47007867837502,8.401655666251727 58.42546956261883,8.316628672782592 58.42104514799922)))"
21150006495000,42,24,18,38,"MULTIPOLYGON(((8.401655666251727 58.42546956261883,8.393262318811866 58.47007867837502,8.478420820288786 58.47445448144393,8.486707864763158 58.42983777200695,8.401655666251727 58.42546956261883)))"
21200006495000,61,31,30,44,"MULTIPOLYGON(((8.486707864763158 58.42983777200695,8.478420820288786 58.47445448144393,8.563604319038545 58.47877394930893,8.571784956221725 58.43414974210488,8.486707864763158 58.42983777200695)))"
21250006495000,744,387,357,39.1,"MULTIPOLYGON(((8.571784956221725 58.43414974210488,8.563604319038545 58.47877394930893,8.648812501114119 58.48303704820211,8.656886627948117 58.438405439274405,8.571784956221725 58.43414974210488)))"
21300006495000,3722,1883,1839,37.9,"MULTIPOLYGON(((8.656886627948117 58.438405439274405,8.648812501114119 58.48303704820211,8.73404505198711 58.4872437447784,8.74201256668571 58.44260483029879,8.656886627948117 58.438405439274405)))"
21350006495000,20062,9898,10164,43.2,"MULTIPOLYGON(((8.74201256668571 58.44260483029879,8.73404505198711 58.4872437447784,8.819301656554634 58.491394006116785,8.827162458607383 58.446747882383605,8.74201256668571 58.44260483029879)))"
21400006495000,3630,1826,1804,40.8,"MULTIPOLYGON(((8.827162458607383 58.446747882383605,8.819301656554634 58.491394006116785,8.904581999146238 58.495487799721126,8.9123359893224 58.450834563157784,8.827162458607383 58.446747882383605)))"
21450006495000,58,26,32,41.4,"MULTIPOLYGON(((8.9123359893224 58.450834563157784,8.904581999146238 58.495487799721126,8.989885763530859 58.49952509352104,8.997532843883311 58.45486484067447,8.9123359893224 58.450834563157784)))"
19800006500000,52,25,27,47.3,"MULTIPOLYGON(((6.104561840270981 58.33077209838846,6.093308736933815 58.375138774228795,6.177779264985713 58.38103149948639,6.188929050376707 58.336654669785325,6.104561840270981 58.33077209838846)))"
19850006500000,93,46,47,42.5,"MULTIPOLYGON(((6.188929050376707 58.336654669785325,6.177779264985713 58.38103149948639,6.262283160574421 58.386868865363255,6.27332949038994 58.34248197385671,6.188929050376707 58.336654669785325)))"
19900006500000,1315,656,659,43.1,"MULTIPOLYGON(((6.27332949038994 58.34248197385671,6.262283160574421 58.386868865363255,6.346820126771776 58.39265082689673,6.357762864531033 58.34825396581013,6.27332949038994 58.34248197385671)))"
19950006500000,71,40,31,42.2,"MULTIPOLYGON(((6.357762864531033 58.34825396581013,6.346820126771776 58.39265082689673,6.431389865891081 58.398377339518994,6.442228876266996 58.353970601246566,6.357762864531033 58.34825396581013)))"
20000006500000,13,8,5,38.7,"MULTIPOLYGON(((6.442228876266996 58.353970601246566,6.431389865891081 58.398377339518994,6.515992079493002 58.40404835905837,6.52672722831733 58.35963183616172,6.442228876266996 58.353970601246566)))"
20050006500000,31,16,15,44.6,"MULTIPOLYGON(((6.52672722831733 58.35963183616172,6.515992079493002 58.40404835905837,6.600626468391509 58.409663841740475,6.611257622659952 58.36523762694721,6.52672722831733 58.35963183616172)))"
20100006500000,176,91,85,43.1,"MULTIPOLYGON(((6.611257622659952 58.36523762694721,6.600626468391509 58.409663841740475,6.685292732659839 58.41522374418945,6.695819760537112 58.37078793039185,6.611257622659952 58.36523762694721)))"
20150006500000,71,41,30,37.9,"MULTIPOLYGON(((6.695819760537112 58.37078793039185,6.685292732659839 58.41522374418945,6.769990571636533 58.420728023429184,6.78041334246139 58.37628270368268,6.695819760537112 58.37078793039185)))"
20200006500000,168,89,79,44,"MULTIPOLYGON(((6.78041334246139 58.37628270368268,6.769990571636533 58.420728023429184,6.854719683931476 58.42617663688442,6.865038068221711 58.38172190440631,6.78041334246139 58.37628270368268)))"
20250006500000,58,28,30,44.9,"MULTIPOLYGON(((6.865038068221711 58.38172190440631,6.854719683931476 58.42617663688442,6.93947976743201 58.431569542382114,6.949693636889407 58.38710549055001,6.865038068221711 58.38172190440631)))"
20300006500000,202,114,88,35,"MULTIPOLYGON(((6.949693636889407 58.38710549055001,6.93947976743201 58.431569542382114,7.024270519309074 58.43690669815237,7.034379746824325 58.39243342050288,6.949693636889407 58.38710549055001)))"
20350006500000,41,25,16,33,"MULTIPOLYGON(((7.034379746824325 58.39243342050288,7.024270519309074 58.43690669815237,7.109091636023374 58.44218806282983,7.119096095680962 58.39770565305706,7.034379746824325 58.39243342050288)))"
20400006500000,61,35,26,38.9,"MULTIPOLYGON(((7.119096095680962 58.39770565305706,7.109091636023374 58.44218806282983,7.19394281333164 58.44741359545465,7.203842380414668 58.40292214740881,7.119096095680962 58.39770565305706)))"
20450006500000,79,45,34,43.9,"MULTIPOLYGON(((7.203842380414668 58.40292214740881,7.19394281333164 58.44741359545465,7.278823746292837 58.45258325547374,7.288618297287846 58.408082863159635,7.203842380414668 58.40292214740881)))"
20500006500000,18,10,8,40.5,"MULTIPOLYGON(((7.288618297287846 58.408082863159635,7.278823746292837 58.45258325547374,7.36373412927452 58.45769700274186,7.373423541876229 58.41318776031746,7.288618297287846 58.408082863159635)))"
20550006500000,368,174,194,41.5,"MULTIPOLYGON(((7.373423541876229 58.41318776031746,7.36373412927452 58.45769700274186,7.448673655959135 58.46275479752276,7.458257809075176 58.41823679929778,7.373423541876229 58.41318776031746)))"
20600006500000,106,47,59,42.4,"MULTIPOLYGON(((7.458257809075176 58.41823679929778,7.448673655959135 58.46275479752276,7.533642019350423 58.4677566004903,7.543120793106016 58.423229940924635,7.458257809075176 58.41823679929778)))"
20650006500000,17,8,9,41.6,"MULTIPOLYGON(((7.543120793106016 58.423229940924635,7.533642019350423 58.4677566004903,7.618638911779832 58.47270237272947,7.628012187522425 58.42816714643183,7.543120793106016 58.423229940924635)))"
20700006500000,1,1,0,0,"MULTIPOLYGON(((7.628012187522425 58.42816714643183,7.618638911779832 58.47270237272947,7.703664024912976 58.477592075737654,7.712931685216834 58.43304837746394,7.628012187522425 58.42816714643183)))"
20750006500000,37,22,15,35.2,"MULTIPOLYGON(((7.712931685216834 58.43304837746394,7.703664024912976 58.477592075737654,7.788717049756129 58.482425671425496,7.79787897842691 58.43787359607745,7.712931685216834 58.43304837746394)))"
20800006500000,30,14,16,35.9,"MULTIPOLYGON(((7.79787897842691 58.43787359607745,7.788717049756129 58.482425671425496,7.87379767666277 58.487203122118146,7.88285375874201 58.44264276474177,7.79787897842691 58.43787359607745)))"
20850006500000,466,227,239,39.3,"MULTIPOLYGON(((7.88285375874201 58.44264276474177,7.87379767666277 58.487203122118146,7.958905595340138 58.49192439055625,7.967855717109758 58.44735584634029,7.88285375874201 58.44264276474177)))"
20900006500000,23,16,7,35.1,"MULTIPOLYGON(((7.967855717109758 58.44735584634029,7.958905595340138 58.49192439055625,8.04404049485586 58.49658943989697,8.052884543842572 58.45201280417145,7.967855717109758 58.44735584634029)))"
20950006500000,49,28,21,41.2,"MULTIPOLYGON(((8.052884543842572 58.45201280417145,8.04404049485586 58.49658943989697,8.129202063644579 58.50119823371509,8.13793992862427 58.45661360194975,8.052884543842572 58.45201280417145)))"
21000006500000,25,11,14,46.4,"MULTIPOLYGON(((8.13793992862427 58.45661360194975,8.129202063644579 58.50119823371509,8.214389989514652 58.50575073600399,8.223021560516743 58.46115820380679,8.13793992862427 58.45661360194975)))"
21050006500000,39,17,22,37.3,"MULTIPOLYGON(((8.223021560516743 58.46115820380679,8.214389989514652 58.50575073600399,8.299603959654865 58.51024691117671,8.308129127966591 58.465646574292286,8.223021560516743 58.46115820380679)))"
21100006500000,25,15,10,37.5,"MULTIPOLYGON(((8.308129127966591 58.465646574292286,8.299603959654865 58.51024691117671,8.384843660641177 58.51468672406693,8.393262318811866 58.47007867837502,8.308129127966591 58.465646574292286)))"
21150006500000,36,19,17,38.6,"MULTIPOLYGON(((8.393262318811866 58.47007867837502,8.384843660641177 58.51468672406693,8.470108778443528 58.51907013992995,8.478420820288786 58.47445448144393,8.393262318811866 58.47007867837502)))"
21200006500000,23,13,10,43.8,"MULTIPOLYGON(((8.478420820288786 58.47445448144393,8.470108778443528 58.51907013992995,8.555398998432654 58.523397124443704,8.563604319038545 58.47877394930893,8.478420820288786 58.47445448144393)))"
21250006500000,2778,1388,1390,39.5,"MULTIPOLYGON(((8.563604319038545 58.47877394930893,8.555398998432654 58.523397124443704,8.640714005386952 58.52766764370973,8.648812501114119 58.48303704820211,8.563604319038545 58.47877394930893)))"
21300006500000,1686,839,847,38.3,"MULTIPOLYGON(((8.648812501114119 58.48303704820211,8.640714005386952 58.52766764370973,8.726053483499374 58.53188166425416,8.73404505198711 58.4872437447784,8.648812501114119 58.48303704820211)))"
21350006500000,791,409,382,39.8,"MULTIPOLYGON(((8.73404505198711 58.4872437447784,8.726053483499374 58.53188166425416,8.811417116384355 58.5360391530286,8.819301656554634 58.491394006116785,8.73404505198711 58.4872437447784)))"
21400006500000,4065,2053,2012,42.3,"MULTIPOLYGON(((8.819301656554634 58.491394006116785,8.811417116384355 58.5360391530286,8.896804587084784 58.5401400774111,8.904581999146238 58.495487799721126,8.819301656554634 58.491394006116785)))"
21450006500000,566,286,280,46.7,"MULTIPOLYGON(((8.904581999146238 58.495487799721126,8.896804587084784 58.5401400774111,8.982215578078991 58.54418440520717,8.989885763530859 58.49952509352104,8.904581999146238 58.495487799721126)))"
19750006505000,245,126,119,43.3,"MULTIPOLYGON(((6.008871872582516 58.36919073494676,5.997481630848265 58.41354546318727,6.082021969767685 58.419503773606415,6.093308736933815 58.375138774228795,6.008871872582516 58.36919073494676)))"
19800006505000,8,6,2,62.4,"MULTIPOLYGON(((6.093308736933815 58.375138774228795,6.082021969767685 58.419503773606415,6.166596111930513 58.42540667790744,6.177779264985713 58.38103149948639,6.093308736933815 58.375138774228795)))"
19850006505000,4,2,2,0,"MULTIPOLYGON(((6.177779264985713 58.38103149948639,6.166596111930513 58.42540667790744,6.251203760023843 58.431254130561555,6.262283160574421 58.386868865363255,6.177779264985713 58.38103149948639)))"
19900006505000,73,39,34,37,"MULTIPOLYGON(((6.262283160574421 58.386868865363255,6.251203760023843 58.431254130561555,6.335844615965134 58.4370460864351,6.346820126771776 58.39265082689673,6.262283160574421 58.386868865363255)))"
19950006505000,71,33,38,35.1,"MULTIPOLYGON(((6.346820126771776 58.39265082689673,6.335844615965134 58.4370460864351,6.420518380908101 58.442782500790585,6.431389865891081 58.398377339518994,6.346820126771776 58.39265082689673)))"
20000006505000,1,1,0,0,"MULTIPOLYGON(((6.431389865891081 58.398377339518994,6.420518380908101 58.442782500790585,6.505224755248636 58.448463329287996,6.515992079493002 58.40404835905837,6.431389865891081 58.398377339518994)))"
20050006505000,669,344,325,43,"MULTIPOLYGON(((6.515992079493002 58.40404835905837,6.505224755248636 58.448463329287996,6.589963438630793 58.45408852798608,6.600626468391509 58.409663841740475,6.515992079493002 58.40404835905837)))"
20100006505000,605,311,294,41.2,"MULTIPOLYGON(((6.600626468391509 58.409663841740475,6.589963438630793 58.45408852798608,6.674734129952769 58.45965805334351,6.685292732659839 58.41522374418945,6.600626468391509 58.409663841740475)))"
20150006505000,25,11,14,42,"MULTIPOLYGON(((6.685292732659839 58.41522374418945,6.674734129952769 58.45965805334351,6.759536527373004 58.46517186222007,6.769990571636533 58.420728023429184,6.685292732659839 58.41522374418945)))"
20200006505000,75,38,37,36.6,"MULTIPOLYGON(((6.769990571636533 58.420728023429184,6.759536527373004 58.46517186222007,6.844370328316252 58.4706299118779,6.854719683931476 58.42617663688442,6.769990571636533 58.420728023429184)))"
20250006505000,46,19,27,39.3,"MULTIPOLYGON(((6.854719683931476 58.42617663688442,6.844370328316252 58.4706299118779,6.929235229479716 58.47603215998265,6.93947976743201 58.431569542382114,6.854719683931476 58.42617663688442)))"
20300006505000,48,22,26,43.9,"MULTIPOLYGON(((6.93947976743201 58.431569542382114,6.929235229479716 58.47603215998265,7.014130926839245 58.48137856460469,7.024270519309074 58.43690669815237,6.93947976743201 58.431569542382114)))"
20350006505000,45,29,16,38.2,"MULTIPOLYGON(((7.024270519309074 58.43690669815237,7.014130926839245 58.48137856460469,7.099057115655539 58.486669084220274,7.109091636023374 58.44218806282983,7.024270519309074 58.43690669815237)))"
20450006505000,613,299,314,39.2,"MULTIPOLYGON(((7.19394281333164 58.44741359545465,7.184013490480432 58.49190367771265,7.268999745163165 58.49708230437331,7.278823746292837 58.45258325547374,7.19394281333164 58.44741359545465)))"
20500006505000,31,18,13,41.5,"MULTIPOLYGON(((7.278823746292837 58.45258325547374,7.268999745163165 58.49708230437331,7.35401557285676 58.502204923902994,7.36373412927452 58.45769700274186,7.278823746292837 58.45258325547374)))"
20550006505000,60,31,29,44.4,"MULTIPOLYGON(((7.36373412927452 58.45769700274186,7.35401557285676 58.502204923902994,7.439060666024371 58.507271496413004,7.448673655959135 58.46275479752276,7.36373412927452 58.45769700274186)))"
20600006505000,101,44,57,45,"MULTIPOLYGON(((7.448673655959135 58.46275479752276,7.439060666024371 58.507271496413004,7.524134716445738 58.51228198242609,7.533642019350423 58.4677566004903,7.448673655959135 58.46275479752276)))"
20650006505000,14,8,6,46.2,"MULTIPOLYGON(((7.533642019350423 58.4677566004903,7.524134716445738 58.51228198242609,7.609237415223621 58.51723634287776,7.618638911779832 58.47270237272947,7.533642019350423 58.4677566004903)))"
20700006505000,6,4,2,41.5,"MULTIPOLYGON(((7.618638911779832 58.47270237272947,7.609237415223621 58.51723634287776,7.694368452790306 58.52213453911732,7.703664024912976 58.477592075737654,7.618638911779832 58.47270237272947)))"
20750006505000,226,119,107,41.7,"MULTIPOLYGON(((7.703664024912976 58.477592075737654,7.694368452790306 58.52213453911732,7.779527518914164 58.52697653290885,7.788717049756129 58.482425671425496,7.703664024912976 58.477592075737654)))"
20800006505000,28,15,13,36.3,"MULTIPOLYGON(((7.788717049756129 58.482425671425496,7.779527518914164 58.52697653290885,7.864714302706193 58.53176228643247,7.87379767666277 58.487203122118146,7.788717049756129 58.482425671425496)))"
20850006505000,60,33,27,34.2,"MULTIPOLYGON(((7.87379767666277 58.487203122118146,7.864714302706193 58.53176228643247,7.949928492626672 58.53649176228526,7.958905595340138 58.49192439055625,7.87379767666277 58.487203122118146)))"
20900006505000,27,17,10,46.3,"MULTIPOLYGON(((7.958905595340138 58.49192439055625,7.949928492626672 58.53649176228526,8.03516977649177 58.54116492348242,8.04404049485586 58.49658943989697,7.958905595340138 58.49192439055625)))"
20950006505000,105,56,49,37.8,"MULTIPOLYGON(((8.04404049485586 58.49658943989697,8.03516977649177 58.54116492348242,8.120437841480271 58.54578173345824,8.129202063644579 58.50119823371509,8.04404049485586 58.49658943989697)))"
21000006505000,37,17,20,33.9,"MULTIPOLYGON(((8.129202063644579 58.50119823371509,8.120437841480271 58.54578173345824,8.205732374140291 58.55034215606716,8.214389989514652 58.50575073600399,8.129202063644579 58.50119823371509)))"
21050006505000,22,16,6,40.2,"MULTIPOLYGON(((8.214389989514652 58.50575073600399,8.205732374140291 58.55034215606716,8.291053060396033 58.554846155584755,8.299603959654865 58.51024691117671,8.214389989514652 58.50575073600399)))"
21100006505000,235,130,105,42.6,"MULTIPOLYGON(((8.299603959654865 58.51024691117671,8.291053060396033 58.554846155584755,8.376399585554584 58.559293696708934,8.384843660641177 58.51468672406693,8.299603959654865 58.51024691117671)))"
21150006505000,64,38,26,43.7,"MULTIPOLYGON(((8.384843660641177 58.51468672406693,8.376399585554584 58.559293696708934,8.461771634312772 58.56368474456063,8.470108778443528 58.51907013992995,8.384843660641177 58.51468672406693)))"
21200006505000,159,88,71,38.2,"MULTIPOLYGON(((8.470108778443528 58.51907013992995,8.461771634312772 58.56368474456063,8.54716889076402 58.56801926468507,8.555398998432654 58.523397124443704,8.470108778443528 58.51907013992995)))"
21250006505000,275,154,121,35.7,"MULTIPOLYGON(((8.555398998432654 58.523397124443704,8.54716889076402 58.56801926468507,8.632591038405245 58.572297223052615,8.640714005386952 58.52766764370973,8.555398998432654 58.523397124443704)))"
21300006505000,241,128,113,42,"MULTIPOLYGON(((8.640714005386952 58.52766764370973,8.632591038405245 58.572297223052615,8.718037760143824 58.57651858605976,8.726053483499374 58.53188166425416,8.640714005386952 58.52766764370973)))"
21350006505000,187,96,91,39.7,"MULTIPOLYGON(((8.726053483499374 58.53188166425416,8.718037760143824 58.57651858605976,8.803508738304547 58.58068332053013,8.811417116384355 58.5360391530286,8.726053483499374 58.53188166425416)))"
21400006505000,284,153,131,44.6,"MULTIPOLYGON(((8.811417116384355 58.5360391530286,8.803508738304547 58.58068332053013,8.889003654636639 58.58479139371535,8.896804587084784 58.5401400774111,8.811417116384355 58.5360391530286)))"
21450006505000,885,446,439,48.3,"MULTIPOLYGON(((8.896804587084784 58.5401400774111,8.889003654636639 58.58479139371535,8.974522190320798 58.588842773296065,8.982215578078991 58.54418440520717,8.896804587084784 58.5401400774111)))"
21500006505000,542,270,272,45.5,"MULTIPOLYGON(((8.982215578078991 58.54418440520717,8.974522190320798 58.588842773296065,9.060064025976276 58.592837427382804,9.06764977128778 58.548172104650575,8.982215578078991 58.54418440520717)))"
21550006505000,9,5,4,41.9,"MULTIPOLYGON(((9.06764977128778 58.548172104650575,9.060064025976276 58.592837427382804,9.145628841667994 58.5967753245169,9.1531068480815 58.552103144404285,9.06764977128778 58.548172104650575)))"
19650006510000,121,62,59,42.6,"MULTIPOLYGON(((5.828503548108089 58.40146280807686,5.81687208979778 58.44579495932677,5.901447420425792 58.451874424541465,5.912975391709681 58.40753179257242,5.828503548108089 58.40146280807686)))"
19700006510000,1633,865,768,37.8,"MULTIPOLYGON(((5.912975391709681 58.40753179257242,5.901447420425792 58.451874424541465,5.986057289202966 58.45789848392174,5.997481630848265 58.41354546318727,5.912975391709681 58.40753179257242)))"
19750006510000,7585,3778,3807,42.6,"MULTIPOLYGON(((5.997481630848265 58.41354546318727,5.986057289202966 58.45789848392174,6.070701399228903 58.463867090976535,6.082021969767685 58.419503773606415,5.997481630848265 58.41354546318727)))"
19800006510000,35,18,17,36.2,"MULTIPOLYGON(((6.082021969767685 58.419503773606415,6.070701399228903 58.463867090976535,6.155379452816538 58.46978019960869,6.166596111930513 58.42540667790744,6.082021969767685 58.419503773606415)))"
19850006510000,6,3,3,62,"MULTIPOLYGON(((6.166596111930513 58.42540667790744,6.155379452816538 58.46978019960869,6.240091151498003 58.47563776411619,6.251203760023843 58.431254130561555,6.166596111930513 58.42540667790744)))"
19900006510000,64,33,31,49.3,"MULTIPOLYGON(((6.251203760023843 58.431254130561555,6.240091151498003 58.47563776411619,6.324836196030504 58.481439739193306,6.335844615965134 58.4370460864351,6.251203760023843 58.431254130561555)))"
19950006510000,53,27,26,53.4,"MULTIPOLYGON(((6.335844615965134 58.4370460864351,6.324836196030504 58.481439739193306,6.409614286402242 58.48718607993199,6.420518380908101 58.442782500790585,6.335844615965134 58.4370460864351)))"
20000006510000,1,1,0,0,"MULTIPOLYGON(((6.420518380908101 58.442782500790585,6.409614286402242 58.48718607993199,6.494425121838348 58.49287674182313,6.505224755248636 58.448463329287996,6.420518380908101 58.442782500790585)))"
20050006510000,1503,735,768,40,"MULTIPOLYGON(((6.505224755248636 58.448463329287996,6.494425121838348 58.49287674182313,6.579268400806945 58.498511680757645,6.589963438630793 58.45408852798608,6.505224755248636 58.448463329287996)))"
20100006510000,13,8,5,50.1,"MULTIPOLYGON(((6.589963438630793 58.45408852798608,6.579268400806945 58.498511680757645,6.664143821025152 58.50409085302785,6.674734129952769 58.45965805334351,6.589963438630793 58.45408852798608)))"
20150006510000,6,4,2,64,"MULTIPOLYGON(((6.674734129952769 58.45965805334351,6.664143821025152 58.50409085302785,6.749051079465206 58.50961421532859,6.759536527373004 58.46517186222007,6.674734129952769 58.45965805334351)))"
20200006510000,16,9,7,47.6,"MULTIPOLYGON(((6.759536527373004 58.46517186222007,6.749051079465206 58.50961421532859,6.83398987236058 58.51508172475848,6.844370328316252 58.4706299118779,6.759536527373004 58.46517186222007)))"
20250006510000,31,15,16,47.4,"MULTIPOLYGON(((6.844370328316252 58.4706299118779,6.83398987236058 58.51508172475848,6.918959895212166 58.5204933388211,6.929235229479716 58.47603215998265,6.844370328316252 58.4706299118779)))"
20300006510000,109,47,62,49.6,"MULTIPOLYGON(((6.929235229479716 58.47603215998265,6.918959895212166 58.5204933388211,7.003960842794499 58.52584901542616,7.014130926839245 58.48137856460469,6.929235229479716 58.47603215998265)))"
20350006510000,67,38,29,40.5,"MULTIPOLYGON(((7.014130926839245 58.48137856460469,7.003960842794499 58.52584901542616,7.088992409162012 58.53114871289073,7.099057115655539 58.486669084220274,7.014130926839245 58.48137856460469)))"
20400006510000,254,132,122,40.8,"MULTIPOLYGON(((7.099057115655539 58.486669084220274,7.088992409162012 58.53114871289073,7.174054287655338 58.53639238994033,7.184013490480432 58.49190367771265,7.099057115655539 58.486669084220274)))"
20450006510000,3,2,1,0,"MULTIPOLYGON(((7.184013490480432 58.49190367771265,7.174054287655338 58.53639238994033,7.259146170907659 58.54158000571015,7.268999745163165 58.49708230437331,7.184013490480432 58.49190367771265)))"
20500006510000,1,1,0,0,"MULTIPOLYGON(((7.268999745163165 58.49708230437331,7.259146170907659 58.54158000571015,7.344267750851067 58.54671151974619,7.35401557285676 58.502204923902994,7.268999745163165 58.49708230437331)))"
20550006510000,94,46,48,42.6,"MULTIPOLYGON(((7.35401557285676 58.502204923902994,7.344267750851067 58.54671151974619,7.429418718723025 58.55178689200633,7.439060666024371 58.507271496413004,7.35401557285676 58.502204923902994)))"
20600006510000,31,16,15,40.1,"MULTIPOLYGON(((7.439060666024371 58.507271496413004,7.429418718723025 58.55178689200633,7.514598765072788 58.55680608286158,7.524134716445738 58.51228198242609,7.439060666024371 58.507271496413004)))"
20700006510000,36,17,19,37.2,"MULTIPOLYGON(((7.609237415223621 58.51723634287776,7.599807579767938 58.56176905309705,7.685044852000907 58.56667576391316,7.694368452790306 58.52213453911732,7.609237415223621 58.51723634287776)))"
20750006510000,496,261,235,37.6,"MULTIPOLYGON(((7.694368452790306 58.52213453911732,7.685044852000907 58.56667576391316,7.77031027029556 58.57152617692675,7.779527518914164 58.52697653290885,7.694368452790306 58.52213453911732)))"
20800006510000,394,208,186,38.1,"MULTIPOLYGON(((7.779527518914164 58.52697653290885,7.77031027029556 58.57152617692675,7.855603522513825 58.57632025417209,7.864714302706193 58.53176228643247,7.779527518914164 58.52697653290885)))"
20850006510000,46,25,21,38.8,"MULTIPOLYGON(((7.864714302706193 58.53176228643247,7.855603522513825 58.57632025417209,7.940924295862342 58.58105795810192,7.949928492626672 58.53649176228526,7.864714302706193 58.53176228643247)))"
20900006510000,30,15,15,35.6,"MULTIPOLYGON(((7.949928492626672 58.53649176228526,7.940924295862342 58.58105795810192,8.026272276899158 58.58573925158871,8.03516977649177 58.54116492348242,7.949928492626672 58.53649176228526)))"
20950006510000,37,16,21,37.2,"MULTIPOLYGON(((8.03516977649177 58.54116492348242,8.026272276899158 58.58573925158871,8.111647151540463 58.590364097925494,8.120437841480271 58.54578173345824,8.03516977649177 58.54116492348242)))"
21000006510000,29,17,12,45.1,"MULTIPOLYGON(((8.120437841480271 58.54578173345824,8.111647151540463 58.590364097925494,8.197048605067357 58.594932460827025,8.205732374140291 58.55034215606716,8.120437841480271 58.54578173345824)))"
21050006510000,2,1,1,0,"MULTIPOLYGON(((8.205732374140291 58.55034215606716,8.197048605067357 58.594932460827025,8.28247632213267 58.599444304430754,8.291053060396033 58.554846155584755,8.205732374140291 58.55034215606716)))"
21100006510000,12,6,6,55.8,"MULTIPOLYGON(((8.291053060396033 58.554846155584755,8.28247632213267 58.599444304430754,8.36792998676779 58.60389959329794,8.376399585554584 58.559293696708934,8.291053060396033 58.554846155584755)))"
21150006510000,61,36,25,38.6,"MULTIPOLYGON(((8.376399585554584 58.559293696708934,8.36792998676779 58.60389959329794,8.453409282389545 58.60829829241458,8.461771634312772 58.56368474456063,8.376399585554584 58.559293696708934)))"
21200006510000,98,54,44,41.8,"MULTIPOLYGON(((8.461771634312772 58.56368474456063,8.453409282389545 58.60829829241458,8.538913891807141 58.61264036719239,8.54716889076402 58.56801926468507,8.461771634312772 58.56368474456063)))"
21250006510000,138,73,65,36.3,"MULTIPOLYGON(((8.54716889076402 58.56801926468507,8.538913891807141 58.61264036719239,8.624443497229086 58.616925783469874,8.632591038405245 58.572297223052615,8.54716889076402 58.56801926468507)))"
21300006510000,137,71,66,37.5,"MULTIPOLYGON(((8.632591038405245 58.572297223052615,8.624443497229086 58.616925783469874,8.709997780270195 58.62115450751321,8.718037760143824 58.57651858605976,8.632591038405245 58.572297223052615)))"
21350006510000,58,35,23,40.5,"MULTIPOLYGON(((8.718037760143824 58.57651858605976,8.709997780270195 58.62115450751321,8.795576421958609 58.62532650601729,8.803508738304547 58.58068332053013,8.718037760143824 58.57651858605976)))"
21400006510000,577,302,275,44.3,"MULTIPOLYGON(((8.803508738304547 58.58068332053013,8.795576421958609 58.62532650601729,8.881179102742843 58.6294417461067,8.889003654636639 58.58479139371535,8.803508738304547 58.58068332053013)))"
21450006510000,2995,1481,1514,43.7,"MULTIPOLYGON(((8.889003654636639 58.58479139371535,8.881179102742843 58.6294417461067,8.966805502498886 58.6335001953365,8.974522190320798 58.588842773296065,8.889003654636639 58.58479139371535)))"
21500006510000,341,174,167,45.2,"MULTIPOLYGON(((8.974522190320798 58.588842773296065,8.966805502498886 58.6335001953365,9.052455300537332 58.63750182169335,9.060064025976276 58.592837427382804,8.974522190320798 58.588842773296065)))"
21550006510000,209,102,107,50.9,"MULTIPOLYGON(((9.060064025976276 58.592837427382804,9.052455300537332 58.63750182169335,9.138128175610523 58.641446593596264,9.145628841667994 58.5967753245169,9.060064025976276 58.592837427382804)))"
21600006510000,1,1,0,0,"MULTIPOLYGON(((9.145628841667994 58.5967753245169,9.138128175610523 58.641446593596264,9.223823805919743 58.64533447989766,9.231216316913669 58.600656433671425,9.145628841667994 58.5967753245169)))"
19650006515000,955,464,491,39,"MULTIPOLYGON(((5.81687208979778 58.44579495932677,5.805205797097298 58.490125345546986,5.889884910860656 58.49621531750609,5.901447420425792 58.451874424541465,5.81687208979778 58.44579495932677)))"
19700006515000,1111,559,552,33.9,"MULTIPOLYGON(((5.901447420425792 58.451874424541465,5.889884910860656 58.49621531750609,5.974598706177804 58.50224979146733,5.986057289202966 58.45789848392174,5.901447420425792 58.451874424541465)))"
19750006515000,2435,1229,1206,40,"MULTIPOLYGON(((5.986057289202966 58.45789848392174,5.974598706177804 58.50224979146733,6.059346884998281 58.50822872076271,6.070701399228903 58.463867090976535,5.986057289202966 58.45789848392174)))"
19800006515000,10,4,6,54.8,"MULTIPOLYGON(((6.070701399228903 58.463867090976535,6.059346884998281 58.50822872076271,6.14412914847957 58.51415205911944,6.155379452816538 58.46978019960869,6.070701399228903 58.463867090976535)))"
19850006515000,18,9,9,47.2,"MULTIPOLYGON(((6.155379452816538 58.46978019960869,6.14412914847957 58.51415205911944,6.228945196992958 58.52001976066118,6.240091151498003 58.47563776411619,6.155379452816538 58.46978019960869)))"
19900006515000,49,24,25,40.2,"MULTIPOLYGON(((6.240091151498003 58.47563776411619,6.228945196992958 58.52001976066118,6.313794730129474 58.5258317799094,6.324836196030504 58.481439739193306,6.240091151498003 58.47563776411619)))"
19950006515000,119,63,56,37.3,"MULTIPOLYGON(((6.324836196030504 58.481439739193306,6.313794730129474 58.5258317799094,6.398677446705828 58.531588071784576,6.409614286402242 58.48718607993199,6.324836196030504 58.481439739193306)))"
20000006515000,28,12,16,39.8,"MULTIPOLYGON(((6.409614286402242 58.48718607993199,6.398677446705828 58.531588071784576,6.483593044770403 58.53728859160752,6.494425121838348 58.49287674182313,6.409614286402242 58.48718607993199)))"
20050006515000,405,219,186,39.4,"MULTIPOLYGON(((6.494425121838348 58.49287674182313,6.483593044770403 58.53728859160752,6.568541221609337 58.54293329510048,6.579268400806945 58.498511680757645,6.494425121838348 58.49287674182313)))"
20150006515000,57,33,24,38.8,"MULTIPOLYGON(((6.664143821025152 58.50409085302785,6.653521673752566 58.54852213838855,6.738534096979992 58.55405507800072,6.749051079465206 58.50961421532859,6.664143821025152 58.50409085302785)))"
20200006515000,12,7,5,43.7,"MULTIPOLYGON(((6.749051079465206 58.50961421532859,6.738534096979992 58.55405507800072,6.823578186327632 58.55953207087127,6.83398987236058 58.51508172475848,6.749051079465206 58.50961421532859)))"
20250006515000,5,4,1,55.6,"MULTIPOLYGON(((6.83398987236058 58.51508172475848,6.823578186327632 58.55953207087127,6.908653636093846 58.56495307434082,6.918959895212166 58.5204933388211,6.83398987236058 58.51508172475848)))"
20300006515000,156,67,89,40.8,"MULTIPOLYGON(((6.918959895212166 58.5204933388211,6.908653636093846 58.56495307434082,6.993760139845605 58.57031804615757,7.003960842794499 58.52584901542616,6.918959895212166 58.5204933388211)))"
20350006515000,12,6,6,47.4,"MULTIPOLYGON(((7.003960842794499 58.52584901542616,6.993760139845605 58.57031804615757,7.078897390424758 58.575626944478536,7.088992409162012 58.53114871289073,7.003960842794499 58.52584901542616)))"
20400006515000,32,18,14,46.7,"MULTIPOLYGON(((7.088992409162012 58.53114871289073,7.078897390424758 58.575626944478536,7.16406507995441 58.58087972787071,7.174054287655338 58.53639238994033,7.088992409162012 58.53114871289073)))"
20550006515000,22,14,8,45.5,"MULTIPOLYGON(((7.344267750851067 58.54671151974619,7.334490540802133 58.591216786193186,7.419747692830253 58.59630098031763,7.429418718723025 58.55178689200633,7.344267750851067 58.54671151974619)))"
20600006515000,50,24,26,39.3,"MULTIPOLYGON(((7.429418718723025 58.55178689200633,7.419747692830253 58.59630098031763,7.50503404524193 58.60132889790377,7.514598765072788 58.55680608286158,7.429418718723025 58.55178689200633)))"
20650006515000,31,16,15,40.2,"MULTIPOLYGON(((7.514598765072788 58.55680608286158,7.50503404524193 58.60132889790377,7.590349286663015 58.60630049958562,7.599807579767938 58.56176905309705,7.514598765072788 58.55680608286158)))"
20700006515000,31,17,14,29.3,"MULTIPOLYGON(((7.599807579767938 58.56176905309705,7.590349286663015 58.60630049958562,7.675693105039491 58.611215746414,7.685044852000907 58.56667576391316,7.599807579767938 58.56176905309705)))"
20750006515000,75,41,34,42.9,"MULTIPOLYGON(((7.685044852000907 58.56667576391316,7.675693105039491 58.611215746414,7.76106518764413 58.61607459985751,7.77031027029556 58.57152617692675,7.685044852000907 58.56667576391316)))"
20800006515000,2144,1069,1075,42.1,"MULTIPOLYGON(((7.77031027029556 58.57152617692675,7.76106518764413 58.61607459985751,7.846465221083107 58.620877021803885,7.855603522513825 58.57632025417209,7.77031027029556 58.57152617692675)))"
20850006515000,204,107,97,41,"MULTIPOLYGON(((7.855603522513825 58.57632025417209,7.846465221083107 58.620877021803885,7.93189289130274 58.62562297456082,7.940924295862342 58.58105795810192,7.855603522513825 58.57632025417209)))"
20900006515000,14,6,8,56.7,"MULTIPOLYGON(((7.940924295862342 58.58105795810192,7.93189289130274 58.62562297456082,8.01734788359621 58.630312420857194,8.026272276899158 58.58573925158871,7.940924295862342 58.58105795810192)))"
21000006515000,9,7,2,41,"MULTIPOLYGON(((8.111647151540463 58.590364097925494,8.102829882610344 58.63494532384408,8.188338572352432 58.63952164709576,8.197048605067357 58.594932460827025,8.111647151540463 58.590364097925494)))"
21050006515000,10,5,5,39.5,"MULTIPOLYGON(((8.197048605067357 58.594932460827025,8.188338572352432 58.63952164709576,8.273873636197075 58.644041354610856,8.28247632213267 58.599444304430754,8.197048605067357 58.594932460827025)))"
21100006515000,60,32,28,52.2,"MULTIPOLYGON(((8.28247632213267 58.599444304430754,8.273873636197075 58.644041354610856,8.359434756893075 58.648504410813246,8.36792998676779 58.60389959329794,8.28247632213267 58.599444304430754)))"
21150006515000,65,35,30,45.2,"MULTIPOLYGON(((8.36792998676779 58.60389959329794,8.359434756893075 58.648504410813246,8.445021616570362 58.65291078055319,8.453409282389545 58.60829829241458,8.36792998676779 58.60389959329794)))"
21200006515000,35,24,11,35.3,"MULTIPOLYGON(((8.453409282389545 58.60829829241458,8.445021616570362 58.65291078055319,8.530633896746963 58.657260429108234,8.538913891807141 58.61264036719239,8.453409282389545 58.60829829241458)))"
21250006515000,58,36,22,39.3,"MULTIPOLYGON(((8.538913891807141 58.61264036719239,8.530633896746963 58.657260429108234,8.616271278335985 58.6615533221843,8.624443497229086 58.616925783469874,8.538913891807141 58.61264036719239)))"
21300006515000,132,79,53,43.2,"MULTIPOLYGON(((8.624443497229086 58.616925783469874,8.616271278335985 58.6615533221843,8.701933441652663 58.66578942591656,8.709997780270195 58.62115450751321,8.624443497229086 58.616925783469874)))"
21350006515000,12,6,6,58.4,"MULTIPOLYGON(((8.709997780270195 58.62115450751321,8.701933441652663 58.66578942591656,8.787620066421429 58.66996870687052,8.795576421958609 58.62532650601729,8.709997780270195 58.62115450751321)))"
21400006515000,315,163,152,40.4,"MULTIPOLYGON(((8.795576421958609 58.62532650601729,8.787620066421429 58.66996870687052,8.873330831782997 58.67409113204291,8.881179102742843 58.6294417461067,8.795576421958609 58.62532650601729)))"
21450006515000,304,158,146,42,"MULTIPOLYGON(((8.881179102742843 58.6294417461067,8.873330831782997 58.67409113204291,8.959065416301534 58.67815666886265,8.966805502498886 58.6335001953365,8.881179102742843 58.6294417461067)))"
21500006515000,261,126,135,40.6,"MULTIPOLYGON(((8.966805502498886 58.6335001953365,8.959065416301534 58.67815666886265,9.044823497971803 58.68216528519178,9.052455300537332 58.63750182169335,8.966805502498886 58.6335001953365)))"
21550006515000,405,207,198,46.4,"MULTIPOLYGON(((9.052455300537332 58.63750182169335,9.044823497971803 58.68216528519178,9.130604754226383 58.68611694932639,9.138128175610523 58.641446593596264,9.052455300537332 58.63750182169335)))"
21600006515000,165,90,75,45.7,"MULTIPOLYGON(((9.138128175610523 58.641446593596264,9.130604754226383 58.68611694932639,9.216408861942899 58.690011629997585,9.223823805919743 58.64533447989766,9.138128175610523 58.641446593596264)))"
21650006515000,6,3,3,66.8,"MULTIPOLYGON(((9.223823805919743 58.64533447989766,9.216408861942899 58.690011629997585,9.302235497451315 58.69384929637226,9.309541869122453 58.64916544988419,9.223823805919743 58.64533447989766)))"
19600006520000,384,198,186,46.7,"MULTIPOLYGON(((5.720561662140304 58.48397992265199,5.708756455463512 58.52829791283804,5.793504525456501 58.53445396080591,5.805205797097298 58.490125345546986,5.720561662140304 58.48397992265199)))"
19650006520000,866,422,444,38.9,"MULTIPOLYGON(((5.805205797097298 58.490125345546986,5.793504525456501 58.53445396080591,5.878287719608752 58.5405544656433,5.889884910860656 58.49621531750609,5.805205797097298 58.490125345546986)))"
19700006520000,68,38,30,40.3,"MULTIPOLYGON(((5.889884910860656 58.49621531750609,5.878287719608752 58.5405544656433,5.963105739517303 58.54659938010889,5.974598706177804 58.50224979146733,5.889884910860656 58.49621531750609)))"
19750006520000,307,155,152,40.5,"MULTIPOLYGON(((5.974598706177804 58.50224979146733,5.963105739517303 58.54659938010889,6.047958285975818 58.552588657356786,6.059346884998281 58.50822872076271,5.974598706177804 58.50224979146733)))"
19800006520000,365,198,167,36,"MULTIPOLYGON(((6.059346884998281 58.50822872076271,6.047958285975818 58.552588657356786,6.132845058980446 58.55852225093763,6.14412914847957 58.51415205911944,6.059346884998281 58.50822872076271)))"
19850006520000,231,129,102,47.2,"MULTIPOLYGON(((6.14412914847957 58.51415205911944,6.132845058980446 58.55852225093763,6.217765757735732 58.56440011479992,6.228945196992958 58.52001976066118,6.14412914847957 58.51415205911944)))"
19900006520000,83,40,43,41.2,"MULTIPOLYGON(((6.228945196992958 58.52001976066118,6.217765757735732 58.56440011479992,6.302720080660555 58.57022220329137,6.313794730129474 58.5258317799094,6.228945196992958 58.52001976066118)))"
19950006520000,191,98,93,43.6,"MULTIPOLYGON(((6.313794730129474 58.5258317799094,6.302720080660555 58.57022220329137,6.387707725394143 58.57598847116009,6.398677446705828 58.531588071784576,6.313794730129474 58.5258317799094)))"
20000006520000,15,10,5,30.2,"MULTIPOLYGON(((6.398677446705828 58.531588071784576,6.387707725394143 58.57598847116009,6.472728388802077 58.58169887355587,6.483593044770403 58.53728859160752,6.398677446705828 58.531588071784576)))"
20050006520000,74,36,38,34.7,"MULTIPOLYGON(((6.483593044770403 58.53728859160752,6.472728388802077 58.58169887355587,6.557781766982424 58.587353366031465,6.568541221609337 58.54293329510048,6.483593044770403 58.53728859160752)))"
20150006520000,70,40,30,40.1,"MULTIPOLYGON(((6.653521673752566 58.54852213838855,6.642867555271806 58.59295190454378,6.727985448251617 58.598494445455174,6.738534096979992 58.55405507800072,6.653521673752566 58.54852213838855)))"
20200006520000,67,35,32,35.3,"MULTIPOLYGON(((6.738534096979992 58.55405507800072,6.727985448251617 58.598494445455174,6.813135139754205 58.60398094553462,6.823578186327632 58.55953207087127,6.738534096979992 58.55405507800072)))"
20250006520000,41,23,18,41.2,"MULTIPOLYGON(((6.823578186327632 58.55953207087127,6.813135139754205 58.60398094553462,6.898316322869142 58.60941136195892,6.908653636093846 58.56495307434082,6.823578186327632 58.55953207087127)))"
20300006520000,6,4,2,57.2,"MULTIPOLYGON(((6.908653636093846 58.56495307434082,6.898316322869142 58.60941136195892,6.983528689949518 58.61478565231396,6.993760139845605 58.57031804615757,6.908653636093846 58.56495307434082)))"
20550006520000,173,80,93,40.3,"MULTIPOLYGON(((7.334490540802133 58.591216786193186,7.324683819566437 58.63572071914216,7.410047466439522 58.640813757338606,7.419747692830253 58.59630098031763,7.334490540802133 58.591216786193186)))"
20600006520000,216,103,113,43.9,"MULTIPOLYGON(((7.419747692830253 58.59630098031763,7.410047466439522 58.640813757338606,7.495440436288357 58.64585042363713,7.50503404524193 58.60132889790377,7.419747692830253 58.59630098031763)))"
20700006520000,9,8,1,43.7,"MULTIPOLYGON(((7.590349286663015 58.60630049958562,7.580862416490484 58.650830678519796,7.666313093738829 58.65575448288692,7.675693105039491 58.611215746414,7.590349286663015 58.60630049958562)))"
20800006520000,79,38,41,43.2,"MULTIPOLYGON(((7.76106518764413 58.61607459985751,7.751792154048379 58.66062179805828,7.837299282762879 58.66543258577415,7.846465221083107 58.620877021803885,7.76106518764413 58.61607459985751)))"
20900006520000,6,4,2,43.7,"MULTIPOLYGON(((7.93189289130274 58.62562297456082,7.922834164561572 58.670186808196384,8.008396483466006 58.67488442790959,8.01734788359621 58.630312420857194,7.93189289130274 58.62562297456082)))"
21000006520000,72,40,32,45.8,"MULTIPOLYGON(((8.102829882610344 58.63494532384408,8.093985922846825 58.67952540792205,8.179602165430655 58.68410971166685,8.188338572352432 58.63952164709576,8.102829882610344 58.63494532384408)))"
21050006520000,17,10,7,47.2,"MULTIPOLYGON(((8.188338572352432 58.63952164709576,8.179602165430655 58.68410971166685,8.265244893306976 58.688637303003006,8.273873636197075 58.644041354610856,8.188338572352432 58.63952164709576)))"
21100006520000,13,6,7,39.2,"MULTIPOLYGON(((8.273873636197075 58.644041354610856,8.265244893306976 58.688637303003006,8.350913787935088 58.6931081462163,8.359434756893075 58.648504410813246,8.273873636197075 58.644041354610856)))"
21150006520000,55,30,25,44.7,"MULTIPOLYGON(((8.359434756893075 58.648504410813246,8.350913787935088 58.6931081462163,8.43660853015105 58.697522206020516,8.445021616570362 58.65291078055319,8.359434756893075 58.648504410813246)))"
21250006520000,10,6,4,26.9,"MULTIPOLYGON(((8.530633896746963 58.657260429108234,8.522328800174714 58.70187944755832,8.608074277616753 58.70617983640231,8.616271278335985 58.6615533221843,8.530633896746963 58.657260429108234)))"
21300006520000,45,26,19,53.8,"MULTIPOLYGON(((8.616271278335985 58.6615533221843,8.608074277616753 58.70617983640231,8.693844641485759 58.71042333855594,8.701933441652663 58.66578942591656,8.616271278335985 58.6615533221843)))"
21350006520000,139,64,75,40.8,"MULTIPOLYGON(((8.701933441652663 58.66578942591656,8.693844641485759 58.71042333855594,8.779639570195343 58.71460992045464,8.787620066421429 58.66996870687052,8.701933441652663 58.66578942591656)))"
21400006520000,248,136,112,40.2,"MULTIPOLYGON(((8.787620066421429 58.66996870687052,8.779639570195343 58.71460992045464,8.865458741571292 58.71873954896664,8.873330831782997 58.67409113204291,8.787620066421429 58.66996870687052)))"
21450006520000,9,5,4,37.1,"MULTIPOLYGON(((8.873330831782997 58.67409113204291,8.865458741571292 58.71873954896664,8.951301832858759 58.72281219139396,8.959065416301534 58.67815666886265,8.873330831782997 58.67409113204291)))"
21500006520000,391,212,179,44.5,"MULTIPOLYGON(((8.959065416301534 58.67815666886265,8.951301832858759 58.72281219139396,9.037168520729473 58.72682781547341,9.044823497971803 58.68216528519178,8.959065416301534 58.67815666886265)))"
21550006520000,582,303,279,43.3,"MULTIPOLYGON(((9.044823497971803 58.68216528519178,9.037168520729473 58.72682781547341,9.12305848128902 58.73078638937748,9.130604754226383 58.68611694932639,9.044823497971803 58.68216528519178)))"
21600006520000,1893,958,935,42.4,"MULTIPOLYGON(((9.130604754226383 58.68611694932639,9.12305848128902 58.73078638937748,9.208971390084093 58.73468788171523,9.216408861942899 58.690011629997585,9.130604754226383 58.68611694932639)))"
21650006520000,3103,1496,1607,48,"MULTIPOLYGON(((9.216408861942899 58.690011629997585,9.208971390084093 58.73468788171523,9.294906922109847 58.73853226153325,9.302235497451315 58.69384929637226,9.216408861942899 58.690011629997585)))"
19550006525000,1870,946,924,39.4,"MULTIPOLYGON(((5.624043807223554 58.52208636937487,5.612099093339895 58.5663918124314,5.696915826897858 58.57261409964415,5.708756455463512 58.52829791283804,5.624043807223554 58.52208636937487)))"
19600006525000,1979,1074,905,34.7,"MULTIPOLYGON(((5.708756455463512 58.52829791283804,5.696915826897858 58.57261409964415,5.78176812952158 58.57878079913822,5.793504525456501 58.53445396080591,5.708756455463512 58.52829791283804)))"
19650006525000,44,24,20,48.7,"MULTIPOLYGON(((5.793504525456501 58.53445396080591,5.78176812952158 58.57878079913822,5.866655702466647 58.584891863096864,5.878287719608752 58.5405544656433,5.793504525456501 58.53445396080591)))"
19700006525000,18,10,8,39.1,"MULTIPOLYGON(((5.878287719608752 58.5405544656433,5.866655702466647 58.584891863096864,5.951578246173916 58.59094724409852,5.963105739517303 58.54659938010889,5.878287719608752 58.5405544656433)))"
19750006525000,108,64,44,40.2,"MULTIPOLYGON(((5.963105739517303 58.54659938010889,5.951578246173916 58.59094724409852,6.036535460275303 58.59694689511843,6.047958285975818 58.552588657356786,5.963105739517303 58.54659938010889)))"
19800006525000,705,366,339,37.8,"MULTIPOLYGON(((6.047958285975818 58.552588657356786,6.036535460275303 58.59694689511843,6.121527043599726 58.60289076952974,6.132845058980446 58.55852225093763,6.047958285975818 58.552588657356786)))"
19850006525000,25,14,11,41.8,"MULTIPOLYGON(((6.132845058980446 58.55852225093763,6.121527043599726 58.60289076952974,6.206552694179019 58.608778821104906,6.217765757735732 58.56440011479992,6.132845058980446 58.55852225093763)))"
19900006525000,11,8,3,31.8,"MULTIPOLYGON(((6.217765757735732 58.56440011479992,6.206552694179019 58.608778821104906,6.291612109253939 58.61461100401688,6.302720080660555 58.57022220329137,6.217765757735732 58.56440011479992)))"
19950006525000,11,6,5,38.5,"MULTIPOLYGON(((6.302720080660555 58.57022220329137,6.291612109253939 58.61461100401688,6.376704985280175 58.62038727284053,6.387707725394143 58.57598847116009,6.302720080660555 58.57022220329137)))"
20000006525000,5,4,1,52.4,"MULTIPOLYGON(((6.387707725394143 58.57598847116009,6.376704985280175 58.62038727284053,6.461831017934442 58.62610758255374,6.472728388802077 58.58169887355587,6.387707725394143 58.57598847116009)))"
20050006525000,1,1,0,0,"MULTIPOLYGON(((6.472728388802077 58.58169887355587,6.461831017934442 58.62610758255374,6.546989902120592 58.631771888538836,6.557781766982424 58.587353366031465,6.472728388802077 58.58169887355587)))"
20150006525000,4,2,2,0,"MULTIPOLYGON(((6.642867555271806 58.59295190454378,6.632181331975778 58.6373801465837,6.717405000876664 58.642932312883076,6.727985448251617 58.598494445455174,6.642867555271806 58.59295190454378)))"
20200006525000,11,5,6,66.1,"MULTIPOLYGON(((6.727985448251617 58.598494445455174,6.717405000876664 58.642932312883076,6.802660601445681 58.648428344039836,6.813135139754205 58.60398094553462,6.727985448251617 58.598494445455174)))"
20300006525000,41,23,18,47.6,"MULTIPOLYGON(((6.898316322869142 58.60941136195892,6.887947825557307 58.65386819706608,6.973266364344426 58.65925182938448,6.983528689949518 58.61478565231396,6.898316322869142 58.60941136195892)))"
20400006525000,1,1,0,0,"MULTIPOLYGON(((7.068771932618273 58.62010377459587,7.058615908204672 58.6645791988294,7.143996146806901 58.669850263648094,7.154045741774598 58.625365687212145,7.068771932618273 58.62010377459587)))"
20600006525000,74,44,30,37.6,"MULTIPOLYGON(((7.410047466439522 58.640813757338606,7.400317916957828 58.68532521903774,7.485817816867384 58.690370656123356,7.495440436288357 58.64585042363713,7.410047466439522 58.640813757338606)))"
20700006525000,14,7,7,28.8,"MULTIPOLYGON(((7.580862416490484 58.650830678519796,7.571346849158742 58.69535958605352,7.656904699265087 58.70029196957738,7.666313093738829 58.65575448288692,7.580862416490484 58.650830678519796)))"
20800006525000,449,234,215,45.3,"MULTIPOLYGON(((7.751792154048379 58.66062179805828,7.74249105193693 58.70516776786496,7.828105591248828 58.70998694250836,7.837299282762879 58.66543258577415,7.751792154048379 58.66062179805828)))"
20850006525000,46,27,19,46.4,"MULTIPOLYGON(((7.837299282762879 58.66543258577415,7.828105591248828 58.70998694250836,7.913748000606186 58.71474945552282,7.922834164561572 58.670186808196384,7.837299282762879 58.66543258577415)))"
21000006525000,1,1,0,0,"MULTIPOLYGON(((8.093985922846825 58.67952540792205,8.08511515977411 58.72410434684812,8.170839273111346 58.72869665131491,8.179602165430655 58.68410971166685,8.093985922846825 58.67952540792205)))"
21100006525000,78,35,43,37.3,"MULTIPOLYGON(((8.265244893306976 58.688637303003006,8.256589983561224 58.73323214646673,8.342366971286545 58.737710796450635,8.350913787935088 58.6931081462163,8.265244893306976 58.688637303003006)))"
21150006525000,65,32,33,46.2,"MULTIPOLYGON(((8.350913787935088 58.6931081462163,8.342366971286545 58.737710796450635,8.428169915822506 58.742132565843164,8.43660853015105 58.697522206020516,8.350913787935088 58.6931081462163)))"
21200006525000,44,27,17,42.7,"MULTIPOLYGON(((8.43660853015105 58.697522206020516,8.428169915822506 58.742132565843164,8.513998496083737 58.74649741965133,8.522328800174714 58.70187944755832,8.43660853015105 58.697522206020516)))"
21250006525000,36,20,16,58.5,"MULTIPOLYGON(((8.522328800174714 58.70187944755832,8.513998496083737 58.74649741965133,8.5998523903714 58.75080532331371,8.608074277616753 58.70617983640231,8.522328800174714 58.70187944755832)))"
21300006525000,49,28,21,39.3,"MULTIPOLYGON(((8.608074277616753 58.70617983640231,8.5998523903714 58.75080532331371,8.68573127638031 58.75505624270137,8.693844641485759 58.71042333855594,8.608074277616753 58.70617983640231)))"
21350006525000,89,46,43,43.1,"MULTIPOLYGON(((8.693844641485759 58.71042333855594,8.68573127638031 58.75505624270137,8.771634831206121 58.759250144118916,8.779639570195343 58.71460992045464,8.693844641485759 58.71042333855594)))"
21400006525000,516,265,251,37.4,"MULTIPOLYGON(((8.779639570195343 58.71460992045464,8.771634831206121 58.759250144118916,8.8575627313525 58.76338699430535,8.865458741571292 58.71873954896664,8.779639570195343 58.71460992045464)))"
21450006525000,632,302,330,43.9,"MULTIPOLYGON(((8.865458741571292 58.71873954896664,8.8575627313525 58.76338699430535,8.943514652738363 58.767466760435184,8.951301832858759 58.72281219139396,8.865458741571292 58.71873954896664)))"
21500006525000,92,50,42,41.3,"MULTIPOLYGON(((8.951301832858759 58.72281219139396,8.943514652738363 58.767466760435184,9.029490270705168 58.77148941011925,9.037168520729473 58.72682781547341,8.951301832858759 58.72281219139396)))"
21550006525000,546,278,268,43.4,"MULTIPOLYGON(((9.037168520729473 58.72682781547341,9.029490270705168 58.77148941011925,9.115489260024198 58.77545491140577,9.12305848128902 58.73078638937748,9.037168520729473 58.72682781547341)))"
21600006525000,128,68,60,41.6,"MULTIPOLYGON(((9.12305848128902 58.73078638937748,9.115489260024198 58.77545491140577,9.201511294903904 58.77936323278115,9.208971390084093 58.73468788171523,9.12305848128902 58.73078638937748)))"
21650006525000,139,69,70,49.4,"MULTIPOLYGON(((9.208971390084093 58.73468788171523,9.201511294903904 58.77936323278115,9.287556048997274 58.78321434317098,9.294906922109847 58.73853226153325,9.208971390084093 58.73468788171523)))"
21700006525000,66,32,34,51.2,"MULTIPOLYGON(((9.294906922109847 58.73853226153325,9.287556048997274 58.78321434317098,9.373623195409246 58.787008211940936,9.380864751817242 58.74231949831658,9.294906922109847 58.73853226153325)))"
21750006525000,1,1,0,0,"MULTIPOLYGON(((9.380864751817242 58.74231949831658,9.373623195409246 58.787008211940936,9.459712406704138 58.790744808897635,9.46684455312042 58.74604956198946,9.380864751817242 58.74231949831658)))"
19550006530000,1021,539,482,38.5,"MULTIPOLYGON(((5.612099093339895 58.5663918124314,5.600118512328935 58.61069541922403,5.685039629129701 58.616928476960325,5.696915826897858 58.57261409964415,5.612099093339895 58.5663918124314)))"
19600006530000,233,113,120,38.7,"MULTIPOLYGON(((5.696915826897858 58.57261409964415,5.685039629129701 58.616928476960325,5.769996463129512 58.623105854544505,5.78176812952158 58.57878079913822,5.696915826897858 58.57261409964415)))"
19650006530000,84,45,39,38.6,"MULTIPOLYGON(((5.78176812952158 58.57878079913822,5.769996463129512 58.623105854544505,5.854988714427536 58.62922750397712,5.866655702466647 58.584891863096864,5.78176812952158 58.57878079913822)))"
19700006530000,6,2,4,56.5,"MULTIPOLYGON(((5.866655702466647 58.584891863096864,5.854988714427536 58.62922750397712,5.94001608230257 58.63529337765553,5.951578246173916 58.59094724409852,5.866655702466647 58.584891863096864)))"
19750006530000,105,57,48,35.4,"MULTIPOLYGON(((5.951578246173916 58.59094724409852,5.94001608230257 58.63529337765553,6.02507826521891 58.64130342837514,6.036535460275303 58.59694689511843,5.951578246173916 58.59094724409852)))"
19800006530000,1134,576,558,39.4,"MULTIPOLYGON(((6.036535460275303 58.59694689511843,6.02507826521891 58.64130342837514,6.110174960832284 58.64725760933065,6.121527043599726 58.60289076952974,6.036535460275303 58.59694689511843)))"
19850006530000,53,27,26,36.5,"MULTIPOLYGON(((6.121527043599726 58.60289076952974,6.110174960832284 58.64725760933065,6.195305865995845 58.653155874117516,6.206552694179019 58.608778821104906,6.121527043599726 58.60289076952974)))"
19900006530000,6,2,4,47,"MULTIPOLYGON(((6.206552694179019 58.608778821104906,6.195305865995845 58.653155874117516,6.280470676766178 58.658998176733064,6.291612109253939 58.61461100401688,6.206552694179019 58.608778821104906)))"
20050006530000,10,5,5,49.3,"MULTIPOLYGON(((6.461831017934442 58.62610758255374,6.450900795407144 58.670514713457266,6.53616549146298 58.676188857581984,6.546989902120592 58.631771888538836,6.461831017934442 58.62610758255374)))"
20100006530000,10,5,5,46.6,"MULTIPOLYGON(((6.546989902120592 58.631771888538836,6.53616549146298 58.676188857581984,6.621462869508342 58.68180685957009,6.632181331975778 58.6373801465837,6.546989902120592 58.631771888538836)))"
20150006530000,197,98,99,35.6,"MULTIPOLYGON(((6.632181331975778 58.6373801465837,6.621462869508342 58.68180685957009,6.706792621708927 58.687368675447836,6.717405000876664 58.642932312883076,6.632181331975778 58.6373801465837)))"
20200006530000,821,417,404,42.2,"MULTIPOLYGON(((6.717405000876664 58.642932312883076,6.706792621708927 58.687368675447836,6.792154439470944 58.69287426165104,6.802660601445681 58.648428344039836,6.717405000876664 58.642932312883076)))"
20300006530000,4,1,3,0,"MULTIPOLYGON(((6.887947825557307 58.65386819706608,6.877548013447446 58.69832357502631,6.962973033544724 58.70371657283216,6.973266364344426 58.65925182938448,6.887947825557307 58.65386819706608)))"
20350006530000,7,4,3,58.9,"MULTIPOLYGON(((6.973266364344426 58.65925182938448,6.962973033544724 58.70371657283216,7.048429188928702 58.709053212740365,7.058615908204672 58.6645791988294,6.973266364344426 58.65925182938448)))"
20600006530000,36,18,18,40.2,"MULTIPOLYGON(((7.400317916957828 58.68532521903774,7.390558921100928 58.729835361360024,7.476166064949725 58.734889591401085,7.485817816867384 58.690370656123356,7.400317916957828 58.68532521903774)))"
20650006530000,1,1,0,0,"MULTIPOLYGON(((7.485817816867384 58.690370656123356,7.476166064949725 58.734889591401085,7.561802463898227 58.73988721831833,7.571346849158742 58.69535958605352,7.485817816867384 58.690370656123356)))"
20700006530000,3,1,2,0,"MULTIPOLYGON(((7.571346849158742 58.69535958605352,7.561802463898227 58.73988721831833,7.647467802113195 58.74482820270879,7.656904699265087 58.70029196957738,7.571346849158742 58.69535958605352)))"
20800006530000,7,5,2,36.6,"MULTIPOLYGON(((7.74249105193693 58.70516776786496,7.733161763073904 58.749712505591994,7.818884029578934 58.75454008841107,7.828105591248828 58.70998694250836,7.74249105193693 58.70516776786496)))"
20850006530000,38,19,19,52.6,"MULTIPOLYGON(((7.828105591248828 58.70998694250836,7.818884029578934 58.75454008841107,7.904634283753025 58.75931091303378,7.913748000606186 58.71474945552282,7.828105591248828 58.70998694250836)))"
21000006530000,7,3,4,53.9,"MULTIPOLYGON(((8.08511515977411 58.72410434684812,8.076217480279261 58.76868213729157,8.162049783573627 58.773282462795535,8.170839273111346 58.72869665131491,8.08511515977411 58.72410434684812)))"
21100006530000,10,5,5,49.7,"MULTIPOLYGON(((8.256589983561224 58.73323214646673,8.24790879643542 58.77782588184311,8.33379419772394 58.7823123584418,8.342366971286545 58.737710796450635,8.256589983561224 58.73323214646673)))"
21200006530000,714,361,353,42.2,"MULTIPOLYGON(((8.428169915822506 58.742132565843164,8.419705665666449 58.78674185703016,8.505642877865272 58.791114342478856,8.513998496083737 58.74649741965133,8.428169915822506 58.742132565843164)))"
21250006530000,114,61,53,41.8,"MULTIPOLYGON(((8.513998496083737 58.74649741965133,8.505642877865272 58.791114342478856,8.591605511304925 58.79542978009171,8.5998523903714 58.75080532331371,8.513998496083737 58.74649741965133)))"
21350006530000,41,22,19,40.2,"MULTIPOLYGON(((8.68573127638031 58.75505624270137,8.6775932423593 58.799688135606644,8.76360574679888 58.80388937519673,8.771634831206121 58.759250144118916,8.68573127638031 58.75505624270137)))"
21400006530000,144,70,74,39.5,"MULTIPOLYGON(((8.771634831206121 58.759250144118916,8.76360574679888 58.80388937519673,8.84964269979797 58.80803346547111,8.8575627313525 58.76338699430535,8.771634831206121 58.759250144118916)))"
21450006530000,111,61,50,43.4,"MULTIPOLYGON(((8.8575627313525 58.76338699430535,8.84964269979797 58.80803346547111,8.935703775942 58.81212037347603,8.943514652738363 58.767466760435184,8.8575627313525 58.76338699430535)))"
21500006530000,68,34,34,35.3,"MULTIPOLYGON(((8.943514652738363 58.767466760435184,8.935703775942 58.81212037347603,9.021788649234836 58.81615006669572,9.029490270705168 58.77148941011925,8.943514652738363 58.767466760435184)))"
21550006530000,758,383,375,44.7,"MULTIPOLYGON(((9.029490270705168 58.77148941011925,9.021788649234836 58.81615006669572,9.10789699310613 58.8201225130534,9.115489260024198 58.77545491140577,9.029490270705168 58.77148941011925)))"
21600006530000,36,20,16,39.6,"MULTIPOLYGON(((9.115489260024198 58.77545491140577,9.10789699310613 58.8201225130534,9.194028480418707 58.82403768091218,9.201511294903904 58.77936323278115,9.115489260024198 58.77545491140577)))"
21650006530000,25,13,12,54.9,"MULTIPOLYGON(((9.201511294903904 58.77936323278115,9.194028480418707 58.82403768091218,9.280182783475995 58.82789553907598,9.287556048997274 58.78321434317098,9.201511294903904 58.77936323278115)))"
21700006530000,85,41,44,47.9,"MULTIPOLYGON(((9.287556048997274 58.78321434317098,9.280182783475995 58.82789553907598,9.366359574029474 58.83169605679051,9.373623195409246 58.787008211940936,9.287556048997274 58.78321434317098)))"
21750006530000,230,127,103,48,"MULTIPOLYGON(((9.373623195409246 58.787008211940936,9.366359574029474 58.83169605679051,9.45255852328616 58.83543920374403,9.459712406704138 58.790744808897635,9.373623195409246 58.787008211940936)))"
22950006530000,36,20,16,40.6,"MULTIPOLYGON(((11.445093601999053 58.860816733203166,11.44048641108883 58.90563422169434,11.527117250205276 58.90799254221773,11.531612867725373 58.8631709095304,11.445093601999053 58.860816733203166)))"
23000006530000,19,11,8,57.4,"MULTIPOLYGON(((11.531612867725373 58.8631709095304,11.527117250205276 58.90799254221773,11.613761873781739 58.91029288040917,11.618145859118034 58.86546720487257,11.531612867725373 58.8631709095304)))"
19500006535000,41,23,18,41.3,"MULTIPOLYGON(((5.515233411801822 58.604406729730336,5.503112282176258 58.64869760413335,5.58810191490565 58.65499718349608,5.600118512328935 58.61069541922403,5.515233411801822 58.604406729730336)))"
19550006535000,6270,3204,3066,35.2,"MULTIPOLYGON(((5.600118512328935 58.61069541922403,5.58810191490565 58.65499718349608,5.673127714024787 58.661241038641855,5.685039629129701 58.616928476960325,5.600118512328935 58.61069541922403)))"
19600006535000,227,130,97,40.4,"MULTIPOLYGON(((5.685039629129701 58.616928476960325,5.673127714024787 58.661241038641855,5.758189379302492 58.66742912099106,5.769996463129512 58.623105854544505,5.685039629129701 58.616928476960325)))"
19650006535000,108,61,47,40.2,"MULTIPOLYGON(((5.769996463129512 58.623105854544505,5.758189379302492 58.66742912099106,5.843286609675664 58.673561382360745,5.854988714427536 58.62922750397712,5.769996463129512 58.623105854544505)))"
19700006535000,27,11,16,43,"MULTIPOLYGON(((5.854988714427536 58.62922750397712,5.843286609675664 58.673561382360745,5.928419103255157 58.679637774966146,5.94001608230257 58.63529337765553,5.854988714427536 58.62922750397712)))"
19750006535000,86,49,37,41.7,"MULTIPOLYGON(((5.94001608230257 58.63529337765553,5.928419103255157 58.679637774966146,6.013586557331709 58.68565825142185,6.02507826521891 58.64130342837514,5.94001608230257 58.63529337765553)))"
19800006535000,43,24,19,49.8,"MULTIPOLYGON(((6.02507826521891 58.64130342837514,6.013586557331709 58.68565825142185,6.098788668381896 58.69162276474323,6.110174960832284 58.64725760933065,6.02507826521891 58.64130342837514)))"
19850006535000,106,59,47,41.7,"MULTIPOLYGON(((6.110174960832284 58.64725760933065,6.098788668381896 58.69162276474323,6.184025132074144 58.697531268347774,6.195305865995845 58.653155874117516,6.110174960832284 58.64725760933065)))"
19900006535000,16,9,7,36.4,"MULTIPOLYGON(((6.195305865995845 58.653155874117516,6.184025132074144 58.697531268347774,6.269295643274816 58.70338371605626,6.280470676766178 58.658998176733064,6.195305865995845 58.653155874117516)))"
19950006535000,17,9,8,43.6,"MULTIPOLYGON(((6.280470676766178 58.658998176733064,6.269295643274816 58.70338371605626,6.354599896054289 58.70918006209416,6.365669088409375 58.66478447157793,6.280470676766178 58.658998176733064)))"
20000006535000,31,13,18,35.6,"MULTIPOLYGON(((6.365669088409375 58.66478447157793,6.354599896054289 58.70918006209416,6.439937583693109 58.714920261092956,6.450900795407144 58.670514713457266,6.365669088409375 58.66478447157793)))"
20050006535000,1,1,0,0,"MULTIPOLYGON(((6.450900795407144 58.670514713457266,6.439937583693109 58.714920261092956,6.5253083986882 58.72060426809129,6.53616549146298 58.676188857581984,6.450900795407144 58.670514713457266)))"
20200006535000,78,35,43,42,"MULTIPOLYGON(((6.706792621708927 58.687368675447836,6.69614817685423 58.73180352828491,6.781616521157255 58.73731869360501,6.792154439470944 58.69287426165104,6.706792621708927 58.687368675447836)))"
20250006535000,1,1,0,0,"MULTIPOLYGON(((6.792154439470944 58.69287426165104,6.781616521157255 58.73731869360501,6.867116755093421 58.742777491176774,6.877548013447446 58.69832357502631,6.792154439470944 58.69287426165104)))"
20600006535000,15,8,7,41.9,"MULTIPOLYGON(((7.390558921100928 58.729835361360024,7.380770354888494 58.77434418022681,7.466485057816648 58.779407225486004,7.476166064949725 58.734889591401085,7.390558921100928 58.729835361360024)))"
20650006535000,93,48,45,46.3,"MULTIPOLYGON(((7.476166064949725 58.734889591401085,7.466485057816648 58.779407225486004,7.552229139256662 58.784413571423215,7.561802463898227 58.73988721831833,7.476166064949725 58.734889591401085)))"
20800006535000,4,3,1,0,"MULTIPOLYGON(((7.733161763073904 58.749712505591994,7.723804168554232 58.79425600753233,7.809634480128821 58.79909201986576,7.818884029578934 58.75454008841107,7.733161763073904 58.749712505591994)))"
20850006535000,23,11,12,48.2,"MULTIPOLYGON(((7.818884029578934 58.75454008841107,7.809634480128821 58.79909201986576,7.895492897663047 58.803871177202474,7.904634283753025 58.75931091303378,7.818884029578934 58.75454008841107)))"
21050006535000,58,27,31,42.8,"MULTIPOLYGON(((8.162049783573627 58.773282462795535,8.15323358436196 58.81786714284526,8.239201220777536 58.822418505954545,8.24790879643542 58.77782588184311,8.162049783573627 58.773282462795535)))"
21150006535000,11,6,5,49.2,"MULTIPOLYGON(((8.33379419772394 58.7823123584418,8.32519535740318 58.82691282909712,8.41121567115111 58.83135007657282,8.419705665666449 58.78674185703016,8.33379419772394 58.7823123584418)))"
21200006535000,20,11,9,37,"MULTIPOLYGON(((8.419705665666449 58.78674185703016,8.41121567115111 58.83135007657282,8.497261838304203 58.835730213115234,8.505642877865272 58.791114342478856,8.419705665666449 58.78674185703016)))"
21250006535000,38,21,17,50.5,"MULTIPOLYGON(((8.505642877865272 58.791114342478856,8.497261838304203 58.835730213115234,8.58333353452316 58.84005320389267,8.591605511304925 58.79542978009171,8.505642877865272 58.791114342478856)))"
21300006535000,14,7,7,42.8,"MULTIPOLYGON(((8.591605511304925 58.79542978009171,8.58333353452316 58.84005320389267,8.669430434853727 58.8443190145092,8.6775932423593 58.799688135606644,8.591605511304925 58.79542978009171)))"
21450006535000,57,30,27,44.5,"MULTIPOLYGON(((8.84964269979797 58.80803346547111,8.84169854500157 58.852678959860626,8.927869101901127 58.85677302799134,8.935703775942 58.81212037347603,8.84964269979797 58.80803346547111)))"
21500006535000,8,4,4,57.8,"MULTIPOLYGON(((8.935703775942 58.81212037347603,8.927869101901127 58.85677302799134,9.014063557091575 58.86080978275474,9.021788649234836 58.81615006669572,8.935703775942 58.81212037347603)))"
21550006535000,553,285,268,46.5,"MULTIPOLYGON(((9.021788649234836 58.81615006669572,9.014063557091575 58.86080978275474,9.100281582653539 58.86478919194843,9.10789699310613 58.8201225130534,9.021788649234836 58.81615006669572)))"
21600006535000,123,60,63,44.3,"MULTIPOLYGON(((9.10789699310613 58.8201225130534,9.100281582653539 58.86478919194843,9.186522850096805 58.86871122381148,9.194028480418707 58.82403768091218,9.10789699310613 58.8201225130534)))"
21650006535000,37,18,19,44.4,"MULTIPOLYGON(((9.194028480418707 58.82403768091218,9.186522850096805 58.86871122381148,9.272787030367782 58.87257584702557,9.280182783475995 58.82789553907598,9.194028480418707 58.82403768091218)))"
21700006535000,107,54,53,55.1,"MULTIPOLYGON(((9.280182783475995 58.82789553907598,9.272787030367782 58.87257584702557,9.359073793857004 58.87638303071566,9.366359574029474 58.83169605679051,9.280182783475995 58.82789553907598)))"
21750006535000,5468,2699,2769,47.1,"MULTIPOLYGON(((9.366359574029474 58.83169605679051,9.359073793857004 58.87638303071566,9.445382810406661 58.8801327444511,9.45255852328616 58.83543920374403,9.366359574029474 58.83169605679051)))"
21800006535000,191,105,86,52.4,"MULTIPOLYGON(((9.45255852328616 58.83543920374403,9.445382810406661 58.8801327444511,9.531713749318197 58.883824958246414,9.538779301916133 58.83912495006834,9.45255852328616 58.83543920374403)))"
21850006535000,60,30,30,49.9,"MULTIPOLYGON(((9.538779301916133 58.83912495006834,9.531713749318197 58.883824958246414,9.618066279359887 58.88745964256218,9.625021580060087 58.842753266339635,9.538779301916133 58.83912495006834)))"
22950006535000,107,59,48,44.9,"MULTIPOLYGON(((11.44048641108883 58.90563422169434,11.435865095777961 58.95045117288055,11.522607848168564 58.95281364831302,11.527117250205276 58.90799254221773,11.44048641108883 58.90563422169434)))"
23000006535000,39,19,20,40.2,"MULTIPOLYGON(((11.527117250205276 58.90799254221773,11.522607848168564 58.95281364831302,11.60936444415242 58.95511803980757,11.613761873781739 58.91029288040917,11.527117250205276 58.90799254221773)))"
23050006535000,124,68,56,50.2,"MULTIPOLYGON(((11.613761873781739 58.91029288040917,11.60936444415242 58.95511803980757,11.696134542060665 58.95736432876118,11.700419941596001 58.91253521773907,11.613761873781739 58.91029288040917)))"
19500006540000,641,349,292,37.2,"MULTIPOLYGON(((5.503112282176258 58.64869760413335,5.490954686626934 58.69298660251412,5.576049150952998 58.699297098955014,5.58810191490565 58.65499718349608,5.503112282176258 58.64869760413335)))"
19550006540000,5940,2982,2958,39.2,"MULTIPOLYGON(((5.58810191490565 58.65499718349608,5.576049150952998 58.699297098955014,5.661179932622654 58.70555177850872,5.673127714024787 58.661241038641855,5.58810191490565 58.65499718349608)))"
19600006540000,503,270,233,39.8,"MULTIPOLYGON(((5.673127714024787 58.661241038641855,5.661179932622654 58.70555177850872,5.746346730242333 58.711750592409665,5.758189379302492 58.66742912099106,5.673127714024787 58.661241038641855)))"
19650006540000,883,455,428,37.6,"MULTIPOLYGON(((5.758189379302492 58.66742912099106,5.746346730242333 58.711750592409665,5.831549241580779 58.717893492290465,5.843286609675664 58.673561382360745,5.758189379302492 58.66742912099106)))"
19700006540000,39,20,19,38.7,"MULTIPOLYGON(((5.843286609675664 58.673561382360745,5.831549241580779 58.717893492290465,5.916787163575 58.72398043018319,5.928419103255157 58.679637774966146,5.843286609675664 58.673561382360745)))"
19750006540000,80,39,41,39.9,"MULTIPOLYGON(((5.928419103255157 58.679637774966146,5.916787163575 58.72398043018319,6.002060192336187 58.73001135852076,6.013586557331709 58.68565825142185,5.928419103255157 58.679637774966146)))"
19800006540000,88,41,47,37.2,"MULTIPOLYGON(((6.013586557331709 58.68565825142185,6.002060192336187 58.73001135852076,6.087368023155758 58.735986230138224,6.098788668381896 58.69162276474323,6.013586557331709 58.68565825142185)))"
19850006540000,12,7,5,28.7,"MULTIPOLYGON(((6.098788668381896 58.69162276474323,6.087368023155758 58.735986230138224,6.172710350511363 58.74190499827413,6.184025132074144 58.697531268347774,6.098788668381896 58.69162276474323)))"
19900006540000,38,18,20,43.9,"MULTIPOLYGON(((6.184025132074144 58.697531268347774,6.172710350511363 58.74190499827413,6.258086868073023 58.74776761657179,6.269295643274816 58.70338371605626,6.184025132074144 58.697531268347774)))"
19950006540000,8,4,4,41.4,"MULTIPOLYGON(((6.269295643274816 58.70338371605626,6.258086868073023 58.74776761657179,6.343497268709252 58.753574039080625,6.354599896054289 58.70918006209416,6.269295643274816 58.70338371605626)))"
20200006540000,26,14,12,43.5,"MULTIPOLYGON(((6.69614817685423 58.73180352828491,6.685471531665246 58.77623686650164,6.771046713085091 58.781761635110946,6.781616521157255 58.73731869360501,6.69614817685423 58.73180352828491)))"
20250006540000,5,3,2,53.8,"MULTIPOLYGON(((6.781616521157255 58.73731869360501,6.771046713085091 58.781761635110946,6.856653918308726 58.78722994082762,6.867116755093421 58.742777491176774,6.781616521157255 58.73731869360501)))"
20550006540000,28,14,14,43.4,"MULTIPOLYGON(((7.295085346879524 58.76922447562435,7.285159335528795 58.813723033084045,7.370952093639227 58.818851671535654,7.380770354888494 58.77434418022681,7.295085346879524 58.76922447562435)))"
20650006540000,13,9,4,32.2,"MULTIPOLYGON(((7.466485057816648 58.779407225486004,7.45677467205519 58.82392355437041,7.542626753094286 58.82893864145431,7.552229139256662 58.784413571423215,7.466485057816648 58.779407225486004)))"
20700006540000,1,1,0,0,"MULTIPOLYGON(((7.552229139256662 58.784413571423215,7.542626753094286 58.82893864145431,7.628508018370092 58.83389689307785,7.638002282102105 58.789363178482596,7.552229139256662 58.784413571423215)))"
20800006540000,212,102,110,47.6,"MULTIPOLYGON(((7.723804168554232 58.79425600753233,7.714418148799004 58.83879826995705,7.800356824607118 58.84364273323463,7.809634480128821 58.79909201986576,7.723804168554232 58.79425600753233)))"
20850006540000,72,38,34,38.7,"MULTIPOLYGON(((7.809634480128821 58.79909201986576,7.800356824607118 58.84364273323463,7.886323725337146 58.84843024448123,7.895492897663047 58.803871177202474,7.809634480128821 58.79909201986576)))"
21000006540000,35,17,18,41.8,"MULTIPOLYGON(((8.067292770607706 58.81325877590205,8.058340916358734 58.85783425930943,8.144390562381702 58.862450688181255,8.15323358436196 58.81786714284526,8.067292770607706 58.81325877590205)))"
21100006540000,16,6,10,38.7,"MULTIPOLYGON(((8.239201220777536 58.822418505954545,8.23046714480352 58.86701001560461,8.316570339855238 58.871512205305606,8.32519535740318 58.82691282909712,8.239201220777536 58.822418505954545)))"
21150006540000,73,37,36,47.9,"MULTIPOLYGON(((8.32519535740318 58.82691282909712,8.316570339855238 58.871512205305606,8.402699823126916 58.875957221444615,8.41121567115111 58.83135007657282,8.32519535740318 58.82691282909712)))"
21250006540000,9,4,5,35.1,"MULTIPOLYGON(((8.497261838304203 58.835730213115234,8.488855269574783 58.88034502861739,8.5750363535285 58.88467559185604,8.58333353452316 58.84005320389267,8.497261838304203 58.835730213115234)))"
21300006540000,25,12,13,40.3,"MULTIPOLYGON(((8.58333353452316 58.84005320389267,8.5750363535285 58.88467559185604,8.661242748698413 58.88894887663002,8.669430434853727 58.8443190145092,8.58333353452316 58.84005320389267)))"
21450006540000,20,10,10,51.2,"MULTIPOLYGON(((8.84169854500157 58.852678959860626,8.833730164475593 58.89732347485492,8.920010529472991 58.901424721440684,8.927869101901127 58.85677302799134,8.84169854500157 58.852678959860626)))"
21500006540000,408,223,185,44.3,"MULTIPOLYGON(((8.927869101901127 58.85677302799134,8.920010529472991 58.901424721440684,9.006314894481651 58.90546855583349,9.014063557091575 58.86080978275474,8.927869101901127 58.85677302799134)))"
21550006540000,594,299,295,43.3,"MULTIPOLYGON(((9.014063557091575 58.86080978275474,9.006314894481651 58.90546855583349,9.092642930225749 58.90945494570455,9.100281582653539 58.86478919194843,9.014063557091575 58.86080978275474)))"
21600006540000,122,59,63,42.9,"MULTIPOLYGON(((9.100281582653539 58.86478919194843,9.092642930225749 58.90945494570455,9.178994306854552 58.913383859168356,9.186522850096805 58.86871122381148,9.100281582653539 58.86478919194843)))"
21650006540000,121,64,57,40.8,"MULTIPOLYGON(((9.186522850096805 58.86871122381148,9.178994306854552 58.913383859168356,9.265368693949945 58.91725526478349,9.272787030367782 58.87257584702557,9.186522850096805 58.86871122381148)))"
21700006540000,1649,828,821,42.8,"MULTIPOLYGON(((9.272787030367782 58.87257584702557,9.265368693949945 58.91725526478349,9.351765760533967 58.921069131553686,9.359073793857004 58.87638303071566,9.272787030367782 58.87257584702557)))"
21750006540000,1992,991,1001,42.6,"MULTIPOLYGON(((9.359073793857004 58.87638303071566,9.351765760533967 58.921069131553686,9.438185175076427 58.92482542892864,9.445382810406661 58.8801327444511,9.359073793857004 58.87638303071566)))"
21800006540000,102,56,46,53.3,"MULTIPOLYGON(((9.445382810406661 58.8801327444511,9.438185175076427 58.92482542892864,9.524626605502515 58.92852412680498,9.531713749318197 58.883824958246414,9.445382810406661 58.8801327444511)))"
21850006540000,20,11,9,57.1,"MULTIPOLYGON(((9.531713749318197 58.883824958246414,9.524626605502515 58.92852412680498,9.611089719200463 58.932165195527,9.618066279359887 58.88745964256218,9.531713749318197 58.883824958246414)))"
22950006540000,92,46,46,43.9,"MULTIPOLYGON(((11.435865095777961 58.95045117288055,11.431229595488603 58.99526758604713,11.5180846024816 58.997634227148374,11.522607848168564 58.95281364831302,11.435865095777961 58.95045117288055)))"
23000006540000,176,96,80,45.1,"MULTIPOLYGON(((11.522607848168564 58.95281364831302,11.5180846024816 58.997634227148374,11.604953512543089 58.99994268244554,11.60936444415242 58.95511803980757,11.522607848168564 58.95281364831302)))"
23050006540000,52,25,27,46.1,"MULTIPOLYGON(((11.60936444415242 58.95511803980757,11.604953512543089 58.99994268244554,11.691835982549286 59.00219293326174,11.696134542060665 58.95736432876118,11.60936444415242 58.95511803980757)))"
19500006545000,654,346,308,40.6,"MULTIPOLYGON(((5.490954686626934 58.69298660251412,5.478760473042394 58.73727371843035,5.563960069516151 58.74359515927251,5.576049150952998 58.699297098955014,5.490954686626934 58.69298660251412)))"
19550006545000,9198,4664,4534,39.2,"MULTIPOLYGON(((5.576049150952998 58.699297098955014,5.563960069516151 58.74359515927251,5.649196135130888 58.74986069034564,5.661179932622654 58.70555177850872,5.576049150952998 58.699297098955014)))"
19600006545000,7245,3649,3596,36.9,"MULTIPOLYGON(((5.661179932622654 58.70555177850872,5.649196135130888 58.74986069034564,5.734468367324771 58.756070262697385,5.746346730242333 58.711750592409665,5.661179932622654 58.70555177850872)))"
19650006545000,1272,640,632,33.5,"MULTIPOLYGON(((5.746346730242333 58.711750592409665,5.734468367324771 58.756070262697385,5.819776462692489 58.76222382777483,5.831549241580779 58.717893492290465,5.746346730242333 58.711750592409665)))"
19700006545000,956,511,445,36.8,"MULTIPOLYGON(((5.831549241580779 58.717893492290465,5.819776462692489 58.76222382777483,5.905120116991234 58.76832133742601,5.916787163575 58.72398043018319,5.831549241580779 58.717893492290465)))"
19750006545000,141,76,65,42.1,"MULTIPOLYGON(((5.916787163575 58.72398043018319,5.905120116991234 58.76832133742601,5.990499025146665 58.77436274390112,6.002060192336187 58.73001135852076,5.916787163575 58.72398043018319)))"
19800006545000,54,27,27,36.9,"MULTIPOLYGON(((6.002060192336187 58.73001135852076,5.990499025146665 58.77436274390112,6.07591288125897 58.780347999853994,6.087368023155758 58.735986230138224,6.002060192336187 58.73001135852076)))"
19900006545000,34,18,16,41.1,"MULTIPOLYGON(((6.172710350511363 58.74190499827413,6.16136137860894 58.78627705834326,6.246844209664108 58.79214987283385,6.258086868073023 58.74776761657179,6.172710350511363 58.74190499827413)))"
19950006545000,50,25,25,41.2,"MULTIPOLYGON(((6.258086868073023 58.74776761657179,6.246844209664108 58.79214987283385,6.332361066084934 58.797966397198145,6.343497268709252 58.753574039080625,6.258086868073023 58.74776761657179)))"
20000006545000,31,13,18,41.7,"MULTIPOLYGON(((6.343497268709252 58.753574039080625,6.332361066084934 58.797966397198145,6.417911638731017 58.803726585717435,6.428941244493236 58.75932422025747,6.343497268709252 58.753574039080625)))"
20200006545000,21,11,10,55.6,"MULTIPOLYGON(((6.685471531665246 58.77623686650164,6.674762550736215 58.820668685177,6.76044488108292 58.82620308135017,6.771046713085091 58.781761635110946,6.685471531665246 58.77623686650164)))"
20250006545000,15,8,7,34.9,"MULTIPOLYGON(((6.771046713085091 58.781761635110946,6.76044488108292 58.82620308135017,6.846159370161311 58.83168091926179,6.856653918308726 58.78722994082762,6.771046713085091 58.781761635110946)))"
20750006545000,18,10,8,35.2,"MULTIPOLYGON(((7.628508018370092 58.83389689307785,7.618984889369921 58.87842934265131,7.705003583550678 58.88333928911542,7.714418148799004 58.83879826995705,7.628508018370092 58.83389689307785)))"
20800006545000,7,3,4,40.3,"MULTIPOLYGON(((7.714418148799004 58.83879826995705,7.705003583550678 58.88333928911542,7.791050944050761 58.8881922248586,7.800356824607118 58.84364273323463,7.714418148799004 58.83879826995705)))"
20850006545000,68,37,31,48.4,"MULTIPOLYGON(((7.800356824607118 58.84364273323463,7.791050944050761 58.8881922248586,7.877126649111453 58.89298811130161,7.886323725337146 58.84843024448123,7.800356824607118 58.84364273323463)))"
20950006545000,4,1,3,0,"MULTIPOLYGON(((7.972318529855388 58.853160765696316,7.963230376292855 58.897726910295695,8.049361802480927 58.90240858412375,8.058340916358734 58.85783425930943,7.972318529855388 58.853160765696316)))"
21100006545000,29,17,12,58.2,"MULTIPOLYGON(((8.23046714480352 58.86701001560461,8.221706456092747 58.911600407577986,8.307919033981703 58.91611048393782,8.316570339855238 58.871512205305606,8.23046714480352 58.86701001560461)))"
21250006545000,31,18,13,40.5,"MULTIPOLYGON(((8.488855269574783 58.88034502861739,8.480423063236296 58.924958786024774,8.56671386121564 58.92929694110423,8.5750363535285 58.88467559185604,8.488855269574783 58.88034502861739)))"
21300006545000,13,8,5,51.5,"MULTIPOLYGON(((8.5750363535285 58.88467559185604,8.56671386121564 58.92929694110423,8.653030078127767 58.933577719173506,8.661242748698413 58.88894887663002,8.5750363535285 58.88467559185604)))"
21350006545000,39,20,19,43.1,"MULTIPOLYGON(((8.661242748698413 58.88894887663002,8.653030078127767 58.933577719173506,8.73937138572398 58.93780108600682,8.747474128182878 58.89316484884724,8.661242748698413 58.88894887663002)))"
21400006545000,77,44,33,40.9,"MULTIPOLYGON(((8.747474128182878 58.89316484884724,8.73937138572398 58.93780108600682,8.825737455146623 58.94196700781939,8.833730164475593 58.89732347485492,8.747474128182878 58.89316484884724)))"
21500006545000,28,14,14,43.9,"MULTIPOLYGON(((8.920010529472991 58.901424721440684,8.912127956936523 58.946075451268506,8.998542561040464 58.950126383454375,9.006314894481651 58.90546855583349,8.920010529472991 58.901424721440684)))"
21600006545000,402,213,189,42.6,"MULTIPOLYGON(((9.092642930225749 58.90945494570455,9.084980936818683 58.95411977192121,9.171442753052405 58.958055584658126,9.178994306854552 58.913383859168356,9.092642930225749 58.90945494570455)))"
21700006545000,252,135,117,41.4,"MULTIPOLYGON(((9.265368693949945 58.91725526478349,9.257927677951423 58.96193379010009,9.344435379161716 58.965754357128866,9.351765760533967 58.921069131553686,9.265368693949945 58.91725526478349)))"
21750006545000,40,22,18,53.8,"MULTIPOLYGON(((9.351765760533967 58.921069131553686,9.344435379161716 58.965754357128866,9.430965523773068 58.969517255073825,9.438185175076427 58.92482542892864,9.351765760533967 58.921069131553686)))"
21800006545000,169,92,77,44.1,"MULTIPOLYGON(((9.438185175076427 58.92482542892864,9.430965523773068 58.969517255073825,9.517517778326766 58.973222453713035,9.524626605502515 58.92852412680498,9.438185175076427 58.92482542892864)))"
21850006545000,741,399,342,43.5,"MULTIPOLYGON(((9.524626605502515 58.92852412680498,9.517517778326766 58.973222453713035,9.604091808823295 58.97686992327399,9.611089719200463 58.932165195527,9.524626605502515 58.92852412680498)))"
21900006545000,350,167,183,48.8,"MULTIPOLYGON(((9.611089719200463 58.932165195527,9.604091808823295 58.97686992327399,9.69068728073009 58.98045963443458,9.697574183029221 58.935748605887795,9.611089719200463 58.932165195527)))"
22000006545000,683,350,333,47.3,"MULTIPOLYGON(((9.784079663326207 58.939274329129844,9.777303858989308 58.98399155832389,9.863941208025635 58.98746566652305,9.870605825915032 58.942742336946004,9.784079663326207 58.939274329129844)))"
22050006545000,640,320,320,45.8,"MULTIPOLYGON(((9.870605825915032 58.942742336946004,9.863941208025635 58.98746566652305,9.950598991754116 58.99088193106622,9.957152336113294 58.94615260148036,9.870605825915032 58.942742336946004)))"
22100006545000,696,324,372,46,"MULTIPOLYGON(((9.957152336113294 58.94615260148036,9.950598991754116 58.99088193106622,10.037276873588041 58.994240324441186,10.043718858740405 58.949505095328945,9.957152336113294 58.94615260148036)))"
22700006545000,735,366,369,56.4,"MULTIPOLYGON(((10.997175091305971 58.9825622796998,10.991963306526506 59.02735574256409,11.07885594009193 59.03001770220739,11.083955448446497 58.98521955340781,10.997175091305971 58.9825622796998)))"
22750006545000,7,3,4,75.3,"MULTIPOLYGON(((11.083955448446497 58.98521955340781,11.07885594009193 59.03001770220739,11.165764254109368 59.03262147466786,11.170751418941549 58.98781874166188,11.083955448446497 58.98521955340781)))"
22950006545000,279,149,130,44.5,"MULTIPOLYGON(((11.431229595488603 58.99526758604713,11.426579849292636 59.04008346047461,11.513547453668735 59.04245427805135,11.5180846024816 58.997634227148374,11.431229595488603 58.99526758604713)))"
23000006545000,73,37,36,36.7,"MULTIPOLYGON(((11.5180846024816 58.997634227148374,11.513547453668735 59.04245427805135,11.600529020933028 59.0447668076965,11.604953512543089 58.99994268244554,11.5180846024816 58.997634227148374)))"
19500006550000,97,55,42,45.4,"MULTIPOLYGON(((5.478760473042394 58.73727371843035,5.466529488461859 58.78155894540278,5.551834518796763 58.78789135808378,5.563960069516151 58.74359515927251,5.478760473042394 58.73727371843035)))"
19550006550000,10337,5261,5076,36.8,"MULTIPOLYGON(((5.563960069516151 58.74359515927251,5.551834518796763 58.78789135808378,5.637176170919408 58.79416776790164,5.649196135130888 58.74986069034564,5.563960069516151 58.74359515927251)))"
19600006550000,7037,3645,3392,37.1,"MULTIPOLYGON(((5.649196135130888 58.74986069034564,5.637176170919408 58.79416776790164,5.722554141093784 58.80038812571615,5.734468367324771 58.756070262697385,5.649196135130888 58.74986069034564)))"
19650006550000,2436,1276,1160,36.3,"MULTIPOLYGON(((5.734468367324771 58.756070262697385,5.722554141093784 58.80038812571615,5.807968124734589 58.80655238278796,5.819776462692489 58.76222382777483,5.734468367324771 58.756070262697385)))"
19700006550000,10745,5430,5315,35.8,"MULTIPOLYGON(((5.819776462692489 58.76222382777483,5.807968124734589 58.80655238278796,5.8934178164132 58.81266049078005,5.905120116991234 58.76832133742601,5.819776462692489 58.76222382777483)))"
19750006550000,130,73,57,41.5,"MULTIPOLYGON(((5.905120116991234 58.76832133742601,5.8934178164132 58.81266049078005,5.978902909863703 58.818712401758965,5.990499025146665 58.77436274390112,5.905120116991234 58.76832133742601)))"
19800006550000,129,69,60,40.8,"MULTIPOLYGON(((5.990499025146665 58.77436274390112,5.978902909863703 58.818712401758965,6.064423097988975 58.824708068196266,6.07591288125897 58.780347999853994,5.990499025146665 58.77436274390112)))"
19850006550000,6,4,2,46.3,"MULTIPOLYGON(((6.07591288125897 58.780347999853994,6.064423097988975 58.824708068196266,6.149978072866803 58.83064744296983,6.16136137860894 58.78627705834326,6.07591288125897 58.780347999853994)))"
19900006550000,95,47,48,45.2,"MULTIPOLYGON(((6.16136137860894 58.78627705834326,6.149978072866803 58.83064744296983,6.235567525756062 58.83653047936513,6.246844209664108 58.79214987283385,6.16136137860894 58.78627705834326)))"
19950006550000,447,235,212,35.9,"MULTIPOLYGON(((6.246844209664108 58.79214987283385,6.235567525756062 58.83653047936513,6.321191147102923 58.84235713107669,6.332361066084934 58.797966397198145,6.246844209664108 58.79214987283385)))"
20000006550000,24,12,12,41.5,"MULTIPOLYGON(((6.332361066084934 58.797966397198145,6.321191147102923 58.84235713107669,6.406848626547132 58.8481273522092,6.417911638731017 58.803726585717435,6.332361066084934 58.797966397198145)))"
20050006550000,8,3,5,48.8,"MULTIPOLYGON(((6.417911638731017 58.803726585717435,6.406848626547132 58.8481273522092,6.492539652928313 58.853841097278995,6.503495617667396 58.809430393083055,6.417911638731017 58.803726585717435)))"
20200006550000,14,8,6,34.1,"MULTIPOLYGON(((6.674762550736215 58.820668685177,6.664021097897685 58.865098979361406,6.749810890221982 58.87064302747608,6.76044488108292 58.82620308135017,6.674762550736215 58.820668685177)))"
20250006550000,57,35,22,38.9,"MULTIPOLYGON(((6.76044488108292 58.82620308135017,6.749810890221982 58.87064302747608,6.835632976968391 58.87613042173475,6.846159370161311 58.83168091926179,6.76044488108292 58.82620308135017)))"
20800006550000,78,45,33,43.1,"MULTIPOLYGON(((7.705003583550678 58.88333928911542,7.695560351868334 58.92787906123459,7.78171671882026 58.93274049105688,7.791050944050761 58.8881922248586,7.705003583550678 58.88333928911542)))"
21050006550000,15,9,6,44.9,"MULTIPOLYGON(((8.13552060389456 58.90703309550138,8.126623594514086 58.95161436148386,8.21291904158362 58.95618967864025,8.221706456092747 58.911600407577986,8.13552060389456 58.90703309550138)))"
21150006550000,3,2,1,0,"MULTIPOLYGON(((8.307919033981703 58.91611048393782,8.299241328050346 58.9607076618457,8.385590126838306 58.96516827497942,8.3941580118221 58.92056328860101,8.307919033981703 58.91611048393782)))"
21200006550000,14,6,8,49.9,"MULTIPOLYGON(((8.3941580118221 58.92056328860101,8.385590126838306 58.96516827497942,8.471965110228714 58.969571482359186,8.480423063236296 58.924958786024774,8.3941580118221 58.92056328860101)))"
21250006550000,97,52,45,52,"MULTIPOLYGON(((8.480423063236296 58.924958786024774,8.471965110228714 58.969571482359186,8.558365949867271 58.97391724874245,8.56671386121564 58.92929694110423,8.480423063236296 58.924958786024774)))"
21600006550000,377,177,200,46.2,"MULTIPOLYGON(((9.084980936818683 58.95411977192121,9.077295502860878 58.99878366818322,9.163868090490986 59.002726397942084,9.171442753052405 58.958055584658126,9.084980936818683 58.95411977192121)))"
21650006550000,202,100,102,38.6,"MULTIPOLYGON(((9.171442753052405 58.958055584658126,9.163868090490986 59.002726397942084,9.25046388554894 59.006611420712005,9.257927677951423 58.96193379010009,9.171442753052405 58.958055584658126)))"
21700006550000,48,24,24,42.5,"MULTIPOLYGON(((9.257927677951423 58.96193379010009,9.25046388554894 59.006611420712005,9.337082554296991 59.010438705252106,9.344435379161716 58.965754357128866,9.257927677951423 58.96193379010009)))"
21750006550000,78,44,34,42.8,"MULTIPOLYGON(((9.344435379161716 58.965754357128866,9.337082554296991 59.010438705252106,9.423723762437234 59.01420822077089,9.430965523773068 58.969517255073825,9.344435379161716 58.965754357128866)))"
21800006550000,2,2,0,0,"MULTIPOLYGON(((9.430965523773068 58.969517255073825,9.423723762437234 59.01420822077089,9.510387175119345 59.01791993692716,9.517517778326766 58.973222453713035,9.430965523773068 58.969517255073825)))"
21850006550000,191,97,94,50.2,"MULTIPOLYGON(((9.517517778326766 58.973222453713035,9.510387175119345 59.01791993692716,9.597072456948316 59.02157382383093,9.604091808823295 58.97686992327399,9.517517778326766 58.973222453713035)))"
21900006550000,293,158,135,43.5,"MULTIPOLYGON(((9.604091808823295 58.97686992327399,9.597072456948316 59.02157382383093,9.683779271992291 59.025169852044264,9.69068728073009 58.98045963443458,9.604091808823295 58.97686992327399)))"
21950006550000,4863,2401,2462,44.2,"MULTIPOLYGON(((9.69068728073009 58.98045963443458,9.683779271992291 59.025169852044264,9.770507283790367 59.02870799258222,9.777303858989308 58.98399155832389,9.69068728073009 58.98045963443458)))"
22000006550000,285,137,148,53.4,"MULTIPOLYGON(((9.777303858989308 58.98399155832389,9.770507283790367 59.02870799258222,9.857256155360455 59.03218821691367,9.863941208025635 58.98746566652305,9.777303858989308 58.98399155832389)))"
22050006550000,1375,701,674,40.1,"MULTIPOLYGON(((9.863941208025635 58.98746566652305,9.857256155360455 59.03218821691367,9.944025549207185 59.035610496962114,9.950598991754116 58.99088193106622,9.863941208025635 58.98746566652305)))"
22100006550000,6525,3253,3272,42.7,"MULTIPOLYGON(((9.950598991754116 58.99088193106622,9.944025549207185 59.035610496962114,10.030815127329824 59.03897480510656,10.037276873588041 58.994240324441186,9.950598991754116 58.99088193106622)))"
22150006550000,4628,2260,2368,45.2,"MULTIPOLYGON(((10.037276873588041 58.994240324441186,10.030815127329824 59.03897480510656,10.117624551230225 59.04228111418235,10.123974516446827 58.99754081959034,10.037276873588041 58.994240324441186)))"
22200006550000,367,193,174,52.4,"MULTIPOLYGON(((10.123974516446827 58.99754081959034,10.117624551230225 59.04228111418235,10.204453481920824 59.045529397481914,10.21069158276397 59.00078338991145,10.123974516446827 58.99754081959034)))"
22250006550000,183,90,93,46.7,"MULTIPOLYGON(((10.21069158276397 59.00078338991145,10.204453481920824 59.045529397481914,10.291301579932654 59.0487196287556,10.297427734494976 59.0039680092584,10.21069158276397 59.00078338991145)))"
22650006550000,585,302,283,44,"MULTIPOLYGON(((10.905086695793301 59.02463561728213,10.89974633825077 59.06942368249271,10.986735498848683 59.07214860777316,10.991963306526506 59.02735574256409,10.905086695793301 59.02463561728213)))"
22700006550000,721,371,350,50.1,"MULTIPOLYGON(((10.991963306526506 59.02735574256409,10.986735498848683 59.07214860777316,11.07374075122059 59.074815265511454,11.07885594009193 59.03001770220739,10.991963306526506 59.02735574256409)))"
22750006550000,13,7,6,67.5,"MULTIPOLYGON(((11.07885594009193 59.03001770220739,11.07374075122059 59.074815265511454,11.160761751530583 59.07742363407784,11.165764254109368 59.03262147466786,11.07885594009193 59.03001770220739)))"
22900006550000,290,152,138,41.9,"MULTIPOLYGON(((11.339626552044813 59.037654374184434,11.334849618672564 59.082465419505446,11.421915795909175 59.08489879543855,11.426579849292636 59.04008346047461,11.339626552044813 59.037654374184434)))"
22950006550000,620,323,297,39.3,"MULTIPOLYGON(((11.426579849292636 59.04008346047461,11.421915795909175 59.08489879543855,11.508996341909857 59.087273800344775,11.513547453668735 59.04245427805135,11.426579849292636 59.04008346047461)))"
23000006550000,60,29,31,45.9,"MULTIPOLYGON(((11.513547453668735 59.04245427805135,11.508996341909857 59.087273800344775,11.596090910965383 59.089590414929475,11.600529020933028 59.0447668076965,11.513547453668735 59.04245427805135)))"
19500006555000,1,1,0,0,"MULTIPOLYGON(((5.466529488461859 58.78155894540278,5.454261579069285 58.82584227691513,5.539672346147094 58.83218568898769,5.551834518796763 58.78789135808378,5.466529488461859 58.78155894540278)))"
19550006555000,1212,625,587,39.9,"MULTIPOLYGON(((5.551834518796763 58.78789135808378,5.539672346147094 58.83218568898769,5.625119888514635 58.8384730048899,5.637176170919408 58.79416776790164,5.551834518796763 58.78789135808378)))"
19600006555000,7744,3898,3846,35,"MULTIPOLYGON(((5.637176170919408 58.79416776790164,5.625119888514635 58.8384730048899,5.710603901255809 58.8447041752927,5.722554141093784 58.80038812571615,5.637176170919408 58.79416776790164)))"
19650006555000,24685,12482,12203,35.2,"MULTIPOLYGON(((5.722554141093784 58.80038812571615,5.710603901255809 58.8447041752927,5.796124078599327 58.85087915126936,5.807968124734589 58.80655238278796,5.722554141093784 58.80038812571615)))"
19700006555000,1112,590,522,34.6,"MULTIPOLYGON(((5.807968124734589 58.80655238278796,5.796124078599327 58.85087915126936,5.88168011392473 58.85699788429675,5.8934178164132 58.81266049078005,5.807968124734589 58.80655238278796)))"
19750006555000,156,76,80,41,"MULTIPOLYGON(((5.8934178164132 58.81266049078005,5.88168011392473 58.85699788429675,5.967271699768455 58.863060326256836,5.978902909863703 58.818712401758965,5.8934178164132 58.81266049078005)))"
19800006555000,1071,551,520,34.7,"MULTIPOLYGON(((5.978902909863703 58.818712401758965,5.967271699768455 58.863060326256836,6.052898527829936 58.86906642943797,6.064423097988975 58.824708068196266,5.978902909863703 58.818712401758965)))"
19850006555000,39,24,15,44.6,"MULTIPOLYGON(((6.064423097988975 58.824708068196266,6.052898527829936 58.86906642943797,6.138560288977787 58.87501614653621,6.149978072866803 58.83064744296983,6.064423097988975 58.824708068196266)))"
19900006555000,183,90,93,41.7,"MULTIPOLYGON(((6.149978072866803 58.83064744296983,6.138560288977787 58.87501614653621,6.224256673255999 58.880909430656715,6.235567525756062 58.83653047936513,6.149978072866803 58.83064744296983)))"
19950006555000,76,42,34,40.5,"MULTIPOLYGON(((6.235567525756062 58.83653047936513,6.224256673255999 58.880909430656715,6.30998736989021 58.88674623531509,6.321191147102923 58.84235713107669,6.235567525756062 58.83653047936513)))"
20000006555000,21,12,9,45,"MULTIPOLYGON(((6.321191147102923 58.84235713107669,6.30998736989021 58.88674623531509,6.395752067293972 58.89252651443863,6.406848626547132 58.8481273522092,6.321191147102923 58.84235713107669)))"
20300006555000,282,152,130,41.4,"MULTIPOLYGON(((6.835632976968391 58.87613042173475,6.825074604291153 58.92057844347442,6.911036718328012 58.926018625082826,6.921487043072224 58.88156111873081,6.835632976968391 58.87613042173475)))"
20350006555000,3,2,1,0,"MULTIPOLYGON(((6.921487043072224 58.88156111873081,6.911036718328012 58.926018625082826,6.997030629831077 58.93140197028467,7.007372772707499 58.88693507547677,6.921487043072224 58.88156111873081)))"
20750006555000,48,30,18,45.7,"MULTIPOLYGON(((7.609432772864052 58.92296052333705,7.599851545919757 58.967490431246496,7.686088332122813 58.972417582519554,7.695560351868334 58.92787906123459,7.609432772864052 58.92296052333705)))"
20800006555000,12,6,6,58.9,"MULTIPOLYGON(((7.695560351868334 58.92787906123459,7.686088332122813 58.972417582519554,7.772354028594915 58.97728752812709,7.78171671882026 58.93274049105688,7.695560351868334 58.92787906123459)))"
20850006555000,4,1,3,0,"MULTIPOLYGON(((7.78171671882026 58.93274049105688,7.772354028594915 58.97728752812709,7.858648310953428 58.982100229187736,7.867901550652696 58.937544774074006,7.78171671882026 58.93274049105688)))"
21100006555000,10,5,5,47.3,"MULTIPOLYGON(((8.21291904158362 58.95618967864025,8.204104787568946 59.0007778255378,8.290537109690609 59.005303735862555,8.299241328050346 58.9607076618457,8.21291904158362 58.95618967864025)))"
21150006555000,10,4,6,36,"MULTIPOLYGON(((8.299241328050346 58.9607076618457,8.290537109690609 59.005303735862555,8.376996057146142 59.00977217749894,8.385590126838306 58.96516827497942,8.299241328050346 58.9607076618457)))"
21200006555000,2,1,1,0,"MULTIPOLYGON(((8.385590126838306 58.96516827497942,8.376996057146142 59.00977217749894,8.46348130086828 59.014183114624664,8.471965110228714 58.969571482359186,8.385590126838306 58.96516827497942)))"
21250006555000,195,104,91,45.8,"MULTIPOLYGON(((8.471965110228714 58.969571482359186,8.46348130086828 59.014183114624664,8.549992511149716 59.01853651185868,8.558365949867271 58.97391724874245,8.471965110228714 58.969571482359186)))"
21300006555000,65,32,33,59.8,"MULTIPOLYGON(((8.558365949867271 58.97391724874245,8.549992511149716 59.01853651185868,8.636529357650547 59.0228323342623,8.64479231677155 58.978205539327305,8.558365949867271 58.97391724874245)))"
21550006555000,3,1,2,0,"MULTIPOLYGON(((8.990746455828505 58.99478326312482,8.982926477327227 59.03943919233728,9.069586528209404 59.04344663206091,9.077295502860878 58.99878366818322,8.990746455828505 58.99478326312482)))"
21600006555000,12,6,6,51.8,"MULTIPOLYGON(((9.077295502860878 58.99878366818322,9.069586528209404 59.04344663206091,9.156270220407078 59.04739629666733,9.163868090490986 59.002726397942084,9.077295502860878 58.99878366818322)))"
21650006555000,77,37,40,47.7,"MULTIPOLYGON(((9.163868090490986 59.002726397942084,9.156270220407078 59.04739629666733,9.242977219362993 59.05128815434216,9.25046388554894 59.006611420712005,9.163868090490986 59.002726397942084)))"
21700006555000,9,4,5,48.9,"MULTIPOLYGON(((9.25046388554894 59.006611420712005,9.242977219362993 59.05128815434216,9.329707189947994 59.05512217372121,9.337082554296991 59.010438705252106,9.25046388554894 59.006611420712005)))"
21750006555000,2,1,1,0,"MULTIPOLYGON(((9.337082554296991 59.010438705252106,9.329707189947994 59.05512217372121,9.416459796468759 59.05889832389135,9.423723762437234 59.01420822077089,9.337082554296991 59.010438705252106)))"
21850006555000,15,6,9,47.9,"MULTIPOLYGON(((9.510387175119345 59.01791993692716,9.503234702675568 59.06261657439153,9.590031571770156 59.066276895213576,9.597072456948316 59.02157382383093,9.510387175119345 59.01791993692716)))"
21900006555000,1967,1009,958,37.9,"MULTIPOLYGON(((9.597072456948316 59.02157382383093,9.590031571770156 59.066276895213576,9.676850066413527 59.0698792568032,9.683779271992291 59.025169852044264,9.597072456948316 59.02157382383093)))"
21950006555000,6466,3228,3238,44.5,"MULTIPOLYGON(((9.683779271992291 59.025169852044264,9.676850066413527 59.0698792568032,9.763689848733858 59.07342363006076,9.770507283790367 59.02870799258222,9.683779271992291 59.025169852044264)))"
22000006555000,51,25,26,46,"MULTIPOLYGON(((9.770507283790367 59.02870799258222,9.763689848733858 59.07342363006076,9.850550580334401 59.07690998634217,9.857256155360455 59.03218821691367,9.770507283790367 59.02870799258222)))"
22050006555000,48,24,24,49.5,"MULTIPOLYGON(((9.857256155360455 59.03218821691367,9.850550580334401 59.07690998634217,9.93743192230144 59.080338297459804,9.944025549207185 59.035610496962114,9.857256155360455 59.03218821691367)))"
22100006555000,4636,2334,2302,42.6,"MULTIPOLYGON(((9.944025549207185 59.035610496962114,9.93743192230144 59.080338297459804,10.024333535212266 59.083708535683215,10.030815127329824 59.03897480510656,9.944025549207185 59.035610496962114)))"
22150006555000,17059,8396,8663,44.2,"MULTIPOLYGON(((10.030815127329824 59.03897480510656,10.024333535212266 59.083708535683215,10.11125507914318 59.087020673740064,10.117624551230225 59.04228111418235,10.030815127329824 59.03897480510656)))"
22200006555000,2893,1465,1428,41.2,"MULTIPOLYGON(((10.117624551230225 59.04228111418235,10.11125507914318 59.087020673740064,10.198196213677555 59.09027468481691,10.204453481920824 59.045529397481914,10.117624551230225 59.04228111418235)))"
22250006555000,1613,820,793,42.1,"MULTIPOLYGON(((10.204453481920824 59.045529397481914,10.198196213677555 59.09027468481691,10.285156597913879 59.09347054255998,10.291301579932654 59.0487196287556,10.204453481920824 59.045529397481914)))"
22300006555000,50,30,20,48.1,"MULTIPOLYGON(((10.291301579932654 59.0487196287556,10.285156597913879 59.09347054255998,10.372135890473887 59.096608221075975,10.378168505323371 59.05185178221246,10.291301579932654 59.0487196287556)))"
22350006555000,902,435,467,52.5,"MULTIPOLYGON(((10.378168505323371 59.05185178221246,10.372135890473887 59.096608221075975,10.459133749510661 59.09968769493285,10.46505391768536 59.054925832521,10.378168505323371 59.05185178221246)))"
22600006555000,1023,505,518,48.2,"MULTIPOLYGON(((10.81277361286306 59.066640511765016,10.807303997542636 59.111423051313736,10.894389545430032 59.114211136590164,10.89974633825077 59.06942368249271,10.81277361286306 59.066640511765016)))"
22650006555000,1515,770,745,45.8,"MULTIPOLYGON(((10.89974633825077 59.06942368249271,10.894389545430032 59.114211136590164,10.98149159933024 59.116940874342916,10.986735498848683 59.07214860777316,10.89974633825077 59.06942368249271)))"
22700006555000,63,37,26,49.6,"MULTIPOLYGON(((10.986735498848683 59.07214860777316,10.98149159933024 59.116940874342916,11.068609814345933 59.119612242389145,11.07374075122059 59.074815265511454,10.986735498848683 59.07214860777316)))"
22750006555000,5,2,3,75.6,"MULTIPOLYGON(((11.07374075122059 59.074815265511454,11.068609814345933 59.119612242389145,11.155743845177168 59.122225219013025,11.160761751530583 59.07742363407784,11.07374075122059 59.074815265511454)))"
22800006555000,600,307,293,43.2,"MULTIPOLYGON(((11.160761751530583 59.07742363407784,11.155743845177168 59.122225219013025,11.242893346129803 59.12477978296624,11.247798155551356 59.07997369230836,11.160761751530583 59.07742363407784)))"
22850006555000,1105,572,533,41.4,"MULTIPOLYGON(((11.247798155551356 59.07997369230836,11.242893346129803 59.12477978296624,11.330057971123864 59.12727591346884,11.334849618672564 59.082465419505446,11.247798155551356 59.07997369230836)))"
22900006555000,8807,4409,4398,44.5,"MULTIPOLYGON(((11.334849618672564 59.082465419505446,11.330057971123864 59.12727591346884,11.417237373701994 59.129713590209626,11.421915795909175 59.08489879543855,11.334849618672564 59.082465419505446)))"
22950006555000,4170,2120,2050,40.7,"MULTIPOLYGON(((11.421915795909175 59.08489879543855,11.417237373701994 59.129713590209626,11.504431207037882 59.1320927933469,11.508996341909857 59.087273800344775,11.421915795909175 59.08489879543855)))"
23150006555000,6,2,4,35.8,"MULTIPOLYGON(((11.770320733665258 59.09404839830019,11.766095817972746 59.138879369775644,11.853343898994453 59.14102448949237,11.857455294177699 59.09618973084321,11.770320733665258 59.09404839830019)))"
19550006560000,2863,1456,1407,36.7,"MULTIPOLYGON(((5.539672346147094 58.83218568898769,5.527473398064167 58.87647814554621,5.613027135593701 58.88277639498736,5.625119888514635 58.8384730048899,5.539672346147094 58.83218568898769)))"
19600006560000,8183,4190,3993,35.6,"MULTIPOLYGON(((5.625119888514635 58.8384730048899,5.613027135593701 58.88277639498736,5.698617496673965 58.88901840521821,5.710603901255809 58.8447041752927,5.625119888514635 58.8384730048899)))"
19650006560000,34952,17754,17198,40.1,"MULTIPOLYGON(((5.710603901255809 58.8447041752927,5.698617496673965 58.88901840521821,5.784244174341666 58.895204127123556,5.796124078599327 58.85087915126936,5.710603901255809 58.8447041752927)))"
19700006560000,863,475,388,40,"MULTIPOLYGON(((5.796124078599327 58.85087915126936,5.784244174341666 58.895204127123556,5.869906860778447 58.90133351199324,5.88168011392473 58.85699788429675,5.796124078599327 58.85087915126936)))"
19750006560000,196,100,96,42.8,"MULTIPOLYGON(((5.88168011392473 58.85699788429675,5.869906860778447 58.90133351199324,5.955605247316973 58.90740651152362,5.967271699768455 58.863060326256836,5.88168011392473 58.85699788429675)))"
19800006560000,591,316,275,39.1,"MULTIPOLYGON(((5.967271699768455 58.863060326256836,5.955605247316973 58.90740651152362,6.041339024447084 58.913423077818855,6.052898527829936 58.86906642943797,5.967271699768455 58.863060326256836)))"
19850006560000,585,291,294,42.1,"MULTIPOLYGON(((6.052898527829936 58.86906642943797,6.041339024447084 58.913423077818855,6.127107881822011 58.91938316339228,6.138560288977787 58.87501614653621,6.052898527829936 58.86906642943797)))"
19900006560000,194,100,94,37,"MULTIPOLYGON(((6.138560288977787 58.87501614653621,6.127107881822011 58.91938316339228,6.212911508264603 58.925286721167744,6.224256673255999 58.880909430656715,6.138560288977787 58.87501614653621)))"
19950006560000,50,33,17,40.7,"MULTIPOLYGON(((6.224256673255999 58.880909430656715,6.212911508264603 58.925286721167744,6.298749591773645 58.93113370448094,6.30998736989021 58.88674623531509,6.224256673255999 58.880909430656715)))"
20350006560000,51,25,26,40.9,"MULTIPOLYGON(((6.911036718328012 58.926018625082826,6.900554595990927 58.97047467003129,6.986657007213294 58.97586742758964,6.997030629831077 58.93140197028467,6.911036718328012 58.926018625082826)))"
20700006560000,23,13,10,54.1,"MULTIPOLYGON(((7.513643993670431 58.96250611362183,7.503924126107295 59.007026011758434,7.590241084904235 59.01201906246808,7.599851545919757 58.967490431246496,7.513643993670431 58.96250611362183)))"
20750006560000,45,23,22,44.6,"MULTIPOLYGON(((7.599851545919757 58.967490431246496,7.590241084904235 59.01201906246808,7.676587401991919 59.01695484915282,7.686088332122813 58.972417582519554,7.599851545919757 58.967490431246496)))"
21100006560000,21,13,8,54,"MULTIPOLYGON(((8.204104787568946 59.0007778255378,8.195263579691403 59.04536484499765,8.281806265889095 59.0498987028027,8.290537109690609 59.005303735862555,8.204104787568946 59.0007778255378)))"
21250006560000,505,248,257,41.5,"MULTIPOLYGON(((8.46348130086828 59.014183114624664,8.454971524843117 59.05879367980725,8.541593436108576 59.063154727523354,8.549992511149716 59.01853651185868,8.46348130086828 59.014183114624664)))"
21300006560000,2,2,0,0,"MULTIPOLYGON(((8.549992511149716 59.01853651185868,8.541593436108576 59.063154727523354,8.628241093172258 59.06745810113232,8.636529357650547 59.0228323342623,8.549992511149716 59.01853651185868)))"
21350006560000,6,4,2,55.7,"MULTIPOLYGON(((8.636529357650547 59.0228323342623,8.628241093172258 59.06745810113232,8.714914163699717 59.071703766002926,8.723091509405723 59.027070547340166,8.636529357650547 59.0228323342623)))"
21400006560000,22,13,9,71.9,"MULTIPOLYGON(((8.723091509405723 59.027070547340166,8.714914163699717 59.071703766002926,8.80161231473445 59.07589168794997,8.809678634832537 59.0312511170413,8.723091509405723 59.027070547340166)))"
21450006560000,9,6,3,54.8,"MULTIPOLYGON(((8.809678634832537 59.0312511170413,8.80161231473445 59.07589168794997,8.888335212705472 59.08002183323535,8.896290401738163 59.03537400976011,8.809678634832537 59.0312511170413)))"
21550006560000,24,15,9,35.9,"MULTIPOLYGON(((8.982926477327227 59.03943919233728,8.975082523434947 59.084094168568974,9.061853912145837 59.08810866110978,9.069586528209404 59.04344663206091,8.982926477327227 59.03943919233728)))"
21600006560000,169,88,81,42.4,"MULTIPOLYGON(((9.069586528209404 59.04344663206091,9.061853912145837 59.08810866110978,9.148649043469607 59.0920652784667,9.156270220407078 59.04739629666733,9.069586528209404 59.04344663206091)))"
21650006560000,114,62,52,46.8,"MULTIPOLYGON(((9.156270220407078 59.04739629666733,9.148649043469607 59.0920652784667,9.235467581453937 59.095963988699616,9.242977219362993 59.05128815434216,9.156270220407078 59.04739629666733)))"
21700006560000,19,9,10,40.5,"MULTIPOLYGON(((9.242977219362993 59.05128815434216,9.235467581453937 59.095963988699616,9.322309189570515 59.09980476032035,9.329707189947994 59.05512217372121,9.242977219362993 59.05128815434216)))"
21750006560000,27,13,14,53.8,"MULTIPOLYGON(((9.329707189947994 59.05512217372121,9.322309189570515 59.09980476032035,9.409173530722802 59.10358756229354,9.416459796468759 59.05889832389135,9.329707189947994 59.05512217372121)))"
21800006560000,54,29,25,39.9,"MULTIPOLYGON(((9.416459796468759 59.05889832389135,9.409173530722802 59.10358756229354,9.496060267253899 59.10731236403757,9.503234702675568 59.06261657439153,9.416459796468759 59.05889832389135)))"
21850006560000,1099,578,521,42.3,"MULTIPOLYGON(((9.503234702675568 59.06261657439153,9.496060267253899 59.10731236403757,9.582969060954406 59.110979135425474,9.590031571770156 59.066276895213576,9.503234702675568 59.06261657439153)))"
21900006560000,4631,2326,2305,39.4,"MULTIPOLYGON(((9.590031571770156 59.066276895213576,9.582969060954406 59.110979135425474,9.669899573070317 59.11458784678591,9.676850066413527 59.0698792568032,9.590031571770156 59.066276895213576)))"
21950006560000,8896,4482,4414,41.6,"MULTIPOLYGON(((9.676850066413527 59.0698792568032,9.669899573070317 59.11458784678591,9.756851464310976 59.11813846890393,9.763689848733858 59.07342363006076,9.676850066413527 59.0698792568032)))"
22000006560000,606,312,294,47.2,"MULTIPOLYGON(((9.763689848733858 59.07342363006076,9.756851464310976 59.11813846890393,9.843824394857023 59.121630973021894,9.850550580334401 59.07690998634217,9.763689848733858 59.07342363006076)))"
22050006560000,172,90,82,40,"MULTIPOLYGON(((9.850550580334401 59.07690998634217,9.843824394857023 59.121630973021894,9.930818024368419 59.12506533084036,9.93743192230144 59.080338297459804,9.850550580334401 59.07690998634217)))"
22100006560000,4,1,3,0,"MULTIPOLYGON(((9.93743192230144 59.080338297459804,9.930818024368419 59.12506533084036,10.017832011992462 59.12844151451888,10.024333535212266 59.083708535683215,9.93743192230144 59.080338297459804)))"
22150006560000,1407,737,670,37.6,"MULTIPOLYGON(((10.024333535212266 59.083708535683215,10.017832011992462 59.12844151451888,10.104866016371872 59.131759496676864,10.11125507914318 59.087020673740064,10.024333535212266 59.083708535683215)))"
22200006560000,3965,1977,1988,40.2,"MULTIPOLYGON(((10.11125507914318 59.087020673740064,10.104866016371872 59.131759496676864,10.191919695652874 59.135019250394365,10.198196213677555 59.09027468481691,10.11125507914318 59.087020673740064)))"
22250006560000,25012,12333,12679,44.2,"MULTIPOLYGON(((10.198196213677555 59.09027468481691,10.191919695652874 59.135019250394365,10.278992707493323 59.13822074921295,10.285156597913879 59.09347054255998,10.198196213677555 59.09027468481691)))"
22300006560000,569,286,283,43.7,"MULTIPOLYGON(((10.285156597913879 59.09347054255998,10.278992707493323 59.13822074921295,10.366084709070885 59.14136396713638,10.372135890473887 59.096608221075975,10.285156597913879 59.09347054255998)))"
22350006560000,3028,1499,1529,47,"MULTIPOLYGON(((10.372135890473887 59.096608221075975,10.366084709070885 59.14136396713638,10.453195357091198 59.14444887863149,10.459133749510661 59.09968769493285,10.372135890473887 59.096608221075975)))"
22600006560000,57,27,30,58.5,"MULTIPOLYGON(((10.807303997542636 59.111423051313736,10.801817531653116 59.156204965914206,10.889016246527982 59.15899797852934,10.894389545430032 59.114211136590164,10.807303997542636 59.111423051313736)))"
22650006560000,735,378,357,43.6,"MULTIPOLYGON(((10.894389545430032 59.114211136590164,10.889016246527982 59.15899797852934,10.976231538629229 59.16173254128282,10.98149159933024 59.116940874342916,10.894389545430032 59.114211136590164)))"
22700006560000,99,47,52,45.5,"MULTIPOLYGON(((10.98149159933024 59.116940874342916,10.976231538629229 59.16173254128282,11.06346306159003 59.16440863190343,11.068609814345933 59.119612242389145,10.98149159933024 59.116940874342916)))"
22750006560000,306,164,142,47.1,"MULTIPOLYGON(((11.068609814345933 59.119612242389145,11.06346306159003 59.16440863190343,11.150710468638055 59.16702622858871,11.155743845177168 59.122225219013025,11.068609814345933 59.119612242389145)))"
22800006560000,368,205,163,45,"MULTIPOLYGON(((11.155743845177168 59.122225219013025,11.150710468638055 59.16702622858871,11.237973412603916 59.16958531000564,11.242893346129803 59.12477978296624,11.155743845177168 59.122225219013025)))"
22850006560000,358,187,171,43.3,"MULTIPOLYGON(((11.242893346129803 59.12477978296624,11.237973412603916 59.16958531000564,11.325251545929602 59.172085855291286,11.330057971123864 59.12727591346884,11.242893346129803 59.12477978296624)))"
22900006560000,12081,6010,6071,42.1,"MULTIPOLYGON(((11.330057971123864 59.12727591346884,11.325251545929602 59.172085855291286,11.412544520676974 59.17452784405342,11.417237373701994 59.129713590209626,11.330057971123864 59.12727591346884)))"
22950006560000,1952,986,966,42.9,"MULTIPOLYGON(((11.417237373701994 59.129713590209626,11.412544520676974 59.17452784405342,11.499851988536276 59.17691125637115,11.504431207037882 59.1320927933469,11.417237373701994 59.129713590209626)))"
23000006560000,46,24,22,47.7,"MULTIPOLYGON(((11.504431207037882 59.1320927933469,11.499851988536276 59.17691125637115,11.587173600834653 59.1792360727955,11.591639123944734 59.13441350350909,11.504431207037882 59.1320927933469)))"
23050006560000,108,53,55,49.8,"MULTIPOLYGON(((11.591639123944734 59.13441350350909,11.587173600834653 59.1792360727955,11.674509008544716 59.181502274350024,11.678860776883775 59.13667570179525,11.591639123944734 59.13441350350909)))"
23100006560000,140,74,66,47.1,"MULTIPOLYGON(((11.678860776883775 59.13667570179525,11.674509008544716 59.181502274350024,11.761857862293102 59.18370984253134,11.766095817972746 59.138879369775644,11.678860776883775 59.13667570179525)))"
23150006560000,2,2,0,0,"MULTIPOLYGON(((11.766095817972746 59.138879369775644,11.761857862293102 59.18370984253134,11.849219812369082 59.18585875930974,11.853343898994453 59.14102448949237,11.766095817972746 59.138879369775644)))"
19550006565000,480,254,226,41,"MULTIPOLYGON(((5.527473398064167 58.87647814554621,5.515237520183827 58.920768721284325,5.600897758978515 58.92707793183464,5.613027135593701 58.88277639498736,5.527473398064167 58.87647814554621)))"
19600006565000,9598,4947,4651,39,"MULTIPOLYGON(((5.613027135593701 58.88277639498736,5.600897758978515 58.92707793183464,5.686594775362169 58.93333080924804,5.698617496673965 58.88901840521821,5.613027135593701 58.88277639498736)))"
19650006565000,25600,12842,12758,38.7,"MULTIPOLYGON(((5.698617496673965 58.88901840521821,5.686594775362169 58.93333080924804,5.772328261173437 58.9395273042199,5.784244174341666 58.895204127123556,5.698617496673965 58.88901840521821)))"
19700006565000,6147,3122,3025,36.9,"MULTIPOLYGON(((5.784244174341666 58.895204127123556,5.772328261173437 58.9395273042199,5.858097907389955 58.94566736785205,5.869906860778447 58.90133351199324,5.784244174341666 58.895204127123556)))"
19750006565000,1349,701,648,38.5,"MULTIPOLYGON(((5.869906860778447 58.90133351199324,5.858097907389955 58.94566736785205,5.943903404134466 58.95175095165423,5.955605247316973 58.90740651152362,5.869906860778447 58.90133351199324)))"
19800006565000,189,99,90,43.1,"MULTIPOLYGON(((5.955605247316973 58.90740651152362,5.943903404134466 58.95175095165423,6.029744440681025 58.95777800754542,6.041339024447084 58.913423077818855,5.955605247316973 58.90740651152362)))"
19850006565000,55,27,28,47.9,"MULTIPOLYGON(((6.041339024447084 58.913423077818855,6.029744440681025 58.95777800754542,6.115620705461221 58.96374848785523,6.127107881822011 58.91938316339228,6.041339024447084 58.913423077818855)))"
19900006565000,21,10,11,38.9,"MULTIPOLYGON(((6.127107881822011 58.91938316339228,6.115620705461221 58.96374848785523,6.201531886070474 58.9696623453252,6.212911508264603 58.925286721167744,6.127107881822011 58.91938316339228)))"
20350006565000,17,11,6,47.2,"MULTIPOLYGON(((6.900554595990927 58.97047467003129,6.890040541365342 59.014929248851104,6.976251771434988 59.020331442768644,6.986657007213294 58.97586742758964,6.900554595990927 58.97047467003129)))"
20700006565000,13,5,8,62.5,"MULTIPOLYGON(((7.503924126107295 59.007026011758434,7.494174575841598 59.051544606904805,7.580601265479641 59.05654641306717,7.590241084904235 59.01201906246808,7.503924126107295 59.007026011758434)))"
20900006565000,1,1,0,0,"MULTIPOLYGON(((7.849366810327302 59.026654473010595,7.840056928404211 59.07120750188904,7.926599590606512 59.07597962431996,7.935799249468782 59.031418232551744,7.849366810327302 59.026654473010595)))"
20950006565000,13,8,5,55,"MULTIPOLYGON(((7.935799249468782 59.031418232551744,7.926599590606512 59.07597962431996,8.013170426619746 59.080694228944985,8.0222597427029 59.03612457280641,7.935799249468782 59.031418232551744)))"
21100006565000,10,5,5,56.5,"MULTIPOLYGON(((8.195263579691403 59.04536484499765,8.186395302938907 59.08995073372732,8.273048682984989 59.09449255946151,8.281806265889095 59.0498987028027,8.195263579691403 59.04536484499765)))"
21250006565000,10,6,4,47,"MULTIPOLYGON(((8.454971524843117 59.05879367980725,8.446435671208706 59.10340317487507,8.533168615164282 59.10777189278939,8.541593436108576 59.063154727523354,8.454971524843117 59.05879367980725)))"
21400006565000,2,1,1,0,"MULTIPOLYGON(((8.714914163699717 59.071703766002926,8.706711737384033 59.11633597296138,8.793521247598935 59.12053126613108,8.80161231473445 59.07589168794997,8.714914163699717 59.071703766002926)))"
21450006565000,70,35,35,47.7,"MULTIPOLYGON(((8.80161231473445 59.07589168794997,8.793521247598935 59.12053126613108,8.880355610814464 59.12466868271181,8.888335212705472 59.08002183323535,8.80161231473445 59.07589168794997)))"
21500006565000,176,85,91,44.3,"MULTIPOLYGON(((8.888335212705472 59.08002183323535,8.880355610814464 59.12466868271181,8.967214491462668 59.12874818928196,8.975082523434947 59.084094168568974,8.888335212705472 59.08002183323535)))"
21550006565000,1015,494,521,42,"MULTIPOLYGON(((8.975082523434947 59.084094168568974,8.967214491462668 59.12874818928196,9.054097553372099 59.132769752870644,9.061853912145837 59.08810866110978,8.975082523434947 59.084094168568974)))"
21600006565000,538,271,267,43.8,"MULTIPOLYGON(((9.061853912145837 59.08810866110978,9.054097553372099 59.132769752870644,9.141004459775573 59.13673334095865,9.148649043469607 59.0920652784667,9.061853912145837 59.08810866110978)))"
21750006565000,96,50,46,41,"MULTIPOLYGON(((9.322309189570515 59.09980476032035,9.314888456063924 59.14448646282031,9.401864869505953 59.148275933822795,9.409173530722802 59.10358756229354,9.322309189570515 59.09980476032035)))"
21800006565000,139,75,64,43.6,"MULTIPOLYGON(((9.409173530722802 59.10358756229354,9.401864869505953 59.148275933822795,9.488863774572057 59.152007303784124,9.496060267253899 59.10731236403757,9.409173530722802 59.10358756229354)))"
21850006565000,557,291,266,45.8,"MULTIPOLYGON(((9.496060267253899 59.10731236403757,9.488863774572057 59.152007303784124,9.575884831633807 59.1556805424579,9.582969060954406 59.110979135425474,9.496060267253899 59.10731236403757)))"
21900006565000,20498,10100,10398,42.7,"MULTIPOLYGON(((9.582969060954406 59.110979135425474,9.575884831633807 59.1556805424579,9.66292770051425 59.15929562005506,9.669899573070317 59.11458784678591,9.582969060954406 59.110979135425474)))"
21950006565000,5264,2628,2636,40.1,"MULTIPOLYGON(((9.669899573070317 59.11458784678591,9.66292770051425 59.15929562005506,9.749992040495924 59.16285250724472,9.756851464310976 59.11813846890393,9.669899573070317 59.11458784678591)))"
22000006565000,51,24,27,45.3,"MULTIPOLYGON(((9.756851464310976 59.11813846890393,9.749992040495924 59.16285250724472,9.837077510328855 59.16635117515505,9.843824394857023 59.121630973021894,9.756851464310976 59.11813846890393)))"
22050006565000,97,54,43,47.3,"MULTIPOLYGON(((9.843824394857023 59.121630973021894,9.837077510328855 59.16635117515505,9.924183768238647 59.169791595374186,9.930818024368419 59.12506533084036,9.843824394857023 59.121630973021894)))"
22100006565000,123,61,62,39,"MULTIPOLYGON(((9.930818024368419 59.12506533084036,9.924183768238647 59.169791595374186,10.011310471934545 59.173173739951096,10.017832011992462 59.12844151451888,9.930818024368419 59.12506533084036)))"
22150006565000,454,244,210,43,"MULTIPOLYGON(((10.017832011992462 59.12844151451888,10.011310471934545 59.173173739951096,10.09845727861758 59.176497581396276,10.104866016371872 59.131759496676864,10.017832011992462 59.12844151451888)))"
22200006565000,3440,1758,1682,40.3,"MULTIPOLYGON(((10.104866016371872 59.131759496676864,10.09845727861758 59.176497581396276,10.185623844988704 59.17976309268273,10.191919695652874 59.135019250394365,10.104866016371872 59.131759496676864)))"
22250006565000,13286,6639,6647,39.9,"MULTIPOLYGON(((10.191919695652874 59.135019250394365,10.185623844988704 59.17976309268273,10.27280982725699 59.18297024724675,10.278992707493323 59.13822074921295,10.191919695652874 59.135019250394365)))"
22300006565000,1392,705,687,42.6,"MULTIPOLYGON(((10.278992707493323 59.13822074921295,10.27280982725699 59.18297024724675,10.36001488114784 59.186119018988606,10.366084709070885 59.14136396713638,10.278992707493323 59.13822074921295)))"
22350006565000,3042,1532,1510,43.9,"MULTIPOLYGON(((10.366084709070885 59.14136396713638,10.36001488114784 59.186119018988606,10.447238661911223 59.189209382273496,10.453195357091198 59.14444887863149,10.366084709070885 59.14136396713638)))"
22400006565000,284,140,144,49.8,"MULTIPOLYGON(((10.453195357091198 59.14444887863149,10.447238661911223 59.189209382273496,10.534480824329965 59.19224131193215,10.540324307796102 59.147475458628925,10.453195357091198 59.14444887863149)))"
22600006565000,3799,1887,1912,41,"MULTIPOLYGON(((10.801817531653116 59.156204965914206,10.796314142513923 59.20098625445837,10.883626370330575 59.203784207258195,10.889016246527982 59.15899797852934,10.801817531653116 59.156204965914206)))"
22650006565000,10528,5115,5413,42.8,"MULTIPOLYGON(((10.889016246527982 59.15899797852934,10.883626370330575 59.203784207258195,10.970955247001077 59.206523607595784,10.976231538629229 59.16173254128282,10.889016246527982 59.15899797852934)))"
22700006565000,1721,856,865,41,"MULTIPOLYGON(((10.976231538629229 59.16173254128282,10.970955247001077 59.206523607595784,11.05830042468072 59.20920443311099,11.06346306159003 59.16440863190343,10.976231538629229 59.16173254128282)))"
22750006565000,735,378,357,42,"MULTIPOLYGON(((11.06346306159003 59.16440863190343,11.05830042468072 59.20920443311099,11.145661555116346 59.211826661914294,11.150710468638055 59.16702622858871,11.06346306159003 59.16440863190343)))"
22800006565000,2683,1382,1301,40.7,"MULTIPOLYGON(((11.150710468638055 59.16702622858871,11.145661555116346 59.211826661914294,11.233038289654855 59.21439027258743,11.237973412603916 59.16958531000564,11.150710468638055 59.16702622858871)))"
22850006565000,198,103,95,41.4,"MULTIPOLYGON(((11.237973412603916 59.16958531000564,11.233038289654855 59.21439027258743,11.320430279251715 59.2168952441841,11.325251545929602 59.172085855291286,11.237973412603916 59.16958531000564)))"
22900006565000,222,113,109,41.9,"MULTIPOLYGON(((11.325251545929602 59.172085855291286,11.320430279251715 59.2168952441841,11.40783717447951 59.21934155623056,11.412544520676974 59.17452784405342,11.325251545929602 59.172085855291286)))"
22950006565000,55,33,22,40.2,"MULTIPOLYGON(((11.412544520676974 59.17452784405342,11.40783717447951 59.21934155623056,11.495258625536502 59.221729188726236,11.499851988536276 59.17691125637115,11.412544520676974 59.17452784405342)))"
23000006565000,71,40,31,39.6,"MULTIPOLYGON(((11.499851988536276 59.17691125637115,11.495258625536502 59.221729188726236,11.582694282255229 59.22405812214436,11.587173600834653 59.1792360727955,11.499851988536276 59.17691125637115)))"
23050006565000,97,60,37,42.4,"MULTIPOLYGON(((11.587173600834653 59.1792360727955,11.582694282255229 59.22405812214436,11.670143794111105 59.22632833743257,11.674509008544716 59.181502274350024,11.587173600834653 59.1792360727955)))"
23100006565000,451,230,221,47,"MULTIPOLYGON(((11.674509008544716 59.181502274350024,11.670143794111105 59.22632833743257,11.757606810231072 59.228539816013416,11.761857862293102 59.18370984253134,11.674509008544716 59.181502274350024)))"
19550006570000,5795,3008,2787,38.9,"MULTIPOLYGON(((5.515237520183827 58.920768721284325,5.502964557274766 58.96505740968975,5.588731604629844 58.971377609035656,5.600897758978515 58.92707793183464,5.515237520183827 58.920768721284325)))"
19600006570000,19363,9667,9696,38.8,"MULTIPOLYGON(((5.600897758978515 58.92707793183464,5.588731604629844 58.971377609035656,5.674535584479241 58.9776413811016,5.686594775362169 58.93333080924804,5.600897758978515 58.92707793183464)))"
19650006570000,67286,33714,33572,39.1,"MULTIPOLYGON(((5.686594775362169 58.93333080924804,5.674535584479241 58.9776413811016,5.76037618745747 58.98384867639243,5.772328261173437 58.9395273042199,5.686594775362169 58.93333080924804)))"
19700006570000,474,218,256,47.1,"MULTIPOLYGON(((5.772328261173437 58.9395273042199,5.76037618745747 58.98384867639243,5.846253103332009 58.98999944582101,5.858097907389955 58.94566736785205,5.772328261173437 58.9395273042199)))"
19750006570000,53,27,26,47.2,"MULTIPOLYGON(((5.858097907389955 58.94566736785205,5.846253103332009 58.98999944582101,5.9321660210095 58.99609364070944,5.943903404134466 58.95175095165423,5.858097907389955 58.94566736785205)))"
19800006570000,166,98,68,40.7,"MULTIPOLYGON(((5.943903404134466 58.95175095165423,5.9321660210095 58.99609364070944,6.018114628541962 59.00213121279056,6.029744440681025 58.95777800754542,5.943903404134466 58.95175095165423)))"
19850006570000,191,95,96,40.6,"MULTIPOLYGON(((6.029744440681025 58.95777800754542,6.018114628541962 59.00213121279056,6.104098613133064 59.008112114209226,6.115620705461221 58.96374848785523,6.029744440681025 58.95777800754542)))"
19900006570000,2,1,1,0,"MULTIPOLYGON(((6.115620705461221 58.96374848785523,6.104098613133064 59.008112114209226,6.190117661144462 59.014036297523816,6.201531886070474 58.9696623453252,6.115620705461221 58.96374848785523)))"
19950006570000,8,4,4,44.5,"MULTIPOLYGON(((6.201531886070474 58.9696623453252,6.190117661144462 59.014036297523816,6.276171458102158 59.0199037157074,6.287477669274371 58.97551953311027,6.201531886070474 58.9696623453252)))"
20000006570000,1,1,0,0,"MULTIPOLYGON(((6.287477669274371 58.97551953311027,6.276171458102158 59.0199037157074,6.362259688702935 59.02571432214928,6.37345774101504 58.98132000478002,6.287477669274371 58.97551953311027)))"
20050006570000,1,1,0,0,"MULTIPOLYGON(((6.37345774101504 58.98132000478002,6.362259688702935 59.02571432214928,6.44838203682082 59.03146807065612,6.459471786417574 58.98706371431997,6.37345774101504 58.98132000478002)))"
20350006570000,13,5,8,35,"MULTIPOLYGON(((6.890040541365342 59.014929248851104,6.8794944189903 59.059382356789534,6.965814788318434 59.0647940111715,6.976251771434988 59.020331442768644,6.890040541365342 59.014929248851104)))"
20700006570000,296,150,146,43,"MULTIPOLYGON(((7.494174575841598 59.051544606904805,7.484395216505731 59.09606189500694,7.570931962598093 59.1010724790859,7.580601265479641 59.05654641306717,7.494174575841598 59.051544606904805)))"
21000006570000,31,13,18,36.5,"MULTIPOLYGON(((8.013170426619746 59.080694228944985,8.00405326572782 59.1252627092367,8.090762737385067 59.129927944909646,8.099769107328601 59.085351277891526,8.013170426619746 59.080694228944985)))"
21050006570000,13,7,6,28.4,"MULTIPOLYGON(((8.099769107328601 59.085351277891526,8.090762737385067 59.129927944909646,8.17749984163995 59.13453548841467,8.186395302938907 59.08995073372732,8.099769107328601 59.085351277891526)))"
21250006570000,77,34,43,45.5,"MULTIPOLYGON(((8.446435671208706 59.10340317487507,8.43787362838341 59.14801159677799,8.52471793810764 59.15238800469207,8.533168615164282 59.10777189278939,8.446435671208706 59.10340317487507)))"
21400006570000,14,7,7,38.6,"MULTIPOLYGON(((8.706711737384033 59.11633597296138,8.698484123007807 59.16096716541846,8.785405327360916 59.165169848869766,8.793521247598935 59.12053126613108,8.706711737384033 59.11633597296138)))"
21450006570000,187,99,88,49.2,"MULTIPOLYGON(((8.793521247598935 59.12053126613108,8.785405327360916 59.165169848869766,8.8723514913902 59.16931455555585,8.880355610814464 59.12466868271181,8.793521247598935 59.12053126613108)))"
21550006570000,208,115,93,42.3,"MULTIPOLYGON(((8.967214491462668 59.12874818928196,8.95932227812987 59.17340125192284,9.046317350006325 59.17742990486928,9.054097553372099 59.132769752870644,8.967214491462668 59.12874818928196)))"
21600006570000,34,21,13,46.8,"MULTIPOLYGON(((9.054097553372099 59.132769752870644,9.046317350006325 59.17742990486928,9.133336368845947 59.181400481747175,9.141004459775573 59.13673334095865,9.054097553372099 59.132769752870644)))"
21700006570000,5,3,2,59,"MULTIPOLYGON(((9.227934873317942 59.1406389214795,9.220378995882946 59.1853129503629,9.30744489176722 59.18916727897822,9.314888456063924 59.14448646282031,9.227934873317942 59.1406389214795)))"
21750006570000,115,58,57,47.6,"MULTIPOLYGON(((9.314888456063924 59.14448646282031,9.30744489176722 59.18916727897822,9.394533716572273 59.19296343631126,9.401864869505953 59.148275933822795,9.314888456063924 59.14448646282031)))"
21800006570000,149,81,68,39.2,"MULTIPOLYGON(((9.401864869505953 59.148275933822795,9.394533716572273 59.19296343631126,9.481645129803148 59.19670139153729,9.488863774572057 59.152007303784124,9.401864869505953 59.148275933822795)))"
21850006570000,1721,894,827,41.7,"MULTIPOLYGON(((9.488863774572057 59.152007303784124,9.481645129803148 59.19670139153729,9.568778790404423 59.200381114289826,9.575884831633807 59.1556805424579,9.488863774572057 59.152007303784124)))"
21900006570000,17993,8915,9078,41.7,"MULTIPOLYGON(((9.575884831633807 59.1556805424579,9.568778790404423 59.200381114289826,9.655934356768208 59.204002574661416,9.66292770051425 59.15929562005506,9.575884831633807 59.1556805424579)))"
21950006570000,1308,614,694,50.2,"MULTIPOLYGON(((9.66292770051425 59.15929562005506,9.655934356768208 59.204002574661416,9.743111486742201 59.2075657432046,9.749992040495924 59.16285250724472,9.66292770051425 59.15929562005506)))"
22000006570000,174,94,80,42.6,"MULTIPOLYGON(((9.749992040495924 59.16285250724472,9.743111486742201 59.2075657432046,9.83030983763777 59.21107059093276,9.837077510328855 59.16635117515505,9.749992040495924 59.16285250724472)))"
22050006570000,53,26,27,42.1,"MULTIPOLYGON(((9.837077510328855 59.16635117515505,9.83030983763777 59.21107059093276,9.917529066238057 59.21451708932101,9.924183768238647 59.169791595374186,9.837077510328855 59.16635117515505)))"
22100006570000,1463,748,715,42.2,"MULTIPOLYGON(((9.924183768238647 59.169791595374186,9.917529066238057 59.21451708932101,10.004768828806146 59.217905210306995,10.011310471934545 59.173173739951096,9.924183768238647 59.169791595374186)))"
22150006570000,365,203,162,41.2,"MULTIPOLYGON(((10.011310471934545 59.173173739951096,10.004768828806146 59.217905210306995,10.092028781093212 59.22123492629182,10.09845727861758 59.176497581396276,10.011310471934545 59.173173739951096)))"
22200006570000,1320,661,659,38.9,"MULTIPOLYGON(((10.09845727861758 59.176497581396276,10.092028781093212 59.22123492629182,10.179308578346761 59.224506210140824,10.185623844988704 59.17976309268273,10.09845727861758 59.176497581396276)))"
22250006570000,1020,560,460,38,"MULTIPOLYGON(((10.185623844988704 59.17976309268273,10.179308578346761 59.224506210140824,10.266607875318858 59.22771903518439,10.27280982725699 59.18297024724675,10.185623844988704 59.17976309268273)))"
22300006570000,5842,2962,2880,43.5,"MULTIPOLYGON(((10.27280982725699 59.18297024724675,10.266607875318858 59.22771903518439,10.353926326274394 59.230873375218785,10.36001488114784 59.186119018988606,10.27280982725699 59.18297024724675)))"
22350006570000,5179,2592,2587,41.7,"MULTIPOLYGON(((10.36001488114784 59.186119018988606,10.353926326274394 59.230873375218785,10.441263584999412 59.23396920450692,10.447238661911223 59.189209382273496,10.36001488114784 59.186119018988606)))"
22400006570000,3216,1601,1615,42.9,"MULTIPOLYGON(((10.447238661911223 59.189209382273496,10.441263584999412 59.23396920450692,10.528619304809403 59.237006497779156,10.534480824329965 59.19224131193215,10.447238661911223 59.189209382273496)))"
22550006570000,268,135,133,44.6,"MULTIPOLYGON(((10.709018910978926 59.198129772026434,10.703384738643905 59.24290537753889,10.790793757022175 59.24576691583104,10.796314142513923 59.20098625445837,10.709018910978926 59.198129772026434)))"
22600006570000,739,380,359,43,"MULTIPOLYGON(((10.796314142513923 59.20098625445837,10.790793757022175 59.24576691583104,10.878219845209825 59.24856982171795,10.883626370330575 59.203784207258195,10.796314142513923 59.20098625445837)))"
22650006570000,31983,15906,16077,43.4,"MULTIPOLYGON(((10.883626370330575 59.203784207258195,10.878219845209825 59.24856982171795,10.965662654295711 59.251314072278255,10.970955247001077 59.206523607595784,10.883626370330575 59.203784207258195)))"
22700006570000,20643,10391,10252,40.2,"MULTIPOLYGON(((10.970955247001077 59.206523607595784,10.965662654295711 59.251314072278255,11.053121834948767 59.25399964506238,11.05830042468072 59.20920443311099,10.970955247001077 59.206523607595784)))"
22750006570000,1569,817,752,41.4,"MULTIPOLYGON(((11.05830042468072 59.20920443311099,11.053121834948767 59.25399964506238,11.140597037426513 59.256626518093285,11.145661555116346 59.211826661914294,11.05830042468072 59.20920443311099)))"
22800006570000,3149,1563,1586,40.5,"MULTIPOLYGON(((11.145661555116346 59.211826661914294,11.140597037426513 59.256626518093285,11.228087911583627 59.25919466986695,11.233038289654855 59.21439027258743,11.145661555116346 59.211826661914294)))"
22850006570000,168,85,83,37.4,"MULTIPOLYGON(((11.233038289654855 59.21439027258743,11.228087911583627 59.25919466986695,11.315594106880509 59.26170407935331,11.320430279251715 59.2168952441841,11.233038289654855 59.21439027258743)))"
22900006570000,72,37,35,44.1,"MULTIPOLYGON(((11.320430279251715 59.2168952441841,11.315594106880509 59.26170407935331,11.403115272391894 59.264154725996555,11.40783717447951 59.21934155623056,11.320430279251715 59.2168952441841)))"
22950006570000,101,65,36,45.6,"MULTIPOLYGON(((11.40783717447951 59.21934155623056,11.403115272391894 59.264154725996555,11.49065105681548 59.266546589716064,11.495258625536502 59.221729188726236,11.40783717447951 59.21934155623056)))"
23050006570000,42,22,20,45,"MULTIPOLYGON(((11.582694282255229 59.22405812214436,11.578201108480572 59.26887965090684,11.665765075356765 59.27115389044012,11.670143794111105 59.22632833743257,11.582694282255229 59.22405812214436)))"
23100006570000,271,135,136,44,"MULTIPOLYGON(((11.670143794111105 59.22632833743257,11.665765075356765 59.27115389044012,11.753342605062643 59.27336928966401,11.757606810231072 59.228539816013416,11.670143794111105 59.22632833743257)))"
23150006570000,33,19,14,53.4,"MULTIPOLYGON(((11.757606810231072 59.228539816013416,11.753342605062643 59.27336928966401,11.84093334487449 59.27552583040404,11.845082979402248 59.230692539785004,11.757606810231072 59.228539816013416)))"
19550006575000,257,130,127,43.5,"MULTIPOLYGON(((5.502964557274766 58.96505740968975,5.490654353232506 59.00934420421256,5.576528517641332 59.01567542015737,5.588731604629844 58.971377609035656,5.502964557274766 58.96505740968975)))"
19600006575000,12171,6089,6082,38.5,"MULTIPOLYGON(((5.588731604629844 58.971377609035656,5.576528517641332 59.01567542015737,5.66243977032299 59.021950114461845,5.674535584479241 58.9776413811016,5.588731604629844 58.971377609035656)))"
19650006575000,24184,12085,12099,38.5,"MULTIPOLYGON(((5.674535584479241 58.9776413811016,5.66243977032299 59.021950114461845,5.748387800701718 59.02816823743939,5.76037618745747 58.98384867639243,5.674535584479241 58.9776413811016)))"
19700006575000,1676,836,840,41.2,"MULTIPOLYGON(((5.76037618745747 58.98384867639243,5.748387800701718 59.02816823743939,5.83437229732868 59.03432973981277,5.846253103332009 58.98999944582101,5.76037618745747 58.98384867639243)))"
19750006575000,2,1,1,0,"MULTIPOLYGON(((5.846253103332009 58.98999944582101,5.83437229732868 59.03432973981277,5.920392947888177 59.040434572715526,5.9321660210095 58.99609364070944,5.846253103332009 58.98999944582101)))"
19800006575000,965,480,485,39.7,"MULTIPOLYGON(((5.9321660210095 58.99609364070944,5.920392947888177 59.040434572715526,6.006449439203923 59.0464826876933,6.018114628541962 59.00213121279056,5.9321660210095 58.99609364070944)))"
19850006575000,7076,3544,3532,38.3,"MULTIPOLYGON(((6.018114628541962 59.00213121279056,6.006449439203923 59.0464826876933,6.092541457245339 59.05247403670532,6.104098613133064 59.008112114209226,6.018114628541962 59.00213121279056)))"
19900006575000,22,8,14,43.1,"MULTIPOLYGON(((6.104098613133064 59.008112114209226,6.092541457245339 59.05247403670532,6.178668687133944 59.058408572125636,6.190117661144462 59.014036297523816,6.104098613133064 59.008112114209226)))"
20000006575000,1,1,0,0,"MULTIPOLYGON(((6.276171458102158 59.0199037157074,6.264830813149735 59.06428624674462,6.351027518737683 59.07010701377024,6.362259688702935 59.02571432214928,6.276171458102158 59.0199037157074)))"
20050006575000,3,2,1,0,"MULTIPOLYGON(((6.362259688702935 59.02571432214928,6.351027518737683 59.07010701377024,6.437258486514219 59.07587082682943,6.44838203682082 59.03146807065612,6.362259688702935 59.02571432214928)))"
20200006575000,7,4,3,67.6,"MULTIPOLYGON(((6.620727817029404 59.04280481118698,6.609821934995531 59.08722740765902,6.696153776849789 59.09282008479005,6.706950612813294 59.04838771292366,6.620727817029404 59.04280481118698)))"
20650006575000,12,7,5,51.4,"MULTIPOLYGON(((7.397888406452087 59.09099389105893,7.387968855378113 59.135500969332654,7.474585921009933 59.14057787198688,7.484395216505731 59.09606189500694,7.397888406452087 59.09099389105893)))"
20700006575000,231,122,109,45.2,"MULTIPOLYGON(((7.484395216505731 59.09606189500694,7.474585921009933 59.14057787198688,7.561233050496673 59.14559725654295,7.570931962598093 59.1010724790859,7.484395216505731 59.09606189500694)))"
20950006575000,14,8,6,30.5,"MULTIPOLYGON(((7.917371757818941 59.12053981897552,7.908115630700783 59.16509881291398,7.994908140973568 59.16983001016893,8.00405326572782 59.1252627092367,7.917371757818941 59.12053981897552)))"
21000006575000,83,50,33,38.8,"MULTIPOLYGON(((8.00405326572782 59.1252627092367,7.994908140973568 59.16983001016893,8.081728734731184 59.17450345368283,8.090762737385067 59.129927944909646,8.00405326572782 59.1252627092367)))"
21050006575000,115,56,59,44.1,"MULTIPOLYGON(((8.090762737385067 59.129927944909646,8.081728734731184 59.17450345368283,8.168577079458917 59.17911910572779,8.17749984163995 59.13453548841467,8.090762737385067 59.129927944909646)))"
21200006575000,31,14,17,36.9,"MULTIPOLYGON(((8.351055619965662 59.143577350818724,8.34235568836777 59.18817688672409,8.429285284143921 59.19261894244759,8.43787362838341 59.14801159677799,8.351055619965662 59.143577350818724)))"
21250006575000,208,103,105,49.9,"MULTIPOLYGON(((8.43787362838341 59.14801159677799,8.429285284143921 59.19261894244759,8.516241294095355 59.19700306024871,8.52471793810764 59.15238800469207,8.43787362838341 59.14801159677799)))"
21300006575000,47,27,20,41.8,"MULTIPOLYGON(((8.52471793810764 59.15238800469207,8.516241294095355 59.19700306024871,8.60322338237719 59.20132920463399,8.611588214681083 59.156706539207285,8.52471793810764 59.15238800469207)))"
21450006575000,54,31,23,37,"MULTIPOLYGON(((8.785405327360916 59.165169848869766,8.777264447344134 59.20980743343476,8.864322749154248 59.21395944911793,8.8723514913902 59.16931455555585,8.785405327360916 59.165169848869766)))"
21500006575000,11,6,5,50.2,"MULTIPOLYGON(((8.8723514913902 59.16931455555585,8.864322749154248 59.21395944911793,8.95140577956028 59.21805335392276,8.95932227812987 59.17340125192284,8.8723514913902 59.16931455555585)))"
21550006575000,6,4,2,38.8,"MULTIPOLYGON(((8.95932227812987 59.17340125192284,8.95140577956028 59.21805335392276,9.038513199578682 59.2220891146165,9.046317350006325 59.17742990486928,8.95932227812987 59.17340125192284)))"
21600006575000,2,1,1,0,"MULTIPOLYGON(((9.046317350006325 59.17742990486928,9.038513199578682 59.2220891146165,9.125644669621563 59.22606669842161,9.133336368845947 59.181400481747175,9.046317350006325 59.17742990486928)))"
21650006575000,12,6,6,49,"MULTIPOLYGON(((9.133336368845947 59.181400481747175,9.125644669621563 59.22606669842161,9.212799849504613 59.229986073016704,9.220378995882946 59.1853129503629,9.133336368845947 59.181400481747175)))"
21700006575000,1,0,1,0,"MULTIPOLYGON(((9.220378995882946 59.1853129503629,9.212799849504613 59.229986073016704,9.299978398455002 59.23384720653746,9.30744489176722 59.18916727897822,9.220378995882946 59.1853129503629)))"
21750006575000,54,30,24,47.6,"MULTIPOLYGON(((9.30744489176722 59.18916727897822,9.299978398455002 59.23384720653746,9.38717997511936 59.237650067577704,9.394533716572273 59.19296343631126,9.30744489176722 59.18916727897822)))"
21800006575000,507,256,251,41.3,"MULTIPOLYGON(((9.394533716572273 59.19296343631126,9.38717997511936 59.237650067577704,9.474404237571767 59.24139462519019,9.481645129803148 59.19670139153729,9.394533716572273 59.19296343631126)))"
21850006575000,7973,3896,4077,41.8,"MULTIPOLYGON(((9.481645129803148 59.19670139153729,9.474404237571767 59.24139462519019,9.561650843321797 59.24508084888763,9.568778790404423 59.200381114289826,9.481645129803148 59.19670139153729)))"
21900006575000,18068,9011,9057,42.9,"MULTIPOLYGON(((9.568778790404423 59.200381114289826,9.561650843321797 59.24508084888763,9.648919449322566 59.24870870864358,9.655934356768208 59.204002574661416,9.568778790404423 59.200381114289826)))"
21950006575000,136,74,62,34.4,"MULTIPOLYGON(((9.655934356768208 59.204002574661416,9.648919449322566 59.24870870864358,9.73620971197887 59.25227817489335,9.743111486742201 59.2075657432046,9.655934356768208 59.204002574661416)))"
22000006575000,162,88,74,47.5,"MULTIPOLYGON(((9.743111486742201 59.2075657432046,9.73620971197887 59.25227817489335,9.823521287155282 59.255789218534865,9.83030983763777 59.21107059093276,9.743111486742201 59.2075657432046)))"
22050006575000,37,21,16,49.3,"MULTIPOLYGON(((9.83030983763777 59.21107059093276,9.823521287155282 59.255789218534865,9.910853830184358 59.259241810929545,9.917529066238057 59.21451708932101,9.83030983763777 59.21107059093276)))"
22100006575000,227,119,108,39.3,"MULTIPOLYGON(((9.917529066238057 59.21451708932101,9.910853830184358 59.259241810929545,9.998206995874819 59.262635923903225,10.004768828806146 59.217905210306995,9.917529066238057 59.21451708932101)))"
22150006575000,96,52,44,40.6,"MULTIPOLYGON(((10.004768828806146 59.217905210306995,9.998206995874819 59.262635923903225,10.08558043851979 59.265971529746906,10.092028781093212 59.22123492629182,10.004768828806146 59.217905210306995)))"
22200006575000,387,215,172,38.5,"MULTIPOLYGON(((10.092028781093212 59.22123492629182,10.08558043851979 59.265971529746906,10.172973811905079 59.269248601217676,10.179308578346761 59.224506210140824,10.092028781093212 59.22123492629182)))"
22250006575000,625,332,293,42.2,"MULTIPOLYGON(((10.179308578346761 59.224506210140824,10.172973811905079 59.269248601217676,10.26038676931747 59.272467111539484,10.266607875318858 59.22771903518439,10.179308578346761 59.224506210140824)))"
22300006575000,2543,1315,1228,37.1,"MULTIPOLYGON(((10.266607875318858 59.22771903518439,10.26038676931747 59.272467111539484,10.347818963553054 59.275627034403946,10.353926326274394 59.230873375218785,10.266607875318858 59.22771903518439)))"
22350006575000,25663,12556,13107,42.2,"MULTIPOLYGON(((10.353926326274394 59.230873375218785,10.347818963553054 59.275627034403946,10.435270046925591 59.278728343971146,10.441263584999412 59.23396920450692,10.353926326274394 59.230873375218785)))"
22400006575000,15482,7587,7895,43.7,"MULTIPOLYGON(((10.441263584999412 59.23396920450692,10.435270046925591 59.278728343971146,10.522739671274898 59.2817710148705,10.528619304809403 59.237006497779156,10.441263584999412 59.23396920450692)))"
22550006575000,4123,2057,2066,41.8,"MULTIPOLYGON(((10.703384738643905 59.24290537753889,10.697733147943982 59.28768034153383,10.785256301649648 59.29054694890967,10.790793757022175 59.24576691583104,10.703384738643905 59.24290537753889)))"
22600006575000,641,331,310,44,"MULTIPOLYGON(((10.790793757022175 59.24576691583104,10.785256301649648 59.29054694890967,10.872796599120848 59.29335482084274,10.878219845209825 59.24856982171795,10.790793757022175 59.24576691583104)))"
22650006575000,1201,639,562,40.6,"MULTIPOLYGON(((10.878219845209825 59.24856982171795,10.872796599120848 59.29335482084274,10.96035368995461 59.29610393431993,10.965662654295711 59.251314072278255,10.878219845209825 59.24856982171795)))"
22700006575000,10193,5119,5074,40.6,"MULTIPOLYGON(((10.965662654295711 59.251314072278255,10.96035368995461 59.29610393431993,11.047927223324978 59.298794266801764,11.053121834948767 59.25399964506238,10.965662654295711 59.251314072278255)))"
22750006575000,28159,13990,14169,41.8,"MULTIPOLYGON(((11.053121834948767 59.25399964506238,11.047927223324978 59.298794266801764,11.135516847991601 59.3014257962231,11.140597037426513 59.256626518093285,11.053121834948767 59.25399964506238)))"
22800006575000,12041,5986,6055,40.1,"MULTIPOLYGON(((11.140597037426513 59.256626518093285,11.135516847991601 59.3014257962231,11.22312221230835 59.303998500993806,11.228087911583627 59.25919466986695,11.140597037426513 59.256626518093285)))"
22850006575000,122,68,54,44.8,"MULTIPOLYGON(((11.228087911583627 59.25919466986695,11.22312221230835 59.303998500993806,11.310742964231958 59.30651235999942,11.315594106880509 59.26170407935331,11.228087911583627 59.25919466986695)))"
22900006575000,42,27,15,45.1,"MULTIPOLYGON(((11.315594106880509 59.26170407935331,11.310742964231958 59.30651235999942,11.39837875133068 59.30896735260179,11.403115272391894 59.264154725996555,11.315594106880509 59.26170407935331)))"
22950006575000,221,124,97,42.3,"MULTIPOLYGON(((11.403115272391894 59.264154725996555,11.39837875133068 59.30896735260179,11.486029220792995 59.3113634586397,11.49065105681548 59.266546589716064,11.403115272391894 59.264154725996555)))"
23050006575000,83,41,42,46.4,"MULTIPOLYGON(((11.578201108480572 59.26887965090684,11.573694019436308 59.31370065842946,11.661372793715692 59.315978932765546,11.665765075356765 59.27115389044012,11.578201108480572 59.26887965090684)))"
23100006575000,95,51,44,45.8,"MULTIPOLYGON(((11.665765075356765 59.27115389044012,11.661372793715692 59.315978932765546,11.749065189732653 59.318198262921186,11.753342605062643 59.27336928966401,11.665765075356765 59.27115389044012)))"
23150006575000,2,1,1,0,"MULTIPOLYGON(((11.753342605062643 59.27336928966401,11.749065189732653 59.318198262921186,11.836770853243898 59.3203586306489,11.84093334487449 59.27552583040404,11.753342605062643 59.27336928966401)))"
19600006580000,415,219,196,40.1,"MULTIPOLYGON(((5.576528517641332 59.01567542015737,5.564288342233438 59.0599713587296,5.650307178324147 59.066257002975334,5.66243977032299 59.021950114461845,5.576528517641332 59.01567542015737)))"
19650006580000,1352,703,649,37.8,"MULTIPOLYGON(((5.66243977032299 59.021950114461845,5.650307178324147 59.066257002975334,5.736362947553251 59.07248598112315,5.748387800701718 59.02816823743939,5.66243977032299 59.021950114461845)))"
19700006580000,267,143,124,42,"MULTIPOLYGON(((5.748387800701718 59.02816823743939,5.736362947553251 59.07248598112315,5.822455337249375 59.07865824370479,5.83437229732868 59.03432973981277,5.748387800701718 59.02816823743939)))"
19750006580000,491,250,241,43.8,"MULTIPOLYGON(((5.83437229732868 59.03432973981277,5.822455337249375 59.07865824370479,5.908584033868226 59.084773741664165,5.920392947888177 59.040434572715526,5.83437229732868 59.03432973981277)))"
19800006580000,3299,1691,1608,37.7,"MULTIPOLYGON(((5.920392947888177 59.040434572715526,5.908584033868226 59.084773741664165,5.994748722998886 59.09083242635876,6.006449439203923 59.0464826876933,5.920392947888177 59.040434572715526)))"
19850006580000,348,180,168,37.6,"MULTIPOLYGON(((6.006449439203923 59.0464826876933,5.994748722998886 59.09083242635876,6.080949089370176 59.096834249561056,6.092541457245339 59.05247403670532,6.006449439203923 59.0464826876933)))"
20050006580000,4,2,2,0,"MULTIPOLYGON(((6.351027518737683 59.07010701377024,6.339761086446845 59.11449807419295,6.426100992088671 59.120271977498994,6.437258486514219 59.07587082682943,6.351027518737683 59.07010701377024)))"
20700006580000,28,17,11,37.4,"MULTIPOLYGON(((7.474585921009933 59.14057787198688,7.464746561537135 59.185092533742534,7.5515044026923 59.190120741433404,7.561233050496673 59.14559725654295,7.474585921009933 59.14057787198688)))"
20950006580000,2,2,0,0,"MULTIPOLYGON(((7.908115630700783 59.16509881291398,7.898831088155645 59.20965660250949,7.985734932619722 59.21439612820817,7.994908140973568 59.16983001016893,7.908115630700783 59.16509881291398)))"
21000006580000,12,10,2,51,"MULTIPOLYGON(((7.994908140973568 59.16983001016893,7.985734932619722 59.21439612820817,8.072666980993667 59.21907780076891,8.081728734731184 59.17450345368283,7.994908140973568 59.16983001016893)))"
21050006580000,499,227,272,43.9,"MULTIPOLYGON(((8.081728734731184 59.17450345368283,8.072666980993667 59.21907780076891,8.159626899391329 59.223701582314824,8.168577079458917 59.17911910572779,8.081728734731184 59.17450345368283)))"
21250006580000,29,18,11,42.3,"MULTIPOLYGON(((8.429285284143921 59.19261894244759,8.42067052562066 59.237225208797,8.507738571645469 59.2416170564588,8.516241294095355 59.19700306024871,8.429285284143921 59.19261894244759)))"
21300006580000,29,16,13,38.9,"MULTIPOLYGON(((8.516241294095355 59.19700306024871,8.507738571645469 59.2416170564588,8.594832808125082 59.24595083043896,8.60322338237719 59.20132920463399,8.516241294095355 59.19700306024871)))"
21350006580000,10,6,4,49.3,"MULTIPOLYGON(((8.60322338237719 59.20132920463399,8.594832808125082 59.24595083043896,8.681952897171517 59.250226495555246,8.690231212501319 59.20559734056007,8.60322338237719 59.20132920463399)))"
21400006580000,105,60,45,42,"MULTIPOLYGON(((8.690231212501319 59.20559734056007,8.681952897171517 59.250226495555246,8.769098500256714 59.25444401707825,8.777264447344134 59.20980743343476,8.690231212501319 59.20559734056007)))"
21450006580000,51,26,25,44.1,"MULTIPOLYGON(((8.777264447344134 59.20980743343476,8.769098500256714 59.25444401707825,8.856269278220338 59.25860336073246,8.864322749154248 59.21395944911793,8.777264447344134 59.20980743343476)))"
21650006580000,63,32,31,49.6,"MULTIPOLYGON(((9.125644669621563 59.22606669842161,9.117929260458927 59.270731988556626,9.205197333962177 59.274658287093544,9.212799849504613 59.229986073016704,9.125644669621563 59.22606669842161)))"
21700006580000,1446,724,722,42.7,"MULTIPOLYGON(((9.212799849504613 59.229986073016704,9.205197333962177 59.274658287093544,9.292488877333385 59.2785262432276,9.299978398455002 59.23384720653746,9.212799849504613 59.229986073016704)))"
21750006580000,674,353,321,43.5,"MULTIPOLYGON(((9.299978398455002 59.23384720653746,9.292488877333385 59.2785262432276,9.379803547784306 59.28233582542759,9.38717997511936 59.237650067577704,9.299978398455002 59.23384720653746)))"
21800006580000,40,19,21,44.5,"MULTIPOLYGON(((9.38717997511936 59.237650067577704,9.379803547784306 59.28233582542759,9.467141001950022 59.28608700262307,9.474404237571767 59.24139462519019,9.38717997511936 59.237650067577704)))"
21850006580000,170,90,80,44.1,"MULTIPOLYGON(((9.474404237571767 59.24139462519019,9.467141001950022 59.28608700262307,9.554500895897029 59.289779744205276,9.561650843321797 59.24508084888763,9.474404237571767 59.24139462519019)))"
21900006580000,1328,694,634,37.3,"MULTIPOLYGON(((9.561650843321797 59.24508084888763,9.554500895897029 59.289779744205276,9.64188288513136 59.293414020028145,9.648919449322566 59.24870870864358,9.561650843321797 59.24508084888763)))"
21950006580000,1657,855,802,42.6,"MULTIPOLYGON(((9.648919449322566 59.24870870864358,9.64188288513136 59.293414020028145,9.72928662460675 59.296989800409044,9.73620971197887 59.25227817489335,9.648919449322566 59.24870870864358)))"
22000006580000,282,141,141,44.2,"MULTIPOLYGON(((9.73620971197887 59.25227817489335,9.72928662460675 59.296989800409044,9.81671176873283 59.30050705612984,9.823521287155282 59.255789218534865,9.73620971197887 59.25227817489335)))"
22050006580000,137,72,65,41.8,"MULTIPOLYGON(((9.823521287155282 59.255789218534865,9.81671176873283 59.30050705612984,9.904157971383345 59.3039657584377,9.910853830184358 59.259241810929545,9.823521287155282 59.255789218534865)))"
22100006580000,420,222,198,38.2,"MULTIPOLYGON(((9.910853830184358 59.259241810929545,9.904157971383345 59.3039657584377,9.991624885904422 59.30736587904589,9.998206995874819 59.262635923903225,9.910853830184358 59.259241810929545)))"
22150006580000,169,81,88,38.4,"MULTIPOLYGON(((9.998206995874819 59.262635923903225,9.991624885904422 59.30736587904589,10.079112165122876 59.3107073901348,10.08558043851979 59.265971529746906,9.998206995874819 59.262635923903225)))"
22200006580000,706,342,364,39.6,"MULTIPOLYGON(((10.08558043851979 59.265971529746906,10.079112165122876 59.3107073901348,10.166619461354513 59.31399026435262,10.172973811905079 59.269248601217676,10.08558043851979 59.265971529746906)))"
22250006580000,3213,1658,1555,40.7,"MULTIPOLYGON(((10.172973811905079 59.269248601217676,10.166619461354513 59.31399026435262,10.254146426412502 59.317214474816254,10.26038676931747 59.272467111539484,10.172973811905079 59.269248601217676)))"
22300006580000,2151,1103,1048,41,"MULTIPOLYGON(((10.26038676931747 59.272467111539484,10.254146426412502 59.317214474816254,10.341692711615769 59.32037999511211,10.347818963553054 59.275627034403946,10.26038676931747 59.272467111539484)))"
22350006580000,8401,4184,4217,40.7,"MULTIPOLYGON(((10.347818963553054 59.275627034403946,10.341692711615769 59.32037999511211,10.429257967797406 59.32348679929693,10.435270046925591 59.278728343971146,10.347818963553054 59.275627034403946)))"
22400006580000,7123,3494,3629,38.4,"MULTIPOLYGON(((10.435270046925591 59.278728343971146,10.429257967797406 59.32348679929693,10.516841845313134 59.32653486189851,10.522739671274898 59.2817710148705,10.435270046925591 59.278728343971146)))"
22500006580000,875,442,433,45.5,"MULTIPOLYGON(((10.610227487975285 59.28475502220135,10.604443994049769 59.32952415791654,10.692064063433747 59.33245466282329,10.697733147943982 59.28768034153383,10.610227487975285 59.28475502220135)))"
22550006580000,2505,1276,1229,42.1,"MULTIPOLYGON(((10.697733147943982 59.28768034153383,10.692064063433747 59.33245466282329,10.779701702439658 59.33532635256445,10.785256301649648 59.29054694890967,10.697733147943982 59.28768034153383)))"
22600006580000,551,286,265,45.1,"MULTIPOLYGON(((10.785256301649648 59.29054694890967,10.779701702439658 59.33532635256445,10.86735655959881 59.338139203559805,10.872796599120848 59.29335482084274,10.785256301649648 59.29054694890967)))"
22650006580000,538,278,260,44.7,"MULTIPOLYGON(((10.872796599120848 59.29335482084274,10.86735655959881 59.338139203559805,10.955028283007838 59.34089319270395,10.96035368995461 59.29610393431993,10.872796599120848 59.29335482084274)))"
22700006580000,1151,598,553,43.3,"MULTIPOLYGON(((10.96035368995461 59.29610393431993,10.955028283007838 59.34089319270395,11.042716520337304 59.34358829736695,11.047927223324978 59.298794266801764,10.96035368995461 59.29610393431993)))"
22750006580000,3002,1483,1519,41.7,"MULTIPOLYGON(((11.047927223324978 59.298794266801764,11.042716520337304 59.34358829736695,11.130420918840374 59.34622449539517,11.135516847991601 59.3014257962231,11.047927223324978 59.298794266801764)))"
22800006580000,1600,829,771,40.5,"MULTIPOLYGON(((11.135516847991601 59.3014257962231,11.130420918840374 59.34622449539517,11.21814112536147 59.34880176511181,11.22312221230835 59.303998500993806,11.135516847991601 59.3014257962231)))"
22850006580000,288,151,137,37.7,"MULTIPOLYGON(((11.22312221230835 59.303998500993806,11.21814112536147 59.34880176511181,11.305876786344992 59.3513200853176,11.310742964231958 59.30651235999942,11.22312221230835 59.303998500993806)))"
22900006580000,108,52,56,36.2,"MULTIPOLYGON(((11.310742964231958 59.30651235999942,11.305876786344992 59.3513200853176,11.393627547844028 59.35377943529152,11.39837875133068 59.30896735260179,11.310742964231958 59.30651235999942)))"
22950006580000,359,174,185,40.2,"MULTIPOLYGON(((11.39837875133068 59.30896735260179,11.393627547844028 59.35377943529152,11.481393055529123 59.35617979479131,11.486029220792995 59.3113634586397,11.39837875133068 59.30896735260179)))"
23000006580000,83,46,37,45.4,"MULTIPOLYGON(((11.486029220792995 59.3113634586397,11.481393055529123 59.35617979479131,11.569172954697043 59.35852114405418,11.573694019436308 59.31370065842946,11.486029220792995 59.3113634586397)))"
23050006580000,17,11,6,49.5,"MULTIPOLYGON(((11.573694019436308 59.31370065842946,11.569172954697043 59.35852114405418,11.656966890279579 59.36080346379746,11.661372793715692 59.315978932765546,11.573694019436308 59.31370065842946)))"
23100006580000,60,32,28,41.4,"MULTIPOLYGON(((11.661372793715692 59.315978932765546,11.656966890279579 59.36080346379746,11.744774506852377 59.36302673521898,11.749065189732653 59.318198262921186,11.661372793715692 59.315978932765546)))"
23150006580000,2,1,1,0,"MULTIPOLYGON(((11.749065189732653 59.318198262921186,11.744774506852377 59.36302673521898,11.832595448643763 59.36519093999788,11.836770853243898 59.3203586306489,11.749065189732653 59.318198262921186)))"
19500006585000,535,288,247,44.8,"MULTIPOLYGON(((5.39236271575064 59.047230271870056,5.379869978705906 59.09150209166521,5.465921592928136 59.09791208522134,5.47830675107333 59.053629098265034,5.39236271575064 59.047230271870056)))"
19600006585000,393,203,190,41.8,"MULTIPOLYGON(((5.564288342233438 59.0599713587296,5.552010921747387 59.1042654182446,5.638137653040379 59.110562040251644,5.650307178324147 59.066257002975334,5.564288342233438 59.0599713587296)))"
19650006585000,1396,692,704,38.8,"MULTIPOLYGON(((5.650307178324147 59.066257002975334,5.638137653040379 59.110562040251644,5.72430147379227 59.11680190116987,5.736362947553251 59.07248598112315,5.650307178324147 59.066257002975334)))"
19700006585000,978,507,471,37.7,"MULTIPOLYGON(((5.736362947553251 59.07248598112315,5.72430147379227 59.11680190116987,5.810502070102904 59.12298495133891,5.822455337249375 59.07865824370479,5.736362947553251 59.07248598112315)))"
19750006585000,320,168,152,36,"MULTIPOLYGON(((5.822455337249375 59.07865824370479,5.810502070102904 59.12298495133891,5.896739127193081 59.12911114151202,5.908584033868226 59.084773741664165,5.822455337249375 59.07865824370479)))"
19800006585000,353,191,162,40.9,"MULTIPOLYGON(((5.908584033868226 59.084773741664165,5.896739127193081 59.12911114151202,5.983012329410909 59.135180422857566,5.994748722998886 59.09083242635876,5.908584033868226 59.084773741664165)))"
19850006585000,413,206,207,38.3,"MULTIPOLYGON(((5.994748722998886 59.09083242635876,5.983012329410909 59.135180422857566,6.069321360238194 59.14119274696031,6.080949089370176 59.096834249561056,5.994748722998886 59.09083242635876)))"
19900006585000,60,33,27,40.5,"MULTIPOLYGON(((6.080949089370176 59.096834249561056,6.069321360238194 59.14119274696031,6.155665902296884 59.14714806582288,6.167184816857056 59.102779163459935,6.080949089370176 59.096834249561056)))"
19950006585000,99,52,47,40.5,"MULTIPOLYGON(((6.167184816857056 59.102779163459935,6.155665902296884 59.14714806582288,6.242045637355568 59.15304633186716,6.253455588487064 59.10866712066201,6.167184816857056 59.102779163459935)))"
20000006585000,58,28,30,40.2,"MULTIPOLYGON(((6.253455588487064 59.10866712066201,6.242045637355568 59.15304633186716,6.328460246335995 59.158887497935645,6.339761086446845 59.11449807419295,6.253455588487064 59.10866712066201)))"
20050006585000,1,1,0,0,"MULTIPOLYGON(((6.339761086446845 59.11449807419295,6.328460246335995 59.158887497935645,6.414909409319703 59.164671517292724,6.426100992088671 59.120271977498994,6.339761086446845 59.11449807419295)))"
20700006585000,336,159,177,44.5,"MULTIPOLYGON(((7.464746561537135 59.185092533742534,7.454877009537826 59.229605876147495,7.541745891976667 59.23464292972858,7.5515044026923 59.190120741433404,7.464746561537135 59.185092533742534)))"
20750006585000,105,56,49,42.1,"MULTIPOLYGON(((7.5515044026923 59.190120741433404,7.541745891976667 59.23464292972858,7.628644765142902 59.239622227344434,7.638292106636992 59.195091292026824,7.5515044026923 59.190120741433404)))"
20900006585000,3,1,2,0,"MULTIPOLYGON(((7.811955780794094 59.20485926199505,7.802531156136936 59.24940739412325,7.889518008391151 59.2542131841146,7.898831088155645 59.20965660250949,7.811955780794094 59.20485926199505)))"
20950006585000,28,18,10,50.7,"MULTIPOLYGON(((7.898831088155645 59.20965660250949,7.889518008391151 59.2542131841146,7.976533520240421 59.25896105979974,7.985734932619722 59.21439612820817,7.898831088155645 59.20965660250949)))"
21000006585000,53,28,25,44.5,"MULTIPOLYGON(((7.985734932619722 59.21439612820817,7.976533520240421 59.25896105979974,8.0635773571181 59.263650982705045,8.072666980993667 59.21907780076891,7.985734932619722 59.21439612820817)))"
21050006585000,86,49,37,46.2,"MULTIPOLYGON(((8.072666980993667 59.21907780076891,8.0635773571181 59.263650982705045,8.150649183759088 59.2682829148038,8.159626899391329 59.223701582314824,8.072666980993667 59.21907780076891)))"
21300006585000,29,17,12,54.4,"MULTIPOLYGON(((8.507738571645469 59.2416170564588,8.499209658632804 59.28622999030364,8.586416381199474 59.290571413689285,8.594832808125082 59.24595083043896,8.507738571645469 59.2416170564588)))"
21400006585000,7,3,4,63.6,"MULTIPOLYGON(((8.681952897171517 59.250226495555246,8.673649067697568 59.29485462755577,8.760907378186793 59.29907959703577,8.769098500256714 59.25444401707825,8.681952897171517 59.250226495555246)))"
21450006585000,10,6,4,45,"MULTIPOLYGON(((8.769098500256714 59.25444401707825,8.760907378186793 59.29907959703577,8.848190972090025 59.30324628771757,8.856269278220338 59.25860336073246,8.769098500256714 59.25444401707825)))"
21550006585000,1,1,0,0,"MULTIPOLYGON(((8.943464891277603 59.262704492697225,8.935499508201206 59.30735466564603,9.022832644693255 59.311404697323795,9.030684999027148 59.26674737960789,8.943464891277603 59.262704492697225)))"
21600006585000,1809,880,929,46,"MULTIPOLYGON(((9.030684999027148 59.26674737960789,9.022832644693255 59.311404697323795,9.110190039126026 59.31539634971205,9.117929260458927 59.270731988556626,9.030684999027148 59.26674737960789)))"
21650006585000,317,168,149,45.9,"MULTIPOLYGON(((9.117929260458927 59.270731988556626,9.110190039126026 59.31539634971205,9.197571348454328 59.319329590231696,9.205197333962177 59.274658287093544,9.117929260458927 59.270731988556626)))"
21700006585000,1412,719,693,42.6,"MULTIPOLYGON(((9.205197333962177 59.274658287093544,9.197571348454328 59.319329590231696,9.28497622903594 59.32320438676425,9.292488877333385 59.2785262432276,9.205197333962177 59.274658287093544)))"
21750006585000,110,62,48,49.5,"MULTIPOLYGON(((9.292488877333385 59.2785262432276,9.28497622903594 59.32320438676425,9.372404336639693 59.32702070765279,9.379803547784306 59.28233582542759,9.292488877333385 59.2785262432276)))"
21800006585000,17,9,8,54.1,"MULTIPOLYGON(((9.379803547784306 59.28233582542759,9.372404336639693 59.32702070765279,9.459855326453576 59.33077852170298,9.467141001950022 59.28608700262307,9.379803547784306 59.28233582542759)))"
21850006585000,35,20,15,46.7,"MULTIPOLYGON(((9.467141001950022 59.28608700262307,9.459855326453576 59.33077852170298,9.547328853092885 59.33447779818397,9.554500895897029 59.289779744205276,9.467141001950022 59.28608700262307)))"
21900006585000,81,41,40,39.5,"MULTIPOLYGON(((9.554500895897029 59.289779744205276,9.547328853092885 59.33447779818397,9.634824570608407 59.338118506829325,9.64188288513136 59.293414020028145,9.554500895897029 59.289779744205276)))"
21950006585000,236,122,114,43.3,"MULTIPOLYGON(((9.64188288513136 59.293414020028145,9.634824570608407 59.338118506829325,9.72234213249463 59.34170061783789,9.72928662460675 59.296989800409044,9.64188288513136 59.293414020028145)))"
22000006585000,2,2,0,0,"MULTIPOLYGON(((9.72928662460675 59.296989800409044,9.72234213249463 59.34170061783789,9.809881191698 59.34522410187479,9.81671176873283 59.30050705612984,9.72928662460675 59.296989800409044)))"
22050006585000,440,238,202,41.8,"MULTIPOLYGON(((9.81671176873283 59.30050705612984,9.809881191698 59.34522410187479,9.897441400625203 59.34868893007226,9.904157971383345 59.3039657584377,9.81671176873283 59.30050705612984)))"
22100006585000,79,44,35,37.7,"MULTIPOLYGON(((9.904157971383345 59.3039657584377,9.897441400625203 59.34868893007226,9.985022411151483 59.352095074030466,9.991624885904422 59.30736587904589,9.904157971383345 59.3039657584377)))"
22150006585000,70,39,31,42.8,"MULTIPOLYGON(((9.991624885904422 59.30736587904589,9.985022411151483 59.352095074030466,10.072623874629004 59.35544250581847,10.079112165122876 59.3107073901348,9.991624885904422 59.30736587904589)))"
22200006585000,637,334,303,39.2,"MULTIPOLYGON(((10.079112165122876 59.3107073901348,10.072623874629004 59.35544250581847,10.160245441895212 59.35873119797504,10.166619461354513 59.31399026435262,10.079112165122876 59.3107073901348)))"
22250006585000,516,258,258,37.6,"MULTIPOLYGON(((10.166619461354513 59.31399026435262,10.160245441895212 59.35873119797504,10.247886763281281 59.36196112350942,10.254146426412502 59.317214474816254,10.166619461354513 59.31399026435262)))"
22300006585000,1865,954,911,36.5,"MULTIPOLYGON(((10.254146426412502 59.317214474816254,10.247886763281281 59.36196112350942,10.33554748862055 59.365132255902196,10.341692711615769 59.32037999511211,10.254146426412502 59.317214474816254)))"
22350006585000,1025,551,474,38.8,"MULTIPOLYGON(((10.341692711615769 59.32037999511211,10.33554748862055 59.365132255902196,10.423227267256989 59.36824456910617,10.429257967797406 59.32348679929693,10.341692711615769 59.32037999511211)))"
22400006585000,3801,1915,1886,44.5,"MULTIPOLYGON(((10.429257967797406 59.32348679929693,10.423227267256989 59.36824456910617,10.510925748053731 59.37129803754702,10.516841845313134 59.32653486189851,10.429257967797406 59.32348679929693)))"
22500006585000,685,351,334,44,"MULTIPOLYGON(((10.604443994049769 59.32952415791654,10.598642579401604 59.37429263612416,10.686377409227697 59.377228340211516,10.692064063433747 59.33245466282329,10.604443994049769 59.32952415791654)))"
22550006585000,2947,1470,1477,43.7,"MULTIPOLYGON(((10.692064063433747 59.33245466282329,10.686377409227697 59.377228340211516,10.774129885003976 59.3801051256582,10.779701702439658 59.33532635256445,10.692064063433747 59.33245466282329)))"
22600006585000,2813,1408,1405,40.6,"MULTIPOLYGON(((10.779701702439658 59.33532635256445,10.774129885003976 59.3801051256582,10.86189965375589 59.38292296878931,10.86735655959881 59.338139203559805,10.779701702439658 59.33532635256445)))"
22650006585000,2359,1243,1116,42.2,"MULTIPOLYGON(((10.86735655959881 59.338139203559805,10.86189965375589 59.38292296878931,10.949686362071054 59.38568184640662,10.955028283007838 59.34089319270395,10.86735655959881 59.338139203559805)))"
22700006585000,147,79,68,36.1,"MULTIPOLYGON(((10.955028283007838 59.34089319270395,10.949686362071054 59.38568184640662,11.037489656107905 59.38838173578937,11.042716520337304 59.34358829736695,10.955028283007838 59.34089319270395)))"
22750006585000,127,69,58,42.2,"MULTIPOLYGON(((11.042716520337304 59.34358829736695,11.037489656107905 59.38838173578937,11.125309181604443 59.391022614694805,11.130420918840374 59.34622449539517,11.042716520337304 59.34358829736695)))"
22800006585000,855,444,411,39.1,"MULTIPOLYGON(((11.130420918840374 59.34622449539517,11.125309181604443 59.391022614694805,11.213144583886947 59.393604461359,11.21814112536147 59.34880176511181,11.130420918840374 59.34622449539517)))"
22850006585000,261,136,125,42.2,"MULTIPOLYGON(((11.21814112536147 59.34880176511181,11.213144583886947 59.393604461359,11.300995507878747 59.396127254497415,11.305876786344992 59.3513200853176,11.21814112536147 59.34880176511181)))"
22900006585000,304,168,136,39.1,"MULTIPOLYGON(((11.305876786344992 59.3513200853176,11.300995507878747 59.396127254497415,11.38886159810902 59.3985909733057,11.393627547844028 59.35377943529152,11.305876786344992 59.3513200853176)))"
22950006585000,646,335,311,42.7,"MULTIPOLYGON(((11.393627547844028 59.35377943529152,11.38886159810902 59.3985909733057,11.476742498721595 59.40099559746011,11.481393055529123 59.35617979479131,11.393627547844028 59.35377943529152)))"
23000006585000,171,91,80,42.6,"MULTIPOLYGON(((11.481393055529123 59.35617979479131,11.476742498721595 59.40099559746011,11.5646378534838 59.40334110711833,11.569172954697043 59.35852114405418,11.481393055529123 59.35617979479131)))"
23050006585000,42,21,21,44.5,"MULTIPOLYGON(((11.569172954697043 59.35852114405418,11.5646378534838 59.40334110711833,11.652547305795325 59.405627482919996,11.656966890279579 59.36080346379746,11.569172954697043 59.35852114405418)))"
23100006585000,214,113,101,40.8,"MULTIPOLYGON(((11.656966890279579 59.36080346379746,11.652547305795325 59.405627482919996,11.7404704986971 59.40785470598723,11.744774506852377 59.36302673521898,11.656966890279579 59.36080346379746)))"
23150006585000,4,2,2,0,"MULTIPOLYGON(((11.744774506852377 59.36302673521898,11.7404704986971 59.40785470598723,11.828407074880213 59.41002275792538,11.832595448643763 59.36519093999788,11.744774506852377 59.36302673521898)))"
19600006590000,421,230,191,38.5,"MULTIPOLYGON(((5.552010921747387 59.1042654182446,5.539696098638993 59.14855759215697,5.625931038150152 59.154865219863346,5.638137653040379 59.110562040251644,5.552010921747387 59.1042654182446)))"
19650006590000,221,111,110,41.5,"MULTIPOLYGON(((5.638137653040379 59.110562040251644,5.625931038150152 59.154865219863346,5.71220322432605 59.161115991269234,5.72430147379227 59.11680190116987,5.638137653040379 59.110562040251644)))"
19700006590000,99,52,47,40.1,"MULTIPOLYGON(((5.72430147379227 59.11680190116987,5.71220322432605 59.161115991269234,5.798512342031445 59.16730985652113,5.810502070102904 59.12298495133891,5.72430147379227 59.11680190116987)))"
19750006590000,1157,595,562,41.1,"MULTIPOLYGON(((5.810502070102904 59.12298495133891,5.798512342031445 59.16730985652113,5.884858075245902 59.17344676618063,5.896739127193081 59.12911114151202,5.810502070102904 59.12298495133891)))"
19800006590000,311,165,146,42.3,"MULTIPOLYGON(((5.896739127193081 59.12911114151202,5.884858075245902 59.17344676618063,5.971240107070162 59.179526671225894,5.983012329410909 59.135180422857566,5.896739127193081 59.12911114151202)))"
19850006590000,156,74,82,39,"MULTIPOLYGON(((5.983012329410909 59.135180422857566,5.971240107070162 59.179526671225894,6.057658119732568 59.18554952305301,6.069321360238194 59.14119274696031,5.983012329410909 59.135180422857566)))"
19900006590000,324,169,155,40.6,"MULTIPOLYGON(((6.069321360238194 59.14119274696031,6.057658119732568 59.18554952305301,6.144111794595583 59.19151527347736,6.155665902296884 59.14714806582288,6.069321360238194 59.14119274696031)))"
19950006590000,473,251,222,39.7,"MULTIPOLYGON(((6.155665902296884 59.14714806582288,6.144111794595583 59.19151527347736,6.230600812162276 59.19742387473506,6.242045637355568 59.15304633186716,6.155665902296884 59.14714806582288)))"
20100006590000,3,1,2,0,"MULTIPOLYGON(((6.414909409319703 59.164671517292724,6.4036835931617 59.209069440807056,6.490276713363224 59.214806312209596,6.50139280555462 59.17039834362617,6.414909409319703 59.164671517292724)))"
20700006590000,109,58,51,49.1,"MULTIPOLYGON(((7.454877009537826 59.229605876147495,7.44497713572482 59.27411789505083,7.531957390411034 59.27916381737585,7.541745891976667 59.23464292972858,7.454877009537826 59.229605876147495)))"
20750006590000,50,22,28,39.9,"MULTIPOLYGON(((7.541745891976667 59.23464292972858,7.531957390411034 59.27916381737585,7.618967764498127 59.284151884625985,7.628644765142902 59.239622227344434,7.541745891976667 59.23464292972858)))"
20950006590000,4,2,2,0,"MULTIPOLYGON(((7.889518008391151 59.2542131841146,7.880176268913944 59.29876855405994,7.967303782716297 59.30352480136773,7.976533520240421 59.25896105979974,7.889518008391151 59.2542131841146)))"
21000006590000,29,19,10,33.8,"MULTIPOLYGON(((7.976533520240421 59.25896105979974,7.967303782716297 59.30352480136773,8.05445974336407 59.3082229960077,8.0635773571181 59.263650982705045,7.976533520240421 59.25896105979974)))"
21050006590000,107,60,47,46.2,"MULTIPOLYGON(((8.0635773571181 59.263650982705045,8.05445974336407 59.3082229960077,8.141643814205645 59.312863099802485,8.150649183759088 59.2682829148038,8.0635773571181 59.263650982705045)))"
21200006590000,24,14,10,51.4,"MULTIPOLYGON(((8.324875461823737 59.277372656716,8.316094936392235 59.321968884396725,8.403361310985458 59.326434491094595,8.412029239293174 59.28183039272074,8.324875461823737 59.277372656716)))"
21250006590000,229,117,112,50.2,"MULTIPOLYGON(((8.412029239293174 59.28183039272074,8.403361310985458 59.326434491094595,8.490654442284347 59.33084185874632,8.499209658632804 59.28622999030364,8.412029239293174 59.28183039272074)))"
21300006590000,101,54,47,53,"MULTIPOLYGON(((8.499209658632804 59.28622999030364,8.490654442284347 59.33084185874632,8.577973990234998 59.335190951434285,8.586416381199474 59.290571413689285,8.499209658632804 59.28622999030364)))"
21400006590000,54,28,26,48.2,"MULTIPOLYGON(((8.673649067697568 59.29485462755577,8.665319614126354 59.3394817336962,8.752690972598039 59.34371417052603,8.760907378186793 59.29907959703577,8.673649067697568 59.29485462755577)))"
21450006590000,18,10,8,60.3,"MULTIPOLYGON(((8.760907378186793 59.29907959703577,8.752690972598039 59.34371417052603,8.84008772364826 59.3478882273751,8.848190972090025 59.30324628771757,8.760907378186793 59.29907959703577)))"
21500006590000,5,3,2,69.2,"MULTIPOLYGON(((8.848190972090025 59.30324628771757,8.84008772364826 59.3478882273751,8.927509524641765 59.35200387015309,8.935499508201206 59.30735466564603,8.848190972090025 59.30324628771757)))"
21550006590000,147,78,69,41.7,"MULTIPOLYGON(((8.935499508201206 59.30735466564603,8.927509524641765 59.35200387015309,9.014956032317786 59.356061065229134,9.022832644693255 59.311404697323795,8.935499508201206 59.30735466564603)))"
21600006590000,411,218,193,41.7,"MULTIPOLYGON(((9.022832644693255 59.311404697323795,9.014956032317786 59.356061065229134,9.10242690279809 59.36005977943276,9.110190039126026 59.31539634971205,9.022832644693255 59.311404697323795)))"
21650006590000,143,76,67,43,"MULTIPOLYGON(((9.110190039126026 59.31539634971205,9.10242690279809 59.36005977943276,9.189921791595012 59.36399998005492,9.197571348454328 59.319329590231696,9.110190039126026 59.31539634971205)))"
21700006590000,105,59,46,48.4,"MULTIPOLYGON(((9.197571348454328 59.319329590231696,9.189921791595012 59.36399998005492,9.277440353619552 59.367881634848956,9.28497622903594 59.32320438676425,9.197571348454328 59.319329590231696)))"
21750006590000,4,2,2,0,"MULTIPOLYGON(((9.28497622903594 59.32320438676425,9.277440353619552 59.367881634848956,9.364982243189504 59.371704712031594,9.372404336639693 59.32702070765279,9.28497622903594 59.32320438676425)))"
21950006590000,11,8,3,43.4,"MULTIPOLYGON(((9.634824570608407 59.338118506829325,9.627744411623413 59.38282216704909,9.715376142975403 59.386410625254186,9.72234213249463 59.34170061783789,9.634824570608407 59.338118506829325)))"
22100006590000,355,195,160,42.4,"MULTIPOLYGON(((9.897441400625203 59.34868893007226,9.890704028180805 59.39341132404893,9.978399483361526 59.39682350714168,9.985022411151483 59.352095074030466,9.897441400625203 59.34868893007226)))"
22150006590000,30,15,15,53,"MULTIPOLYGON(((9.985022411151483 59.352095074030466,9.978399483361526 59.39682350714168,10.066115480262056 59.400176875150606,10.072623874629004 59.35544250581847,9.985022411151483 59.352095074030466)))"
22200006590000,796,441,355,38.5,"MULTIPOLYGON(((10.072623874629004 59.35544250581847,10.066115480262056 59.400176875150606,10.153851668233079 59.40347140050442,10.160245441895212 59.35873119797504,10.072623874629004 59.35544250581847)))"
22250006590000,595,314,281,41.1,"MULTIPOLYGON(((10.160245441895212 59.35873119797504,10.153851668233079 59.40347140050442,10.24160769611531 59.406707056104096,10.247886763281281 59.36196112350942,10.160245441895212 59.35873119797504)))"
22300006590000,2505,1235,1270,44.1,"MULTIPOLYGON(((10.247886763281281 59.36196112350942,10.24160769611531 59.406707056104096,10.329383212248018 59.40988381532389,10.33554748862055 59.365132255902196,10.247886763281281 59.36196112350942)))"
22350006590000,2714,1409,1305,36.9,"MULTIPOLYGON(((10.33554748862055 59.365132255902196,10.329383212248018 59.40988381532389,10.41717786447755 59.41300165201199,10.423227267256989 59.36824456910617,10.33554748862055 59.365132255902196)))"
22400006590000,11865,5859,6006,42.6,"MULTIPOLYGON(((10.423227267256989 59.36824456910617,10.41717786447755 59.41300165201199,10.504991300165909 59.41606054049143,10.510925748053731 59.37129803754702,10.423227267256989 59.36824456910617)))"
22450006590000,2,2,0,0,"MULTIPOLYGON(((10.510925748053731 59.37129803754702,10.504991300165909 59.41606054049143,10.592823166199356 59.41906045556081,10.598642579401604 59.37429263612416,10.510925748053731 59.37129803754702)))"
22500006590000,5210,2585,2625,45.2,"MULTIPOLYGON(((10.598642579401604 59.37429263612416,10.592823166199356 59.41906045556081,10.680673108997047 59.422001372495046,10.686377409227697 59.377228340211516,10.598642579401604 59.37429263612416)))"
22550006590000,6404,3269,3135,39.6,"MULTIPOLYGON(((10.686377409227697 59.377228340211516,10.680673108997047 59.422001372495046,10.768540774519678 59.424883267046226,10.774129885003976 59.3801051256582,10.686377409227697 59.377228340211516)))"
22600006590000,82,51,31,43.5,"MULTIPOLYGON(((10.774129885003976 59.3801051256582,10.768540774519678 59.424883267046226,10.856425808278194 59.42770611544423,10.86189965375589 59.38292296878931,10.774129885003976 59.3801051256582)))"
22650006590000,2,1,1,0,"MULTIPOLYGON(((10.86189965375589 59.38292296878931,10.856425808278194 59.42770611544423,10.9443278553425 59.43046989439754,10.949686362071054 59.38568184640662,10.86189965375589 59.38292296878931)))"
22700006590000,594,291,303,39.4,"MULTIPOLYGON(((10.949686362071054 59.38568184640662,10.9443278553425 59.43046989439754,11.032246560350202 59.433174581093915,11.037489656107905 59.38838173578937,10.949686362071054 59.38568184640662)))"
22750006590000,176,85,91,41.3,"MULTIPOLYGON(((11.037489656107905 59.38838173578937,11.032246560350202 59.433174581093915,11.12018156751539 59.4358201532011,11.125309181604443 59.391022614694805,11.037489656107905 59.38838173578937)))"
22800006590000,196,103,93,42.9,"MULTIPOLYGON(((11.125309181604443 59.391022614694805,11.12018156751539 59.4358201532011,11.208132520637431 59.43840658886752,11.213144583886947 59.393604461359,11.125309181604443 59.391022614694805)))"
22850006590000,204,111,93,39.9,"MULTIPOLYGON(((11.213144583886947 59.393604461359,11.208132520637431 59.43840658886752,11.296099063109807 59.44093386672295,11.300995507878747 59.396127254497415,11.213144583886947 59.393604461359)))"
22900006590000,4964,2453,2511,43.6,"MULTIPOLYGON(((11.300995507878747 59.396127254497415,11.296099063109807 59.44093386672295,11.384080837928957 59.4434019658791,11.38886159810902 59.3985909733057,11.300995507878747 59.396127254497415)))"
22950006590000,286,150,136,41.3,"MULTIPOLYGON(((11.38886159810902 59.3985909733057,11.384080837928957 59.4434019658791,11.472077487703165 59.445810865930405,11.476742498721595 59.40099559746011,11.38886159810902 59.3985909733057)))"
23000006590000,12,7,5,39.8,"MULTIPOLYGON(((11.476742498721595 59.40099559746011,11.472077487703165 59.445810865930405,11.56008865466145 59.44816054695448,11.5646378534838 59.40334110711833,11.476742498721595 59.40099559746011)))"
23050006590000,20,11,9,44.4,"MULTIPOLYGON(((11.5646378534838 59.40334110711833,11.56008865466145 59.44816054695448,11.648113980662512 59.4504509895129,11.652547305795325 59.405627482919996,11.5646378534838 59.40334110711833)))"
23100006590000,207,116,91,38.8,"MULTIPOLYGON(((11.652547305795325 59.405627482919996,11.648113980662512 59.4504509895129,11.736153107203663 59.452682174651684,11.7404704986971 59.40785470598723,11.652547305795325 59.405627482919996)))"
23150006590000,7,4,3,36.9,"MULTIPOLYGON(((11.7404704986971 59.40785470598723,11.736153107203663 59.452682174651684,11.824205675429818 59.45485408390187,11.828407074880213 59.41002275792538,11.7404704986971 59.40785470598723)))"
19400006595000,3403,1707,1696,42.9,"MULTIPOLYGON(((5.19513507861179 59.12275952984403,5.182350210175833 59.167004726147,5.268540907384944 59.1735506857876,5.281217898035911 59.12929407596592,5.19513507861179 59.12275952984403)))"
19450006595000,164,82,82,43.9,"MULTIPOLYGON(((5.281217898035911 59.12929407596592,5.268540907384944 59.1735506857876,5.354770265822091 59.18003989802162,5.367339215687978 59.13577196932346,5.281217898035911 59.12929407596592)))"
19500006595000,35,15,20,40.9,"MULTIPOLYGON(((5.367339215687978 59.13577196932346,5.354770265822091 59.18003989802162,5.441037972739421 59.1864723111497,5.4534987200363 59.1421931584172,5.367339215687978 59.13577196932346)))"
19550006595000,4,3,1,0,"MULTIPOLYGON(((5.4534987200363 59.1421931584172,5.441037972739421 59.1864723111497,5.527343714472512 59.19284787388318,5.539696098638993 59.14855759215697,5.4534987200363 59.1421931584172)))"
19750006595000,736,371,365,38.1,"MULTIPOLYGON(((5.798512342031445 59.16730985652113,5.786485998304458 59.2116329530214,5.872940724543527 59.217780609556044,5.884858075245902 59.17344676618063,5.798512342031445 59.16730985652113)))"
19800006595000,105,53,52,41.3,"MULTIPOLYGON(((5.884858075245902 59.17344676618063,5.872940724543527 59.217780609556044,5.95943190374694 59.22387116546512,5.971240107070162 59.179526671225894,5.884858075245902 59.17344676618063)))"
19850006595000,95,47,48,47.2,"MULTIPOLYGON(((5.971240107070162 59.179526671225894,5.95943190374694 59.22387116546512,6.045959216883118 59.22990457195492,6.057658119732568 59.18554952305301,5.971240107070162 59.179526671225894)))"
19900006595000,251,131,120,45.9,"MULTIPOLYGON(((6.057658119732568 59.18554952305301,6.045959216883118 59.22990457195492,6.132522344048473 59.23588078065263,6.144111794595583 59.19151527347736,6.057658119732568 59.18554952305301)))"
19950006595000,728,373,355,43.1,"MULTIPOLYGON(((6.144111794595583 59.19151527347736,6.132522344048473 59.23588078065263,6.219120964473997 59.24179974360766,6.230600812162276 59.19742387473506,6.144111794595583 59.19151527347736)))"
20000006595000,40,20,20,44.4,"MULTIPOLYGON(((6.230600812162276 59.19742387473506,6.219120964473997 59.24179974360766,6.305754756531872 59.24766141329301,6.31712485208294 59.2032752794844,6.230600812162276 59.19742387473506)))"
20050006595000,59,31,28,38.2,"MULTIPOLYGON(((6.31712485208294 59.2032752794844,6.305754756531872 59.24766141329301,6.392423397742153 59.25346574260667,6.4036835931617 59.209069440807056,6.31712485208294 59.2032752794844)))"
20650006595000,7,4,3,47.7,"MULTIPOLYGON(((7.358027332757694 59.26901415850262,7.347985433311496 59.313515858841455,7.435046810068013 59.31862858627696,7.44497713572482 59.27411789505083,7.358027332757694 59.26901415850262)))"
21050006595000,27,14,13,57,"MULTIPOLYGON(((8.05445974336407 59.3082229960077,8.045314019300259 59.35279383717234,8.132610671691147 59.357442133898296,8.141643814205645 59.312863099802485,8.05445974336407 59.3082229960077)))"
21100006595000,85,43,42,52.9,"MULTIPOLYGON(((8.141643814205645 59.312863099802485,8.132610671691147 59.357442133898296,8.219935216655637 59.36203220161511,8.22885565789358 59.31744507502444,8.141643814205645 59.312863099802485)))"
21150006595000,32,19,13,45.1,"MULTIPOLYGON(((8.22885565789358 59.31744507502444,8.219935216655637 59.36203220161511,8.307287314754033 59.36656400289792,8.316094936392235 59.321968884396725,8.22885565789358 59.31744507502444)))"
21200006595000,14,6,8,43.3,"MULTIPOLYGON(((8.316094936392235 59.321968884396725,8.307287314754033 59.36656400289792,8.394666625861248 59.37103750077551,8.403361310985458 59.326434491094595,8.316094936392235 59.321968884396725)))"
21250006595000,8,5,3,41.3,"MULTIPOLYGON(((8.403361310985458 59.326434491094595,8.394666625861248 59.37103750077551,8.482072809174593 59.37545265873151,8.490654442284347 59.33084185874632,8.403361310985458 59.326434491094595)))"
21300006595000,37,21,16,48.3,"MULTIPOLYGON(((8.490654442284347 59.33084185874632,8.482072809174593 59.37545265873151,8.569505523221602 59.379809440705436,8.577973990234998 59.335190951434285,8.490654442284347 59.33084185874632)))"
21550006595000,32,18,14,47.1,"MULTIPOLYGON(((8.927509524641765 59.35200387015309,8.919494834296888 59.39665210358634,9.007055057036467 59.40071648077333,9.014956032317786 59.356061065229134,8.927509524641765 59.35200387015309)))"
21600006595000,1251,634,617,37.1,"MULTIPOLYGON(((9.014956032317786 59.356061065229134,9.007055057036467 59.40071648077333,9.094639748053316 59.404722275248574,9.10242690279809 59.36005977943276,9.014956032317786 59.356061065229134)))"
21650006595000,1342,639,703,44.2,"MULTIPOLYGON(((9.10242690279809 59.36005977943276,9.094639748053316 59.404722275248574,9.18224856140921 59.40866945417234,9.189921791595012 59.36399998005492,9.10242690279809 59.36005977943276)))"
21700006595000,953,489,464,43.2,"MULTIPOLYGON(((9.189921791595012 59.36399998005492,9.18224856140921 59.40866945417234,9.269881150560247 59.412557985169116,9.277440353619552 59.367881634848956,9.189921791595012 59.36399998005492)))"
21750006595000,305,156,149,44.5,"MULTIPOLYGON(((9.277440353619552 59.367881634848956,9.269881150560247 59.412557985169116,9.357537168365004 59.41638783632858,9.364982243189504 59.371704712031594,9.277440353619552 59.367881634848956)))"
21850006595000,16,9,7,47.8,"MULTIPOLYGON(((9.452547114037616 59.37546918028389,9.44521626709281 59.420158976206444,9.532918098431956 59.42387137382561,9.540134619319813 59.37917500875223,9.452547114037616 59.37546918028389)))"
21900006595000,14,9,5,48.3,"MULTIPOLYGON(((9.540134619319813 59.37917500875223,9.532918098431956 59.42387137382561,9.620642313498019 59.42752499867693,9.627744411623413 59.38282216704909,9.540134619319813 59.37917500875223)))"
21950006595000,6,5,1,40.7,"MULTIPOLYGON(((9.627744411623413 59.38282216704909,9.620642313498019 59.42752499867693,9.708388562842194 59.431119820720234,9.715376142975403 59.386410625254186,9.627744411623413 59.38282216704909)))"
22050006595000,21,12,9,43.8,"MULTIPOLYGON(((9.803029464850766 59.38994035391526,9.796156496459643 59.434655810385195,9.883945763797907 59.438132938572245,9.890704028180805 59.39341132404893,9.803029464850766 59.38994035391526)))"
22100006595000,1099,542,557,45.8,"MULTIPOLYGON(((9.890704028180805 59.39341132404893,9.883945763797907 59.438132938572245,9.971756013765354 59.441551176653455,9.978399483361526 59.39682350714168,9.890704028180805 59.39341132404893)))"
22150006595000,223,127,96,37.9,"MULTIPOLYGON(((9.978399483361526 59.39682350714168,9.971756013765354 59.441551176653455,10.059586894739624 59.44491049647345,10.066115480262056 59.400176875150606,9.978399483361526 59.39682350714168)))"
22200006595000,296,165,131,42,"MULTIPOLYGON(((10.066115480262056 59.400176875150606,10.059586894739624 59.44491049647345,10.147438054576158 59.44821087035017,10.153851668233079 59.40347140050442,10.066115480262056 59.400176875150606)))"
22250006595000,711,376,335,38.8,"MULTIPOLYGON(((10.153851668233079 59.40347140050442,10.147438054576158 59.44821087035017,10.235309140616712 59.451452271075794,10.24160769611531 59.406707056104096,10.153851668233079 59.40347140050442)))"
22300006595000,1954,1052,902,40.4,"MULTIPOLYGON(((10.24160769611531 59.406707056104096,10.235309140616712 59.451452271075794,10.323199799697939 59.45463467191755,10.329383212248018 59.40988381532389,10.24160769611531 59.406707056104096)))"
22350006595000,1193,621,572,41.2,"MULTIPOLYGON(((10.329383212248018 59.40988381532389,10.323199799697939 59.45463467191755,10.41110967815999 59.45775804661855,10.41717786447755 59.41300165201199,10.329383212248018 59.40988381532389)))"
22400006595000,9444,4722,4722,44.2,"MULTIPOLYGON(((10.41717786447755 59.41300165201199,10.41110967815999 59.45775804661855,10.499038421855143 59.46082236939852,10.504991300165909 59.41606054049143,10.41717786447755 59.41300165201199)))"
22450006595000,4,2,2,0,"MULTIPOLYGON(((10.504991300165909 59.41606054049143,10.499038421855143 59.46082236939852,10.586985676156463 59.463827614954695,10.592823166199356 59.41906045556081,10.504991300165909 59.41606054049143)))"
22500006595000,21438,10481,10957,43.8,"MULTIPOLYGON(((10.592823166199356 59.41906045556081,10.586985676156463 59.463827614954695,10.674951085966494 59.4667737584625,10.680673108997047 59.422001372495046,10.592823166199356 59.41906045556081)))"
22550006595000,10669,5304,5365,40.8,"MULTIPOLYGON(((10.680673108997047 59.422001372495046,10.674951085966494 59.4667737584625,10.76293429572599 59.46966077557636,10.768540774519678 59.424883267046226,10.680673108997047 59.422001372495046)))"
22600006595000,2313,1191,1122,37.6,"MULTIPOLYGON(((10.768540774519678 59.424883267046226,10.76293429572599 59.46966077557636,10.850934949422665 59.47248864243046,10.856425808278194 59.42770611544423,10.768540774519678 59.424883267046226)))"
22650006595000,153,81,72,44.1,"MULTIPOLYGON(((10.856425808278194 59.42770611544423,10.850934949422665 59.47248864243046,10.938952690599967 59.4752573356394,10.9443278553425 59.43046989439754,10.856425808278194 59.42770611544423)))"
22700006595000,321,165,156,43.1,"MULTIPOLYGON(((10.9443278553425 59.43046989439754,10.938952690599967 59.4752573356394,11.026987162365897 59.477966832299025,11.032246560350202 59.433174581093915,10.9443278553425 59.43046989439754)))"
22750006595000,111,57,54,44.9,"MULTIPOLYGON(((11.032246560350202 59.433174581093915,11.026987162365897 59.477966832299025,11.115038007401834 59.480617109987044,11.12018156751539 59.4358201532011,11.032246560350202 59.433174581093915)))"
22800006595000,2554,1277,1277,41.8,"MULTIPOLYGON(((11.12018156751539 59.4358201532011,11.115038007401834 59.480617109987044,11.203104867971414 59.48320814676371,11.208132520637431 59.43840658886752,11.12018156751539 59.4358201532011)))"
22850006595000,387,206,181,37.9,"MULTIPOLYGON(((11.208132520637431 59.43840658886752,11.203104867971414 59.48320814676371,11.291187385929403 59.4857399211726,11.296099063109807 59.44093386672295,11.208132520637431 59.43840658886752)))"
22900006595000,729,384,345,41.3,"MULTIPOLYGON(((11.296099063109807 59.44093386672295,11.291187385929403 59.4857399211726,11.379285202730633 59.48821241224116,11.384080837928957 59.4434019658791,11.296099063109807 59.44093386672295)))"
22950006595000,105,57,48,38.7,"MULTIPOLYGON(((11.384080837928957 59.4434019658791,11.379285202730633 59.48821241224116,11.467397959438934 59.4906255994814,11.472077487703165 59.445810865930405,11.384080837928957 59.4434019658791)))"
23050006595000,35,21,14,46.1,"MULTIPOLYGON(((11.56008865466145 59.44816054695448,11.555525296736098 59.49297946289051,11.643666854930874 59.49527398295152,11.648113980662512 59.4504509895129,11.56008865466145 59.44816054695448)))"
23100006595000,2194,1070,1124,46.9,"MULTIPOLYGON(((11.648113980662512 59.4504509895129,11.643666854930874 59.49527398295152,11.731822273967992 59.49750914063386,11.736153107203663 59.452682174651684,11.648113980662512 59.4504509895129)))"
23150006595000,4,3,1,0,"MULTIPOLYGON(((11.736153107203663 59.452682174651684,11.731822273967992 59.49750914063386,11.819991193437186 59.499684917393935,11.824205675429818 59.45485408390187,11.736153107203663 59.452682174651684)))"
19400006600000,780,411,369,42.7,"MULTIPOLYGON(((5.182350210175833 59.167004726147,5.169526368531905 59.211247908735054,5.255825255352153 59.217805310949466,5.268540907384944 59.1735506857876,5.182350210175833 59.167004726147)))"
19450006600000,62,32,30,50.7,"MULTIPOLYGON(((5.268540907384944 59.1735506857876,5.255825255352153 59.217805310949466,5.342162967323262 59.224305870896906,5.354770265822091 59.18003989802162,5.268540907384944 59.1735506857876)))"
19500006600000,66,40,26,49.2,"MULTIPOLYGON(((5.354770265822091 59.18003989802162,5.342162967323262 59.224305870896906,5.428539190475047 59.23074953667702,5.441037972739421 59.1864723111497,5.354770265822091 59.18003989802162)))"
19550006600000,662,339,323,42.4,"MULTIPOLYGON(((5.441037972739421 59.1864723111497,5.428539190475047 59.23074953667702,5.514953609914356 59.237136256801534,5.527343714472512 59.19284787388318,5.441037972739421 59.1864723111497)))"
19750006600000,206,115,91,41.9,"MULTIPOLYGON(((5.786485998304458 59.2116329530214,5.774422883312566 59.25595423457332,5.86098692073038 59.26211266548866,5.872940724543527 59.217780609556044,5.786485998304458 59.2116329530214)))"
19800006600000,110,56,54,45,"MULTIPOLYGON(((5.872940724543527 59.217780609556044,5.86098692073038 59.26211266548866,5.947587566345625 59.26821389954147,5.95943190374694 59.22387116546512,5.872940724543527 59.217780609556044)))"
19850006600000,46,28,18,44.4,"MULTIPOLYGON(((5.95943190374694 59.22387116546512,5.947587566345625 59.26821389954147,6.034224499860246 59.27425788774738,6.045959216883118 59.22990457195492,5.95943190374694 59.22387116546512)))"
19900006600000,55,28,27,43.2,"MULTIPOLYGON(((6.045959216883118 59.22990457195492,6.034224499860246 59.27425788774738,6.120897400098059 59.280244581544274,6.132522344048473 59.23588078065263,6.045959216883118 59.22990457195492)))"
19950006600000,122,58,64,47.8,"MULTIPOLYGON(((6.132522344048473 59.23588078065263,6.120897400098059 59.280244581544274,6.207605945011339 59.28617393279381,6.219120964473997 59.24179974360766,6.132522344048473 59.23588078065263)))"
20000006600000,10,5,5,55.7,"MULTIPOLYGON(((6.219120964473997 59.24179974360766,6.207605945011339 59.28617393279381,6.294349811687491 59.292045893782756,6.305754756531872 59.24766141329301,6.219120964473997 59.24179974360766)))"
20050006600000,28,14,14,38.9,"MULTIPOLYGON(((6.305754756531872 59.24766141329301,6.294349811687491 59.292045893782756,6.381128676355774 59.297860417224435,6.392423397742153 59.25346574260667,6.305754756531872 59.24766141329301)))"
20100006600000,6,3,3,64.2,"MULTIPOLYGON(((6.392423397742153 59.25346574260667,6.381128676355774 59.297860417224435,6.467942214394041 59.30361745626005,6.479126564779484 59.25921268487308,6.392423397742153 59.25346574260667)))"
20600006600000,38,18,20,46.1,"MULTIPOLYGON(((7.260954971979268 59.308345259448174,7.250770383159641 59.35283649116285,7.337912618314178 59.35801620400785,7.347985433311496 59.313515858841455,7.260954971979268 59.308345259448174)))"
20650006600000,285,133,152,43.6,"MULTIPOLYGON(((7.347985433311496 59.313515858841455,7.337912618314178 59.35801620400785,7.425085901789087 59.36313794562537,7.435046810068013 59.31862858627696,7.347985433311496 59.313515858841455)))"
20850006600000,2,1,1,0,"MULTIPOLYGON(((7.696413099845325 59.33361912449089,7.686788695420194 59.378154929135185,7.774082821695886 59.38304437409399,7.783594801522911 59.338499953970235,7.696413099845325 59.33361912449089)))"
21000006600000,117,63,54,47.3,"MULTIPOLYGON(((7.958045598229531 59.3480873493147,7.948758844258799 59.392648700021724,8.036140063799477 59.39736350267345,8.045314019300259 59.35279383717234,7.958045598229531 59.3480873493147)))"
21050006600000,34,17,17,49.1,"MULTIPOLYGON(((8.045314019300259 59.35279383717234,8.036140063799477 59.39736350267345,8.12354963648752 59.40202001365807,8.132610671691147 59.357442133898296,8.045314019300259 59.35279383717234)))"
21100006600000,101,54,47,48.8,"MULTIPOLYGON(((8.132610671691147 59.357442133898296,8.12354963648752 59.40202001365807,8.210987222169546 59.406618194947576,8.219935216655637 59.36203220161511,8.132610671691147 59.357442133898296)))"
21250006600000,311,162,149,45.1,"MULTIPOLYGON(((8.394666625861248 59.37103750077551,8.385945068419277 59.4156394186014,8.473464645220854 59.42006238718547,8.482072809174593 59.37545265873151,8.394666625861248 59.37103750077551)))"
21300006600000,828,413,415,43.6,"MULTIPOLYGON(((8.482072809174593 59.37545265873151,8.473464645220854 59.42006238718547,8.561010867499906 59.42442687851615,8.569505523221602 59.379809440705436,8.482072809174593 59.37545265873151)))"
21350006600000,4,2,2,0,"MULTIPOLYGON(((8.569505523221602 59.379809440705436,8.561010867499906 59.42442687851615,8.648583391690849 59.4287328568479,8.656964425867912 59.384107811093706,8.569505523221602 59.379809440705436)))"
21400006600000,49,25,24,43.3,"MULTIPOLYGON(((8.656964425867912 59.384107811093706,8.648583391690849 59.4287328568479,8.736181873569398 59.432980286894995,8.744449174325165 59.38834773475085,8.656964425867912 59.384107811093706)))"
21450006600000,14,8,6,40.9,"MULTIPOLYGON(((8.744449174325165 59.38834773475085,8.736181873569398 59.432980286894995,8.823805968260558 59.4371691338326,8.83195942515897 59.392529176990486,8.744449174325165 59.38834773475085)))"
21500006600000,230,122,108,40.4,"MULTIPOLYGON(((8.83195942515897 59.392529176990486,8.823805968260558 59.4371691338326,8.911455330246685 59.441299363297674,8.919494834296888 59.39665210358634,8.83195942515897 59.392529176990486)))"
21550006600000,335,175,160,40.9,"MULTIPOLYGON(((8.919494834296888 59.39665210358634,8.911455330246685 59.441299363297674,8.999129613375569 59.44537094139022,9.007055057036467 59.40071648077333,8.919494834296888 59.39665210358634)))"
21600006600000,4568,2241,2327,40.1,"MULTIPOLYGON(((9.007055057036467 59.40071648077333,8.999129613375569 59.44537094139022,9.086828470868548 59.44938383467418,9.094639748053316 59.404722275248574,9.007055057036467 59.40071648077333)))"
21650006600000,709,352,357,42.3,"MULTIPOLYGON(((9.094639748053316 59.404722275248574,9.086828470868548 59.44938383467418,9.17455155532869 59.45333801017845,9.18224856140921 59.40866945417234,9.094639748053316 59.404722275248574)))"
21700006600000,12,7,5,46.7,"MULTIPOLYGON(((9.18224856140921 59.40866945417234,9.17455155532869 59.45333801017845,9.262298518748992 59.45723343539795,9.269881150560247 59.412557985169116,9.18224856140921 59.40866945417234)))"
21750006600000,542,277,265,44.7,"MULTIPOLYGON(((9.269881150560247 59.412557985169116,9.262298518748992 59.45723343539795,9.350069012520626 59.46107007829452,9.357537168365004 59.41638783632858,9.269881150560247 59.412557985169116)))"
21850006600000,8,4,4,39,"MULTIPOLYGON(((9.44521626709281 59.420158976206444,9.4378626874412 59.46484790729792,9.525679193723107 59.468566891306885,9.532918098431956 59.42387137382561,9.44521626709281 59.420158976206444)))"
21900006600000,7,4,3,42,"MULTIPOLYGON(((9.532918098431956 59.42387137382561,9.525679193723107 59.468566891306885,9.613518181001847 59.47222699968987,9.620642313498019 59.42752499867693,9.532918098431956 59.42387137382561)))"
22050006600000,18,9,9,46.2,"MULTIPOLYGON(((9.796156496459643 59.434655810385195,9.789262194257834 59.47937046940684,9.877166516697379 59.48285377183541,9.883945763797907 59.438132938572245,9.796156496459643 59.434655810385195)))"
22100006600000,3,1,2,0,"MULTIPOLYGON(((9.883945763797907 59.438132938572245,9.877166516697379 59.48285377183541,9.965091913075318 59.48627808082892,9.971756013765354 59.441551176653455,9.883945763797907 59.438132938572245)))"
22150006600000,1072,521,551,46.9,"MULTIPOLYGON(((9.971756013765354 59.441551176653455,9.965091913075318 59.48627808082892,10.05303803026932 59.48964336811876,10.059586894739624 59.44491049647345,9.971756013765354 59.441551176653455)))"
22200006600000,247,133,114,39.2,"MULTIPOLYGON(((10.059586894739624 59.44491049647345,10.05303803026932 59.48964336811876,10.14100451463103 59.49294960591167,10.147438054576158 59.44821087035017,10.059586894739624 59.44491049647345)))"
22250006600000,298,162,136,40.8,"MULTIPOLYGON(((10.147438054576158 59.44821087035017,10.14100451463103 59.49294960591167,10.228991011994681 59.49619676689031,10.235309140616712 59.451452271075794,10.147438054576158 59.44821087035017)))"
22300006600000,6710,3330,3380,43.2,"MULTIPOLYGON(((10.235309140616712 59.451452271075794,10.228991011994681 59.49619676689031,10.316997167685718 59.499384824214346,10.323199799697939 59.45463467191755,10.235309140616712 59.451452271075794)))"
22350006600000,1436,698,738,44.7,"MULTIPOLYGON(((10.323199799697939 59.45463467191755,10.316997167685718 59.499384824214346,10.405022626529462 59.502513751521114,10.41110967815999 59.45775804661855,10.323199799697939 59.45463467191755)))"
22500006600000,124,66,58,47.7,"MULTIPOLYGON(((10.586985676156463 59.463827614954695,10.581130030527886 59.50859411302597,10.669211262910965 59.51154549689466,10.674951085966494 59.4667737584625,10.586985676156463 59.463827614954695)))"
22550006600000,5263,2604,2659,38.4,"MULTIPOLYGON(((10.674951085966494 59.4667737584625,10.669211262910965 59.51154549689466,10.757310372921081 59.514437650088915,10.76293429572599 59.46966077557636,10.674951085966494 59.4667737584625)))"
22600006600000,488,274,214,38.6,"MULTIPOLYGON(((10.76293429572599 59.46966077557636,10.757310372921081 59.514437650088915,10.845427003013933 59.51727054864663,10.850934949422665 59.47248864243046,10.76293429572599 59.46966077557636)))"
22650006600000,1742,886,856,37.3,"MULTIPOLYGON(((10.850934949422665 59.47248864243046,10.845427003013933 59.51727054864663,10.933560795197705 59.52004416908807,10.938952690599967 59.4752573356394,10.850934949422665 59.47248864243046)))"
22700006600000,135,66,69,44.2,"MULTIPOLYGON(((10.938952690599967 59.4752573356394,10.933560795197705 59.52004416908807,11.021711391041954 59.522758488416535,11.026987162365897 59.477966832299025,10.938952690599967 59.4752573356394)))"
22750006600000,195,104,91,39.1,"MULTIPOLYGON(((11.026987162365897 59.477966832299025,11.021711391041954 59.522758488416535,11.109878431686493 59.52541348411927,11.115038007401834 59.480617109987044,11.026987162365897 59.477966832299025)))"
22800006600000,553,285,268,40.6,"MULTIPOLYGON(((11.115038007401834 59.480617109987044,11.109878431686493 59.52541348411927,11.19806155785032 59.52800913416788,11.203104867971414 59.48320814676371,11.115038007401834 59.480617109987044)))"
22850006600000,489,257,232,42.1,"MULTIPOLYGON(((11.203104867971414 59.48320814676371,11.19806155785032 59.52800913416788,11.286260409840585 59.53054541701925,11.291187385929403 59.4857399211726,11.203104867971414 59.48320814676371)))"
22900006600000,1086,559,527,39.3,"MULTIPOLYGON(((11.291187385929403 59.4857399211726,11.286260409840585 59.53054541701925,11.374474627561563 59.533022311615994,11.379285202730633 59.48821241224116,11.291187385929403 59.4857399211726)))"
22950006600000,360,190,170,39.6,"MULTIPOLYGON(((11.379285202730633 59.48821241224116,11.374474627561563 59.533022311615994,11.462703850523663 59.53543979738731,11.467397959438934 59.4906255994814,11.379285202730633 59.48821241224116)))"
23000006600000,4,3,1,0,"MULTIPOLYGON(((11.467397959438934 59.4906255994814,11.462703850523663 59.53543979738731,11.550947717852456 59.53779785424951,11.555525296736098 59.49297946289051,11.467397959438934 59.4906255994814)))"
23050006600000,88,47,41,45.1,"MULTIPOLYGON(((11.555525296736098 59.49297946289051,11.550947717852456 59.53779785424951,11.639205868297733 59.540096462606634,11.643666854930874 59.49527398295152,11.555525296736098 59.49297946289051)))"
23100006600000,158,82,76,46.2,"MULTIPOLYGON(((11.643666854930874 59.49527398295152,11.639205868297733 59.540096462606634,11.727477940242586 59.54233560335108,11.731822273967992 59.49750914063386,11.643666854930874 59.49527398295152)))"
19400006605000,4682,2368,2314,39.8,"MULTIPOLYGON(((5.169526368531905 59.211247908735054,5.156663388540236 59.25548907045986,5.243070778013639 59.262057944426424,5.255825255352153 59.217805310949466,5.169526368531905 59.211247908735054)))"
19450006605000,691,356,335,42.3,"MULTIPOLYGON(((5.255825255352153 59.217805310949466,5.243070778013639 59.262057944426424,5.329517157489913 59.268569881046616,5.342162967323262 59.224305870896906,5.255825255352153 59.217805310949466)))"
19550006605000,108,55,53,48.6,"MULTIPOLYGON(((5.428539190475047 59.23074953667702,5.416002211770363 59.27502482821799,5.50252562472684 59.281422734251684,5.514953609914356 59.237136256801534,5.428539190475047 59.23074953667702)))"
19600006605000,23,15,8,44.8,"MULTIPOLYGON(((5.514953609914356 59.237136256801534,5.50252562472684 59.281422734251684,5.589087079308017 59.287763547874,5.601405909831289 59.24346598019595,5.514953609914356 59.237136256801534)))"
19650006605000,22,12,10,53.2,"MULTIPOLYGON(((5.601405909831289 59.24346598019595,5.589087079308017 59.287763547874,5.675686257545733 59.29404721822777,5.687895773505497 59.24973865620083,5.601405909831289 59.24346598019595)))"
19750006605000,56,29,27,48.6,"MULTIPOLYGON(((5.774422883312566 59.25595423457332,5.762322840561383 59.30027369487391,5.848996508572362 59.306442927792844,5.86098692073038 59.26211266548866,5.774422883312566 59.25595423457332)))"
19800006605000,28,15,13,41.1,"MULTIPOLYGON(((5.86098692073038 59.26211266548866,5.848996508572362 59.306442927792844,5.935706940898562 59.31255486738596,5.947587566345625 59.26821389954147,5.86098692073038 59.26211266548866)))"
19850006605000,58,30,28,47.6,"MULTIPOLYGON(((5.947587566345625 59.26821389954147,5.935706940898562 59.31255486738596,6.02245381596892 59.31860946447704,6.034224499860246 59.27425788774738,5.947587566345625 59.26821389954147)))"
19900006605000,15,8,7,28.3,"MULTIPOLYGON(((6.034224499860246 59.27425788774738,6.02245381596892 59.31860946447704,6.109236811328025 59.324606670313734,6.120897400098059 59.280244581544274,6.034224499860246 59.27425788774738)))"
19950006605000,86,47,39,47.8,"MULTIPOLYGON(((6.120897400098059 59.280244581544274,6.109236811328025 59.324606670313734,6.19605560364278 59.33054643656891,6.207605945011339 59.28617393279381,6.120897400098059 59.280244581544274)))"
20000006605000,23,13,10,39.6,"MULTIPOLYGON(((6.207605945011339 59.28617393279381,6.19605560364278 59.33054643656891,6.28290986870909 59.3364287153421,6.294349811687491 59.292045893782756,6.207605945011339 59.28617393279381)))"
20050006605000,7,3,4,40.6,"MULTIPOLYGON(((6.294349811687491 59.292045893782756,6.28290986870909 59.3364287153421,6.36979928145864 59.34225345916093,6.381128676355774 59.297860417224435,6.294349811687491 59.292045893782756)))"
20100006605000,104,55,49,40.5,"MULTIPOLYGON(((6.381128676355774 59.297860417224435,6.36979928145864 59.34225345916093,6.456723515965686 59.3480206209824,6.467942214394041 59.30361745626005,6.381128676355774 59.297860417224435)))"
20650006605000,4,2,2,0,"MULTIPOLYGON(((7.337912618314178 59.35801620400785,7.327808754868768 59.402515189675334,7.415094279356166 59.40764596887056,7.425085901789087 59.36313794562537,7.337912618314178 59.35801620400785)))"
21000006605000,201,104,97,43.7,"MULTIPOLYGON(((7.948758844258799 59.392648700021724,7.939443397574282 59.437208849848076,8.026937755033693 59.441931988964214,8.036140063799477 59.39736350267345,7.948758844258799 59.392648700021724)))"
21100006605000,183,91,92,46.6,"MULTIPOLYGON(((8.12354963648752 59.40202001365807,8.114460588173545 59.44659673562798,8.202011555425909 59.45120305165986,8.210987222169546 59.406618194947576,8.12354963648752 59.40202001365807)))"
21150006605000,6,3,3,63.5,"MULTIPOLYGON(((8.210987222169546 59.406618194947576,8.202011555425909 59.45120305165986,8.28959031451969 59.455750899336316,8.298452479994074 59.41115800896814,8.210987222169546 59.406618194947576)))"
21200006605000,48,29,19,42.3,"MULTIPOLYGON(((8.298452479994074 59.41115800896814,8.28959031451969 59.455750899336316,8.377196522488497 59.460240241390984,8.385945068419277 59.4156394186014,8.298452479994074 59.41115800896814)))"
21250006605000,132,72,60,42.9,"MULTIPOLYGON(((8.385945068419277 59.4156394186014,8.377196522488497 59.460240241390984,8.464829835678533 59.4646710410157,8.473464645220854 59.42006238718547,8.385945068419277 59.4156394186014)))"
21300006605000,156,81,75,45.6,"MULTIPOLYGON(((8.473464645220854 59.42006238718547,8.464829835678533 59.4646710410157,8.55248990975653 59.46904326186172,8.561010867499906 59.42442687851615,8.473464645220854 59.42006238718547)))"
21350006605000,213,115,98,47.1,"MULTIPOLYGON(((8.561010867499906 59.42442687851615,8.55248990975653 59.46904326186172,8.64017639971773 59.47335686804077,8.648583391690849 59.4287328568479,8.561010867499906 59.42442687851615)))"
21400006605000,82,37,45,45.4,"MULTIPOLYGON(((8.648583391690849 59.4287328568479,8.64017639971773 59.47335686804077,8.727888959893905 59.47761182412608,8.736181873569398 59.432980286894995,8.648583391690849 59.4287328568479)))"
21450006605000,30,16,14,49,"MULTIPOLYGON(((8.736181873569398 59.432980286894995,8.727888959893905 59.47761182412608,8.81562724396142 59.48180809515353,8.823805968260558 59.4371691338326,8.736181873569398 59.432980286894995)))"
21500006605000,64,34,30,48.9,"MULTIPOLYGON(((8.823805968260558 59.4371691338326,8.81562724396142 59.48180809515353,8.903390904949328 59.48594564662268,8.911455330246685 59.441299363297674,8.823805968260558 59.4371691338326)))"
21600006605000,129,75,54,41.8,"MULTIPOLYGON(((8.999129613375569 59.44537094139022,8.991179595247528 59.49002444449779,9.078992966614933 59.49404445520892,9.086828470868548 59.44938383467418,8.999129613375569 59.44537094139022)))"
21650006605000,48,27,21,49,"MULTIPOLYGON(((9.086828470868548 59.44938383467418,9.078992966614933 59.49404445520892,9.166830670187698 59.49800564565287,9.17455155532869 59.45333801017845,9.086828470868548 59.44938383467418)))"
21750006605000,257,135,122,44.8,"MULTIPOLYGON(((9.262298518748992 59.45723343539795,9.254692356487487 59.501907983194165,9.34257767542976 59.50575143566621,9.350069012520626 59.46107007829452,9.262298518748992 59.45723343539795)))"
22050006605000,259,153,106,45.9,"MULTIPOLYGON(((9.789262194257834 59.47937046940684,9.782346465439351 59.52408432909071,9.870366195569355 59.52757382202026,9.877166516697379 59.48285377183541,9.789262194257834 59.47937046940684)))"
22100006605000,190,91,99,44.4,"MULTIPOLYGON(((9.877166516697379 59.48285377183541,9.870366195569355 59.52757382202026,9.958407091481556 59.53100421792007,9.965091913075318 59.48627808082892,9.877166516697379 59.48285377183541)))"
22150006605000,494,260,234,41.1,"MULTIPOLYGON(((9.965091913075318 59.48627808082892,9.958407091481556 59.53100421792007,10.046468798545067 59.53437548840777,10.05303803026932 59.48964336811876,9.965091913075318 59.48627808082892)))"
22200006605000,1735,875,860,43.6,"MULTIPOLYGON(((10.05303803026932 59.48964336811876,10.046468798545067 59.53437548840777,10.13455096159916 59.53768760557806,10.14100451463103 59.49294960591167,10.05303803026932 59.48964336811876)))"
22250006605000,722,400,322,39.6,"MULTIPOLYGON(((10.14100451463103 59.49294960591167,10.13455096159916 59.53768760557806,10.22265322496191 59.54094054200359,10.228991011994681 59.49619676689031,10.14100451463103 59.49294960591167)))"
22300006605000,3475,1783,1692,40.4,"MULTIPOLYGON(((10.228991011994681 59.49619676689031,10.22265322496191 59.54094054200359,10.31077523243889 59.54413427073583,10.316997167685718 59.499384824214346,10.228991011994681 59.49619676689031)))"
22350006605000,1004,508,496,43.9,"MULTIPOLYGON(((10.316997167685718 59.499384824214346,10.31077523243889 59.54413427073583,10.398916627331893 59.54726876530583,10.405022626529462 59.502513751521114,10.316997167685718 59.499384824214346)))"
22400006605000,160,88,72,42.8,"MULTIPOLYGON(((10.405022626529462 59.502513751521114,10.398916627331893 59.54726876530583,10.487077052447685 59.55034399972508,10.493067032859793 59.505583522926564,10.405022626529462 59.502513751521114)))"
22450006605000,1195,597,598,48.2,"MULTIPOLYGON(((10.493067032859793 59.505583522926564,10.487077052447685 59.55034399972508,10.575256150106796 59.553359948486325,10.581130030527886 59.50859411302597,10.493067032859793 59.505583522926564)))"
22500006605000,117,60,57,51.7,"MULTIPOLYGON(((10.581130030527886 59.50859411302597,10.575256150106796 59.553359948486325,10.66345356215234 59.55631658656429,10.669211262910965 59.51154549689466,10.581130030527886 59.50859411302597)))"
22550006605000,5220,2578,2642,42.4,"MULTIPOLYGON(((10.669211262910965 59.51154549689466,10.66345356215234 59.55631658656429,10.751668929958848 59.55921388941653,10.757310372921081 59.514437650088915,10.669211262910965 59.51154549689466)))"
22600006605000,410,227,183,42.6,"MULTIPOLYGON(((10.757310372921081 59.514437650088915,10.751668929958848 59.55921388941653,10.839901894441166 59.562051832984096,10.845427003013933 59.51727054864663,10.757310372921081 59.514437650088915)))"
22650006605000,623,318,305,40.7,"MULTIPOLYGON(((10.845427003013933 59.51727054864663,10.839901894441166 59.562051832984096,10.928152096063343 59.56483039369237,10.933560795197705 59.52004416908807,10.845427003013933 59.51727054864663)))"
22700006605000,58,29,29,37.6,"MULTIPOLYGON(((10.933560795197705 59.52004416908807,10.928152096063343 59.56483039369237,11.01641917484759 59.567549548451694,11.021711391041954 59.522758488416535,10.933560795197705 59.52004416908807)))"
22750006605000,275,155,120,43.9,"MULTIPOLYGON(((11.021711391041954 59.522758488416535,11.01641917484759 59.567549548451694,11.104702770383215 59.5702092746582,11.109878431686493 59.52541348411927,11.021711391041954 59.522758488416535)))"
22800006605000,1011,521,490,41.9,"MULTIPOLYGON(((11.109878431686493 59.52541348411927,11.104702770383215 59.5702092746582,11.19300252183564 59.57280955019441,11.19806155785032 59.52800913416788,11.109878431686493 59.52541348411927)))"
22850006605000,338,177,161,43.6,"MULTIPOLYGON(((11.19806155785032 59.52800913416788,11.19300252183564 59.57280955019441,11.281318067955409 59.57535035342996,11.286260409840585 59.53054541701925,11.19806155785032 59.52800913416788)))"
22900006605000,7451,3675,3776,43.4,"MULTIPOLYGON(((11.286260409840585 59.53054541701925,11.281318067955409 59.57535035342996,11.369649047087234 59.5778316632223,11.374474627561563 59.533022311615994,11.286260409840585 59.53054541701925)))"
22950006605000,509,271,238,42,"MULTIPOLYGON(((11.374474627561563 59.533022311615994,11.369649047087234 59.5778316632223,11.45799509717907 59.58025345891726,11.462703850523663 59.53543979738731,11.374474627561563 59.533022311615994)))"
23000006605000,382,204,178,45,"MULTIPOLYGON(((11.462703850523663 59.53543979738731,11.45799509717907 59.58025345891726,11.54635585579121 59.58261572034978,11.550947717852456 59.53779785424951,11.462703850523663 59.53543979738731)))"
23050006605000,242,131,111,43.8,"MULTIPOLYGON(((11.550947717852456 59.53779785424951,11.54635585579121 59.58261572034978,11.634730960105408 59.584918427844514,11.639205868297733 59.540096462606634,11.550947717852456 59.53779785424951)))"
23100006605000,28,14,14,50.5,"MULTIPOLYGON(((11.639205868297733 59.540096462606634,11.634730960105408 59.584918427844514,11.723120046934019 59.58716156221639,11.727477940242586 59.54233560335108,11.639205868297733 59.540096462606634)))"
19400006610000,7201,3649,3552,39.4,"MULTIPOLYGON(((5.156663388540236 59.25548907045986,5.143761104125716 59.29972820413154,5.230277310516311 59.30630857915248,5.243070778013639 59.262057944426424,5.156663388540236 59.25548907045986)))"
19450006610000,9060,4654,4406,39.6,"MULTIPOLYGON(((5.243070778013639 59.262057944426424,5.230277310516311 59.30630857915248,5.316832672697483 59.312831921527845,5.329517157489913 59.268569881046616,5.243070778013639 59.262057944426424)))"
19500006610000,166,93,73,46,"MULTIPOLYGON(((5.329517157489913 59.268569881046616,5.316832672697483 59.312831921527845,5.403426874235791 59.31929817895201,5.416002211770363 59.27502482821799,5.329517157489913 59.268569881046616)))"
19550006610000,978,499,479,38.8,"MULTIPOLYGON(((5.416002211770363 59.27502482821799,5.403426874235791 59.31929817895201,5.490059597761816 59.32570729953444,5.50252562472684 59.281422734251684,5.416002211770363 59.27502482821799)))"
19600006610000,106,56,50,40.8,"MULTIPOLYGON(((5.50252562472684 59.281422734251684,5.490059597761816 59.32570729953444,5.576730524976466 59.33205923180117,5.589087079308017 59.287763547874,5.50252562472684 59.281422734251684)))"
19650006610000,166,86,80,43.3,"MULTIPOLYGON(((5.589087079308017 59.287763547874,5.576730524976466 59.33205923180117,5.663439336657369 59.33835392469622,5.675686257545733 59.29404721822777,5.589087079308017 59.287763547874)))"
19700006610000,176,95,81,36.2,"MULTIPOLYGON(((5.675686257545733 59.29404721822777,5.663439336657369 59.33835392469622,5.750185712665292 59.34459132758324,5.762322840561383 59.30027369487391,5.675686257545733 59.29404721822777)))"
19750006610000,106,57,49,39.5,"MULTIPOLYGON(((5.762322840561383 59.30027369487391,5.750185712665292 59.34459132758324,5.836969331950633 59.35077139024678,5.848996508572362 59.306442927792844,5.762322840561383 59.30027369487391)))"
19800006610000,294,137,157,42.1,"MULTIPOLYGON(((5.848996508572362 59.306442927792844,5.836969331950633 59.35077139024678,5.923789872559951 59.35689406289391,5.935706940898562 59.31255486738596,5.848996508572362 59.306442927792844)))"
19850006610000,62,31,31,52.3,"MULTIPOLYGON(((5.935706940898562 59.31255486738596,5.923789872559951 59.35689406289391,6.010647011642566 59.3629592961556,6.02245381596892 59.31860946447704,5.935706940898562 59.31255486738596)))"
19900006610000,212,106,106,47.1,"MULTIPOLYGON(((6.02245381596892 59.31860946447704,6.010647011642566 59.3629592961556,6.097540425457185 59.36896704108818,6.109236811328025 59.324606670313734,6.02245381596892 59.31860946447704)))"
19950006610000,73,40,33,34.4,"MULTIPOLYGON(((6.109236811328025 59.324606670313734,6.097540425457185 59.36896704108818,6.18446978937863 59.37491724917469,6.19605560364278 59.33054643656891,6.109236811328025 59.324606670313734)))"
20000006610000,318,152,166,41.4,"MULTIPOLYGON(((6.19605560364278 59.33054643656891,6.18446978937863 59.37491724917469,6.271434777904549 59.38080987232646,6.28290986870909 59.3364287153421,6.19605560364278 59.33054643656891)))"
20050006610000,26,14,12,44.7,"MULTIPOLYGON(((6.28290986870909 59.3364287153421,6.271434777904549 59.38080987232646,6.358435064662246 59.38664486288434,6.36979928145864 59.34225345916093,6.28290986870909 59.3364287153421)))"
20100006610000,12,8,4,49.4,"MULTIPOLYGON(((6.36979928145864 59.34225345916093,6.358435064662246 59.38664486288434,6.445470322415523 59.392422173620226,6.456723515965686 59.3480206209824,6.36979928145864 59.34225345916093)))"
20150006610000,15,9,6,48.2,"MULTIPOLYGON(((6.456723515965686 59.3480206209824,6.445470322415523 59.392422173620226,6.532540223071577 59.3981417577384,6.543682245453938 59.35373015419445,6.456723515965686 59.3480206209824)))"
20650006610000,21,13,8,43.8,"MULTIPOLYGON(((7.327808754868768 59.402515189675334,7.317673709311943 59.447012811491554,7.405071810478414 59.452152651761686,7.415094279356166 59.40764596887056,7.327808754868768 59.402515189675334)))"
20700006610000,30,15,15,49.3,"MULTIPOLYGON(((7.415094279356166 59.40764596887056,7.405071810478414 59.452152651761686,7.492500891016625 59.457234279584085,7.502410650160995 59.412718635540415,7.415094279356166 59.40764596887056)))"
20900006610000,25,15,10,39.3,"MULTIPOLYGON(((7.764541472405993 59.42758754924997,7.75497062690626 59.47212947558351,7.842520239194879 59.476977843085436,7.8519778566523 59.43242735691397,7.764541472405993 59.42758754924997)))"
20950006610000,49,24,25,37.6,"MULTIPOLYGON(((7.8519778566523 59.43242735691397,7.842520239194879 59.476977843085436,7.930099134232558 59.48176779513103,7.939443397574282 59.437208849848076,7.8519778566523 59.43242735691397)))"
21000006610000,896,448,448,44.1,"MULTIPOLYGON(((7.939443397574282 59.437208849848076,7.930099134232558 59.48176779513103,8.017706970468963 59.486499292476445,8.026937755033693 59.441931988964214,7.939443397574282 59.437208849848076)))"
21050006610000,40,18,22,40.5,"MULTIPOLYGON(((8.026937755033693 59.441931988964214,8.017706970468963 59.486499292476445,8.10534340562987 59.49117229633326,8.114460588173545 59.44659673562798,8.026937755033693 59.441931988964214)))"
21100006610000,84,43,41,42.3,"MULTIPOLYGON(((8.114460588173545 59.44659673562798,8.10534340562987 59.49117229633326,8.193008096724967 59.495786768369655,8.202011555425909 59.45120305165986,8.114460588173545 59.44659673562798)))"
21150006610000,39,20,19,45.8,"MULTIPOLYGON(((8.202011555425909 59.45120305165986,8.193008096724967 59.495786768369655,8.280700700055709 59.50034267071153,8.28959031451969 59.455750899336316,8.202011555425909 59.45120305165986)))"
21200006610000,38,24,14,47.8,"MULTIPOLYGON(((8.28959031451969 59.455750899336316,8.280700700055709 59.50034267071153,8.368420871223242 59.504839965943695,8.377196522488497 59.460240241390984,8.28959031451969 59.455750899336316)))"
21250006610000,193,89,104,45.7,"MULTIPOLYGON(((8.377196522488497 59.460240241390984,8.368420871223242 59.504839965943695,8.456168265136336 59.50927861711091,8.464829835678533 59.4646710410157,8.377196522488497 59.460240241390984)))"
21300006610000,56,32,24,41.2,"MULTIPOLYGON(((8.464829835678533 59.4646710410157,8.456168265136336 59.50927861711091,8.543942536019372 59.513658587719114,8.55248990975653 59.46904326186172,8.464829835678533 59.4646710410157)))"
21350006610000,1408,678,730,43.2,"MULTIPOLYGON(((8.55248990975653 59.46904326186172,8.543942536019372 59.513658587719114,8.631743337420403 59.51797984173641,8.64017639971773 59.47335686804077,8.55248990975653 59.46904326186172)))"
21400006610000,293,141,152,49,"MULTIPOLYGON(((8.64017639971773 59.47335686804077,8.631743337420403 59.51797984173641,8.719570322219193 59.522242343594314,8.727888959893905 59.47761182412608,8.64017639971773 59.47335686804077)))"
21600006610000,1,1,0,0,"MULTIPOLYGON(((8.991179595247528 59.49002444449779,8.98320489594649 59.534676987498266,9.071133130053543 59.53870413433678,9.078992966614933 59.49404445520892,8.991179595247528 59.49002444449779)))"
21650006610000,53,30,23,41,"MULTIPOLYGON(((9.078992966614933 59.49404445520892,9.071133130053543 59.53870413433678,9.159085802218657 59.5426723581602,9.166830670187698 59.49800564565287,9.078992966614933 59.49404445520892)))"
21700006610000,61,37,24,38.4,"MULTIPOLYGON(((9.166830670187698 59.49800564565287,9.159085802218657 59.5426723581602,9.24706256148386 59.54658162620206,9.254692356487487 59.501907983194165,9.166830670187698 59.49800564565287)))"
21750006610000,530,274,256,46.5,"MULTIPOLYGON(((9.254692356487487 59.501907983194165,9.24706256148386 59.54658162620206,9.335063056280566 59.55043190616644,9.34257767542976 59.50575143566621,9.254692356487487 59.501907983194165)))"
21900006610000,11,6,5,40.8,"MULTIPOLYGON(((9.518417807922678 59.51326155908558,9.511133843191566 59.55795537503824,9.599203429191427 59.56162850171563,9.606371918348477 59.51692816805222,9.518417807922678 59.51326155908558)))"
21950006610000,99,56,43,39.2,"MULTIPOLYGON(((9.606371918348477 59.51692816805222,9.599203429191427 59.56162850171563,9.687295338510909 59.56524251585747,9.694348255183945 59.520535767990054,9.606371918348477 59.51692816805222)))"
22050006610000,270,138,132,41.2,"MULTIPOLYGON(((9.782346465439351 59.52408432909071,9.775409216655092 59.56879738753537,9.863544708569394 59.572293087297176,9.870366195569355 59.52757382202026,9.782346465439351 59.52408432909071)))"
22150006610000,2,1,1,0,"MULTIPOLYGON(((9.958407091481556 59.53100421792007,9.95170145864817 59.57572958616796,10.039879110743367 59.579106855650906,10.046468798545067 59.53437548840777,9.958407091481556 59.53100421792007)))"
22200006610000,753,376,377,40.3,"MULTIPOLYGON(((10.046468798545067 59.53437548840777,10.039879110743367 59.579106855650906,10.128077308173218 59.58242486772818,10.13455096159916 59.53768760557806,10.046468798545067 59.53437548840777)))"
22250006610000,675,327,348,51.1,"MULTIPOLYGON(((10.13455096159916 59.53768760557806,10.128077308173218 59.58242486772818,10.216295693730949 59.58568359486173,10.22265322496191 59.54094054200359,10.13455096159916 59.53768760557806)))"
22300006610000,4037,2037,2000,41.7,"MULTIPOLYGON(((10.22265322496191 59.54094054200359,10.216295693730949 59.58568359486173,10.304533909693536 59.588883009994184,10.31077523243889 59.54413427073583,10.22265322496191 59.54094054200359)))"
22350006610000,839,422,417,42.2,"MULTIPOLYGON(((10.31077523243889 59.54413427073583,10.304533909693536 59.588883009994184,10.392791597830493 59.59202308654973,10.398916627331893 59.54726876530583,10.31077523243889 59.54413427073583)))"
22400006610000,564,288,276,48.5,"MULTIPOLYGON(((10.398916627331893 59.54726876530583,10.392791597830493 59.59202308654973,10.481068399412688 59.59510379843483,10.487077052447685 59.55034399972508,10.398916627331893 59.54726876530583)))"
22450006610000,264,134,130,37,"MULTIPOLYGON(((10.487077052447685 59.55034399972508,10.481068399412688 59.59510379843483,10.569363955221185 59.59812512003912,10.575256150106796 59.553359948486325,10.487077052447685 59.55034399972508)))"
22500006610000,2014,1016,998,44.9,"MULTIPOLYGON(((10.575256150106796 59.553359948486325,10.569363955221185 59.59812512003912,10.657677905556133 59.60108702623614,10.66345356215234 59.55631658656429,10.575256150106796 59.553359948486325)))"
22550006610000,4060,2028,2032,36.7,"MULTIPOLYGON(((10.66345356215234 59.55631658656429,10.657677905556133 59.60108702623614,10.746009890245679 59.603989492384144,10.751668929958848 59.55921388941653,10.66345356215234 59.55631658656429)))"
22600006610000,3041,1494,1547,43.1,"MULTIPOLYGON(((10.751668929958848 59.55921388941653,10.746009890245679 59.603989492384144,10.834359548654895 59.60683249432683,10.839901894441166 59.562051832984096,10.751668929958848 59.55921388941653)))"
22650006610000,401,215,186,42.1,"MULTIPOLYGON(((10.839901894441166 59.562051832984096,10.834359548654895 59.60683249432683,10.92272651969477 59.60961600839415,10.928152096063343 59.56483039369237,10.839901894441166 59.562051832984096)))"
22700006610000,69,40,29,46.5,"MULTIPOLYGON(((10.928152096063343 59.56483039369237,10.92272651969477 59.60961600839415,11.011110441831196 59.61234001140295,11.01641917484759 59.567549548451694,10.928152096063343 59.56483039369237)))"
22750006610000,2100,1075,1025,37.8,"MULTIPOLYGON(((11.01641917484759 59.567549548451694,11.011110441831196 59.61234001140295,11.099510953093993 59.615004480657774,11.104702770383215 59.5702092746582,11.01641917484759 59.567549548451694)))"
22800006610000,14221,7081,7140,41.8,"MULTIPOLYGON(((11.104702770383215 59.5702092746582,11.099510953093993 59.615004480657774,11.187927691085982 59.61760939395151,11.19300252183564 59.57280955019441,11.104702770383215 59.5702092746582)))"
22850006610000,2070,1071,999,41.9,"MULTIPOLYGON(((11.19300252183564 59.57280955019441,11.187927691085982 59.61760939395151,11.276360292992052 59.62015472956613,11.281318067955409 59.57535035342996,11.19300252183564 59.57280955019441)))"
22900006610000,298,167,131,40.6,"MULTIPOLYGON(((11.281318067955409 59.57535035342996,11.276360292992052 59.62015472956613,11.364808395588286 59.622640466273324,11.369649047087234 59.5778316632223,11.281318067955409 59.57535035342996)))"
22950006610000,510,263,247,41.3,"MULTIPOLYGON(((11.369649047087234 59.5778316632223,11.364808395588286 59.622640466273324,11.453271635251088 59.625066583335155,11.45799509717907 59.58025345891726,11.369649047087234 59.5778316632223)))"
23000006610000,81,43,38,41,"MULTIPOLYGON(((11.45799509717907 59.58025345891726,11.453271635251088 59.625066583335155,11.541749647966347 59.62743306050473,11.54635585579121 59.58261572034978,11.45799509717907 59.58025345891726)))"
23050006610000,248,132,116,48.3,"MULTIPOLYGON(((11.54635585579121 59.58261572034978,11.541749647966347 59.62743306050473,11.630242069338632 59.62973987802683,11.634730960105408 59.584918427844514,11.54635585579121 59.58261572034978)))"
19250006615000,208,115,93,44.5,"MULTIPOLYGON(((4.884450569860756 59.27964541244562,4.871182429468618 59.32384734833406,4.95768790418018 59.33061031913087,4.97084741973253 59.286396567441656,4.884450569860756 59.27964541244562)))"
19400006615000,336,177,159,40.2,"MULTIPOLYGON(((5.143761104125716 59.29972820413154,5.130819348271356 59.3439653025184,5.21744468707136 59.350557208020525,5.230277310516311 59.30630857915248,5.143761104125716 59.29972820413154)))"
19450006615000,2556,1332,1224,40.9,"MULTIPOLYGON(((5.230277310516311 59.30630857915248,5.21744468707136 59.350557208020525,5.304109348391914 59.35709198535725,5.316832672697483 59.312831921527845,5.230277310516311 59.30630857915248)))"
19500006615000,2528,1265,1263,36.2,"MULTIPOLYGON(((5.316832672697483 59.312831921527845,5.304109348391914 59.35709198535725,5.390813014558558 59.3635695820187,5.403426874235791 59.31929817895201,5.316832672697483 59.312831921527845)))"
19550006615000,194,105,89,43.9,"MULTIPOLYGON(((5.403426874235791 59.31929817895201,5.390813014558558 59.3635695820187,5.477555366954276 59.36998994591155,5.490059597761816 59.32570729953444,5.403426874235791 59.31929817895201)))"
19600006615000,187,100,87,44.8,"MULTIPOLYGON(((5.490059597761816 59.32570729953444,5.477555366954276 59.36998994591155,5.564336086025849 59.37635302536045,5.576730524976466 59.33205923180117,5.490059597761816 59.32570729953444)))"
19650006615000,95,47,48,45.7,"MULTIPOLYGON(((5.576730524976466 59.33205923180117,5.564336086025849 59.37635302536045,5.651154851290245 59.38265876910963,5.663439336657369 59.33835392469622,5.576730524976466 59.33205923180117)))"
19700006615000,43,23,20,49,"MULTIPOLYGON(((5.663439336657369 59.33835392469622,5.651154851290245 59.38265876910963,5.738011341341138 59.388907126324305,5.750185712665292 59.34459132758324,5.663439336657369 59.33835392469622)))"
19750006615000,188,92,96,43.9,"MULTIPOLYGON(((5.750185712665292 59.34459132758324,5.738011341341138 59.388907126324305,5.824905233855376 59.395098046592175,5.836969331950633 59.35077139024678,5.750185712665292 59.34459132758324)))"
19800006615000,74,38,36,46.1,"MULTIPOLYGON(((5.836969331950633 59.35077139024678,5.824905233855376 59.395098046592175,5.911836205599611 59.40123147992492,5.923789872559951 59.35689406289391,5.836969331950633 59.35077139024678)))"
19850006615000,49,27,22,48.1,"MULTIPOLYGON(((5.923789872559951 59.35689406289391,5.911836205599611 59.40123147992492,5.998803932436878 59.40730737675961,6.010647011642566 59.3629592961556,5.923789872559951 59.35689406289391)))"
19900006615000,66,35,31,48.1,"MULTIPOLYGON(((6.010647011642566 59.3629592961556,5.998803932436878 59.40730737675961,6.085808089333327 59.413325687960224,6.097540425457185 59.36896704108818,6.010647011642566 59.3629592961556)))"
19950006615000,13,5,8,44,"MULTIPOLYGON(((6.097540425457185 59.36896704108818,6.085808089333327 59.413325687960224,6.172848350364939 59.419286364819015,6.18446978937863 59.37491724917469,6.097540425457185 59.36896704108818)))"
20000006615000,25,14,11,31.9,"MULTIPOLYGON(((6.18446978937863 59.37491724917469,6.172848350364939 59.419286364819015,6.259924388724311 59.42518935905799,6.271434777904549 59.38080987232646,6.18446978937863 59.37491724917469)))"
20050006615000,52,26,26,41.4,"MULTIPOLYGON(((6.271434777904549 59.38080987232646,6.259924388724311 59.42518935905799,6.347035876727508 59.43103462283029,6.358435064662246 59.38664486288434,6.271434777904549 59.38080987232646)))"
20150006615000,1,1,0,0,"MULTIPOLYGON(((6.445470322415523 59.392422173620226,6.434182485820967 59.43682210872162,6.521363886588426 59.442551769751674,6.532540223071577 59.3981417577384,6.445470322415523 59.392422173620226)))"
20650006615000,15,7,8,41.7,"MULTIPOLYGON(((7.317673709311943 59.447012811491554,7.307507347208519 59.491509065078326,7.39501836210062 59.49665799002259,7.405071810478414 59.452152651761686,7.317673709311943 59.447012811491554)))"
20700006615000,22,15,7,62.3,"MULTIPOLYGON(((7.405071810478414 59.452152651761686,7.39501836210062 59.49665799002259,7.482560490188614 59.50174860235097,7.492500891016625 59.457234279584085,7.405071810478414 59.452152651761686)))"
20900006615000,6,3,3,53.3,"MULTIPOLYGON(((7.75497062690626 59.47212947558351,7.745370157715579 59.516670149216694,7.833033338866451 59.52152709891784,7.842520239194879 59.476977843085436,7.75497062690626 59.47212947558351)))"
20950006615000,49,29,20,35.3,"MULTIPOLYGON(((7.842520239194879 59.476977843085436,7.833033338866451 59.52152709891784,7.92072592957144 59.5263255321859,7.930099134232558 59.48176779513103,7.842520239194879 59.476977843085436)))"
21000006615000,52,29,23,34.7,"MULTIPOLYGON(((7.930099134232558 59.48176779513103,7.92072592957144 59.5263255321859,8.008447586860383 59.531065409620446,8.017706970468963 59.486499292476445,7.930099134232558 59.48176779513103)))"
21100006615000,130,65,65,50.7,"MULTIPOLYGON(((8.10534340562987 59.49117229633326,8.09619796703397 59.535746692278195,8.183976725671654 59.5403693416742,8.193008096724967 59.495786768369655,8.10534340562987 59.49117229633326)))"
21150006615000,86,48,38,45.7,"MULTIPOLYGON(((8.193008096724967 59.495786768369655,8.183976725671654 59.5403693416742,8.271783517639545 59.54493331978294,8.280700700055709 59.50034267071153,8.193008096724967 59.495786768369655)))"
21200006615000,2,2,0,0,"MULTIPOLYGON(((8.280700700055709 59.50034267071153,8.271783517639545 59.54493331978294,8.359617997098363 59.54943858903955,8.368420871223242 59.504839965943695,8.280700700055709 59.50034267071153)))"
21350006615000,160,82,78,41.7,"MULTIPOLYGON(((8.543942536019372 59.513658587719114,8.535368631652846 59.55827285304689,8.623284091615286 59.56260177498115,8.631743337420403 59.51797984173641,8.543942536019372 59.513658587719114)))"
21400006615000,7,3,4,40.6,"MULTIPOLYGON(((8.631743337420403 59.51797984173641,8.623284091615286 59.56260177498115,8.711225848818433 59.56687184243259,8.719570322219193 59.522242343594314,8.631743337420403 59.51797984173641)))"
21600006615000,1,0,1,0,"MULTIPOLYGON(((8.98320489594649 59.534676987498266,8.975205408143822 59.579328567777786,9.063248855330922 59.58336286952624,9.071133130053543 59.53870413433678,8.98320489594649 59.534676987498266)))"
21650006615000,23,13,10,50.4,"MULTIPOLYGON(((9.071133130053543 59.53870413433678,9.063248855330922 59.58336286952624,9.15131684704776 59.58733814525015,9.159085802218657 59.5426723581602,9.071133130053543 59.53870413433678)))"
21700006615000,2084,1031,1053,45.6,"MULTIPOLYGON(((9.159085802218657 59.5426723581602,9.15131684704776 59.58733814525015,9.239409030848355 59.59125436205131,9.24706256148386 59.54658162620206,9.159085802218657 59.5426723581602)))"
21750006615000,7818,3867,3951,42.7,"MULTIPOLYGON(((9.24706256148386 59.54658162620206,9.239409030848355 59.59125436205131,9.32752505367169 59.59511148750387,9.335063056280566 59.55043190616644,9.24706256148386 59.54658162620206)))"
21850006615000,1,1,0,0,"MULTIPOLYGON(((9.423086934437992 59.554223166229086,9.415664561850157 59.598909489655455,9.503827201118037 59.60264833702803,9.511133843191566 59.55795537503824,9.423086934437992 59.554223166229086)))"
21950006615000,659,354,305,40,"MULTIPOLYGON(((9.599203429191427 59.56162850171563,9.59201261662004 59.606327998618916,9.680220452919883 59.609948443901764,9.687295338510909 59.56524251585747,9.599203429191427 59.56162850171563)))"
22000006615000,425,225,200,41.1,"MULTIPOLYGON(((9.687295338510909 59.56524251585747,9.680220452919883 59.609948443901764,9.768450354008872 59.61350964282743,9.775409216655092 59.56879738753537,9.687295338510909 59.56524251585747)))"
22050006615000,284,154,130,41.2,"MULTIPOLYGON(((9.775409216655092 59.56879738753537,9.768450354008872 59.61350964282743,9.856701963314558 59.617011565824946,9.863544708569394 59.572293087297176,9.775409216655092 59.56879738753537)))"
22150006615000,195,105,90,41.2,"MULTIPOLYGON(((9.95170145864817 59.57572958616796,9.944974923709408 59.62045418380247,10.033268877519513 59.62383746814806,10.039879110743367 59.579106855650906,9.95170145864817 59.57572958616796)))"
22200006615000,257,135,122,41.8,"MULTIPOLYGON(((10.039879110743367 59.579106855650906,10.033268877519513 59.62383746814806,10.121583466533354 59.62716139073062,10.128077308173218 59.58242486772818,10.039879110743367 59.579106855650906)))"
22250006615000,1694,822,872,44.5,"MULTIPOLYGON(((10.128077308173218 59.58242486772818,10.121583466533354 59.62716139073062,10.209918332010549 59.630425923900866,10.216295693730949 59.58568359486173,10.128077308173218 59.58242486772818)))"
22300006615000,1366,706,660,37.1,"MULTIPOLYGON(((10.216295693730949 59.58568359486173,10.209918332010549 59.630425923900866,10.298273114690701 59.63363104049201,10.304533909693536 59.588883009994184,10.216295693730949 59.58568359486173)))"
22350006615000,94,51,43,40,"MULTIPOLYGON(((10.304533909693536 59.588883009994184,10.298273114690701 59.63363104049201,10.386647454802226 59.63677671382068,10.392791597830493 59.59202308654973,10.304533909693536 59.588883009994184)))"
22400006615000,5396,2689,2707,43.5,"MULTIPOLYGON(((10.392791597830493 59.59202308654973,10.386647454802226 59.63677671382068,10.47504099207123 59.63986291768779,10.481068399412688 59.59510379843483,10.392791597830493 59.59202308654973)))"
22450006615000,91,49,42,42.9,"MULTIPOLYGON(((10.481068399412688 59.59510379843483,10.47504099207123 59.63986291768779,10.563453365730448 59.642889626379244,10.569363955221185 59.59812512003912,10.481068399412688 59.59510379843483)))"
22500006615000,277,140,137,48.7,"MULTIPOLYGON(((10.569363955221185 59.59812512003912,10.563453365730448 59.642889626379244,10.65188421452815 59.64585681466685,10.657677905556133 59.60108702623614,10.569363955221185 59.59812512003912)))"
22550006615000,1399,732,667,39.5,"MULTIPOLYGON(((10.657677905556133 59.60108702623614,10.65188421452815 59.64585681466685,10.740333176737149 59.648764457808966,10.746009890245679 59.603989492384144,10.657677905556133 59.60108702623614)))"
22600006615000,3103,1600,1503,38.3,"MULTIPOLYGON(((10.746009890245679 59.603989492384144,10.740333176737149 59.648764457808966,10.828799890163781 59.651612531551464,10.834359548654895 59.60683249432683,10.746009890245679 59.603989492384144)))"
22650006615000,782,430,352,40,"MULTIPOLYGON(((10.834359548654895 59.60683249432683,10.828799890163781 59.651612531551464,10.91728399215697 59.65440101212823,10.92272651969477 59.60961600839415,10.834359548654895 59.60683249432683)))"
22700006615000,1011,552,459,35.9,"MULTIPOLYGON(((10.92272651969477 59.60961600839415,10.91728399215697 59.65440101212823,11.005785119617256 59.657129876262154,11.011110441831196 59.61234001140295,10.92272651969477 59.60961600839415)))"
22750006615000,5038,2463,2575,42,"MULTIPOLYGON(((11.011110441831196 59.61234001140295,11.005785119617256 59.657129876262154,11.094302909005926 59.65979910116563,11.099510953093993 59.615004480657774,11.011110441831196 59.61234001140295)))"
22800006615000,495,259,236,39.6,"MULTIPOLYGON(((11.099510953093993 59.615004480657774,11.094302909005926 59.65979910116563,11.182836996354101 59.662408664541466,11.187927691085982 59.61760939395151,11.099510953093993 59.615004480657774)))"
22850006615000,362,183,179,41.8,"MULTIPOLYGON(((11.187927691085982 59.61760939395151,11.182836996354101 59.662408664541466,11.271387017271916 59.66495854458339,11.276360292992052 59.62015472956613,11.187927691085982 59.61760939395151)))"
22900006615000,2491,1218,1273,43.3,"MULTIPOLYGON(((11.276360292992052 59.62015472956613,11.271387017271916 59.66495854458339,11.359952606957684 59.66744871997688,11.364808395588286 59.622640466273324,11.276360292992052 59.62015472956613)))"
22950006615000,262,138,124,41.5,"MULTIPOLYGON(((11.364808395588286 59.622640466273324,11.359952606957684 59.66744871997688,11.448533400207088 59.66987916989978,11.453271635251088 59.625066583335155,11.364808395588286 59.622640466273324)))"
23000006615000,172,91,81,43.4,"MULTIPOLYGON(((11.453271635251088 59.625066583335155,11.448533400207088 59.66987916989978,11.537129031422436 59.6722498740229,11.541749647966347 59.62743306050473,11.453271635251088 59.625066583335155)))"
23050006615000,79,44,35,51,"MULTIPOLYGON(((11.541749647966347 59.62743306050473,11.537129031422436 59.6722498740229,11.625739134621892 59.67456081251069,11.630242069338632 59.62973987802683,11.541749647966347 59.62743306050473)))"
23200006615000,21,12,9,55.5,"MULTIPOLYGON(((11.807268678621224 59.63417445756969,11.803001291180838 59.67900331571002,11.891652610739632 59.681134843224164,11.89580213591708 59.63630218254379,11.807268678621224 59.63417445756969)))"
19400006620000,47,22,25,49.2,"MULTIPOLYGON(((5.130819348271356 59.3439653025184,5.117837953011682 59.38820035834659,5.20457274094772 59.394803823881944,5.21744468707136 59.350557208020525,5.130819348271356 59.3439653025184)))"
19450006620000,5251,2668,2583,42.1,"MULTIPOLYGON(((5.21744468707136 59.350557208020525,5.20457274094772 59.394803823881944,5.291347019083156 59.40135006551065,5.304109348391914 59.35709198535725,5.21744468707136 59.350557208020525)))"
19500006620000,13312,6623,6689,39.7,"MULTIPOLYGON(((5.304109348391914 59.35709198535725,5.291347019083156 59.40135006551065,5.378160468496213 59.407839030517486,5.390813014558558 59.3635695820187,5.304109348391914 59.35709198535725)))"
19550006620000,475,256,219,39.4,"MULTIPOLYGON(((5.390813014558558 59.3635695820187,5.378160468496213 59.407839030517486,5.465012769315925 59.414270666605184,5.477555366954276 59.36998994591155,5.390813014558558 59.3635695820187)))"
19600006620000,602,302,300,35.8,"MULTIPOLYGON(((5.477555366954276 59.36998994591155,5.465012769315925 59.414270666605184,5.55190360072851 59.420644921896034,5.564336086025849 59.37635302536045,5.477555366954276 59.36998994591155)))"
19650006620000,339,186,153,38.7,"MULTIPOLYGON(((5.564336086025849 59.37635302536045,5.55190360072851 59.420644921896034,5.638832640983833 59.42696174493326,5.651154851290245 59.38265876910963,5.564336086025849 59.37635302536045)))"
19700006620000,89,47,42,40,"MULTIPOLYGON(((5.651154851290245 59.38265876910963,5.638832640983833 59.42696174493326,5.72579956740193 59.43322108468264,5.738011341341138 59.388907126324305,5.651154851290245 59.38265876910963)))"
19750006620000,18,9,9,32.9,"MULTIPOLYGON(((5.738011341341138 59.388907126324305,5.72579956740193 59.43322108468264,5.812804056379539 59.43942289053395,5.824905233855376 59.395098046592175,5.738011341341138 59.388907126324305)))"
19850006620000,27,15,12,46.3,"MULTIPOLYGON(((5.911836205599611 59.40123147992492,5.899845783396748 59.44556711230238,5.986924423023646 59.45165370023013,5.998803932436878 59.40730737675961,5.911836205599611 59.40123147992492)))"
19900006620000,150,81,69,40.4,"MULTIPOLYGON(((5.998803932436878 59.40730737675961,5.986924423023646 59.45165370023013,6.07403964892708 59.45768260498772,6.085808089333327 59.413325687960224,5.998803932436878 59.40730737675961)))"
19950006620000,18,11,7,38,"MULTIPOLYGON(((6.085808089333327 59.413325687960224,6.07403964892708 59.45768260498772,6.1611911338774 59.46365377767555,6.172848350364939 59.419286364819015,6.085808089333327 59.413325687960224)))"
20000006620000,12,6,6,33.1,"MULTIPOLYGON(((6.172848350364939 59.419286364819015,6.1611911338774 59.46365377767555,6.2483785497553 59.469567169825346,6.259924388724311 59.42518935905799,6.172848350364939 59.419286364819015)))"
20050006620000,42,22,20,36.8,"MULTIPOLYGON(((6.259924388724311 59.42518935905799,6.2483785497553 59.469567169825346,6.335601567558725 59.475422733401466,6.347035876727508 59.43103462283029,6.259924388724311 59.42518935905799)))"
20100006620000,87,43,44,49.8,"MULTIPOLYGON(((6.347035876727508 59.43103462283029,6.335601567558725 59.475422733401466,6.422859857409789 59.481220420802416,6.434182485820967 59.43682210872162,6.347035876727508 59.43103462283029)))"
20150006620000,128,66,62,41.6,"MULTIPOLYGON(((6.434182485820967 59.43682210872162,6.422859857409789 59.481220420802416,6.510153088561778 59.48696018486226,6.521363886588426 59.442551769751674,6.434182485820967 59.43682210872162)))"
20200006620000,18,9,9,39.8,"MULTIPOLYGON(((6.521363886588426 59.442551769751674,6.510153088561778 59.48696018486226,6.597480929406194 59.492641978851985,6.608579748757946 59.448223559375414,6.521363886588426 59.442551769751674)))"
20250006620000,13,6,7,41.6,"MULTIPOLYGON(((6.608579748757946 59.448223559375414,6.597480929406194 59.492641978851985,6.684843047479834 59.49826575648086,6.695829741208939 59.45383743148456,6.608579748757946 59.448223559375414)))"
20650006620000,2,1,1,0,"MULTIPOLYGON(((7.307507347208519 59.491509065078326,7.297309533345991 59.536003946031116,7.384933800397699 59.54116197935144,7.39501836210062 59.49665799002259,7.307507347208519 59.491509065078326)))"
20700006620000,2,1,1,0,"MULTIPOLYGON(((7.39501836210062 59.49665799002259,7.384933800397699 59.54116197935144,7.472589315244844 59.546261599640886,7.482560490188614 59.50174860235097,7.39501836210062 59.49665799002259)))"
20900006620000,56,32,24,53.1,"MULTIPOLYGON(((7.745370157715579 59.516670149216694,7.735739936613424 59.56120956624836,7.823517028861073 59.56607512060755,7.833033338866451 59.52152709891784,7.745370157715579 59.516670149216694)))"
21000006620000,491,230,261,46.4,"MULTIPOLYGON(((7.92072592957144 59.5263255321859,7.91132365820486 59.570882057305646,7.99915948024694 59.575630336784755,8.008447586860383 59.531065409620446,7.92072592957144 59.5263255321859)))"
21050006620000,122,60,62,40.9,"MULTIPOLYGON(((8.008447586860383 59.531065409620446,7.99915948024694 59.575630336784755,8.08702414985508 59.58031991994587,8.09619796703397 59.535746692278195,8.008447586860383 59.531065409620446)))"
21100006620000,71,41,30,36.5,"MULTIPOLYGON(((8.09619796703397 59.535746692278195,8.08702414985508 59.58031991994587,8.174917321170577 59.58495076815004,8.183976725671654 59.5403693416742,8.09619796703397 59.535746692278195)))"
21150006620000,121,55,66,40.1,"MULTIPOLYGON(((8.183976725671654 59.5403693416742,8.174917321170577 59.58495076815004,8.262838647616217 59.58952284321953,8.271783517639545 59.54493331978294,8.183976725671654 59.5403693416742)))"
21250006620000,51,25,26,50.3,"MULTIPOLYGON(((8.359617997098363 59.54943858903955,8.350787781904318 59.594036107438974,8.438764376044755 59.598490523556514,8.44747981751146 59.553885112340964,8.359617997098363 59.54943858903955)))"
21300006620000,36,15,21,41.2,"MULTIPOLYGON(((8.44747981751146 59.553885112340964,8.438764376044755 59.598490523556514,8.526768081353074 59.602886054785024,8.535368631652846 59.55827285304689,8.44747981751146 59.553885112340964)))"
21350006620000,369,199,170,39.5,"MULTIPOLYGON(((8.535368631652846 59.55827285304689,8.526768081353074 59.602886054785024,8.614798548458639 59.60722266480307,8.623284091615286 59.56260177498115,8.535368631652846 59.55827285304689)))"
21400006620000,334,165,169,41.4,"MULTIPOLYGON(((8.623284091615286 59.56260177498115,8.614798548458639 59.60722266480307,8.702855427312805 59.61150031775614,8.711225848818433 59.56687184243259,8.623284091615286 59.56260177498115)))"
21450006620000,77,43,34,44.6,"MULTIPOLYGON(((8.711225848818433 59.56687184243259,8.702855427312805 59.61150031775614,8.79093836719716 59.6157189782577,8.799193554016997 59.571083020156244,8.711225848818433 59.56687184243259)))"
21500006620000,18,8,10,45.3,"MULTIPOLYGON(((8.799193554016997 59.571083020156244,8.79093836719716 59.6157189782577,8.879047016731796 59.61987861139026,8.887186857308956 59.57523527337446,8.799193554016997 59.571083020156244)))"
21550006620000,402,194,208,45.4,"MULTIPOLYGON(((8.887186857308956 59.57523527337446,8.879047016731796 59.61987861139026,8.967181023883608 59.62397918270646,8.975205408143822 59.579328567777786,8.887186857308956 59.57523527337446)))"
21600006620000,285,154,131,46.6,"MULTIPOLYGON(((8.975205408143822 59.579328567777786,8.967181023883608 59.62397918270646,9.05534003597466 59.628020658230064,9.063248855330922 59.58336286952624,8.975205408143822 59.579328567777786)))"
21650006620000,790,398,392,43.1,"MULTIPOLYGON(((9.063248855330922 59.58336286952624,9.05534003597466 59.628020658230064,9.143523699690588 59.63200300445714,9.15131684704776 59.58733814525015,9.063248855330922 59.58336286952624)))"
21700006620000,256,128,128,39.6,"MULTIPOLYGON(((9.15131684704776 59.58733814525015,9.143523699690588 59.63200300445714,9.231731661089004 59.635926188356905,9.239409030848355 59.59125436205131,9.15131684704776 59.58733814525015)))"
21750006620000,325,155,170,40.5,"MULTIPOLYGON(((9.239409030848355 59.59125436205131,9.231731661089004 59.635926188356905,9.319963565607999 59.639790177372895,9.32752505367169 59.59511148750387,9.239409030848355 59.59125436205131)))"
21850006620000,54,29,25,43.7,"MULTIPOLYGON(((9.415664561850157 59.598909489655455,9.408219058074645 59.64359493942386,9.49649778271354 59.64734044290482,9.503827201118037 59.60264833702803,9.415664561850157 59.598909489655455)))"
21900006620000,12,7,5,45.3,"MULTIPOLYGON(((9.503827201118037 59.60264833702803,9.49649778271354 59.64734044290482,9.584799383155419 59.65102665668796,9.59201261662004 59.606327998618916,9.503827201118037 59.60264833702803)))"
21950006620000,6974,3539,3435,38.9,"MULTIPOLYGON(((9.59201261662004 59.606327998618916,9.584799383155419 59.65102665668796,9.673123502445755 59.65465355012368,9.680220452919883 59.609948443901764,9.59201261662004 59.606327998618916)))"
22000006620000,684,357,327,42.7,"MULTIPOLYGON(((9.680220452919883 59.609948443901764,9.673123502445755 59.65465355012368,9.76146978305344 59.65822109304143,9.768450354008872 59.61350964282743,9.680220452919883 59.609948443901764)))"
22050006620000,25,14,11,47.2,"MULTIPOLYGON(((9.768450354008872 59.61350964282743,9.76146978305344 59.65822109304143,9.849837866879493 59.6617292557508,9.856701963314558 59.617011565824946,9.768450354008872 59.61350964282743)))"
22100006620000,28,14,14,43,"MULTIPOLYGON(((9.856701963314558 59.617011565824946,9.849837866879493 59.6617292557508,9.938227395265779 59.66517800904222,9.944974923709408 59.62045418380247,9.856701963314558 59.617011565824946)))"
22150006620000,82,44,38,45.2,"MULTIPOLYGON(((9.944974923709408 59.62045418380247,9.938227395265779 59.66517800904222,10.026638009003785 59.668567324188096,10.033268877519513 59.62383746814806,9.944974923709408 59.62045418380247)))"
22250006620000,132,77,55,41.4,"MULTIPOLYGON(((10.121583466533354 59.62716139073062,10.115069348343454 59.67189717294349,10.203521053001994 59.67516752754712,10.209918332010549 59.630425923900866,10.121583466533354 59.62716139073062)))"
22300006620000,2455,1276,1179,37.2,"MULTIPOLYGON(((10.209918332010549 59.630425923900866,10.203521053001994 59.67516752754712,10.291992762172779 59.678378360722206,10.298273114690701 59.63363104049201,10.209918332010549 59.630425923900866)))"
22350006620000,313,159,154,44.4,"MULTIPOLYGON(((10.298273114690701 59.63363104049201,10.291992762172779 59.678378360722206,10.380484114534237 59.68152964567726,10.386647454802226 59.63677671382068,10.298273114690701 59.63363104049201)))"
22400006620000,104,56,48,46.1,"MULTIPOLYGON(((10.386647454802226 59.63677671382068,10.380484114534237 59.68152964567726,10.468994748258826 59.68462135610698,10.47504099207123 59.63986291768779,10.386647454802226 59.63677671382068)))"
22450006620000,3708,1826,1882,43.5,"MULTIPOLYGON(((10.47504099207123 59.63986291768779,10.468994748258826 59.68462135610698,10.55752430102198 59.687653466193034,10.563453365730448 59.642889626379244,10.47504099207123 59.63986291768779)))"
22500006620000,8311,4024,4287,45.6,"MULTIPOLYGON(((10.563453365730448 59.642889626379244,10.55752430102198 59.687653466193034,10.64607241001113 59.69062595060484,10.65188421452815 59.64585681466685,10.563453365730448 59.642889626379244)))"
22550006620000,6654,3333,3321,41.2,"MULTIPOLYGON(((10.65188421452815 59.64585681466685,10.64607241001113 59.69062595060484,10.734638711934743 59.6935387845004,10.740333176737149 59.648764457808966,10.65188421452815 59.64585681466685)))"
22600006620000,10468,5120,5348,38.2,"MULTIPOLYGON(((10.740333176737149 59.648764457808966,10.734638711934743 59.6935387845004,10.823222843031392 59.69639194352708,10.828799890163781 59.651612531551464,10.740333176737149 59.648764457808966)))"
22650006620000,1821,965,856,36.7,"MULTIPOLYGON(((10.828799890163781 59.651612531551464,10.823222843031392 59.69639194352708,10.911824439078854 59.69918540382228,10.91728399215697 59.65440101212823,10.828799890163781 59.651612531551464)))"
22700006620000,2254,1135,1119,38.7,"MULTIPOLYGON(((10.91728399215697 59.65440101212823,10.911824439078854 59.69918540382228,11.000443135403247 59.70191914201427,11.005785119617256 59.657129876262154,10.91728399215697 59.65440101212823)))"
22750006620000,635,335,300,43.6,"MULTIPOLYGON(((11.005785119617256 59.657129876262154,11.000443135403247 59.70191914201427,11.08907856688818 59.70459313522289,11.094302909005926 59.65979910116563,11.005785119617256 59.657129876262154)))"
22800006620000,173,94,79,43.6,"MULTIPOLYGON(((11.094302909005926 59.65979910116563,11.08907856688818 59.70459313522289,11.177730367983944 59.707207361060256,11.182836996354101 59.662408664541466,11.094302909005926 59.65979910116563)))"
22850006620000,198,114,84,43.4,"MULTIPOLYGON(((11.182836996354101 59.662408664541466,11.177730367983944 59.707207361060256,11.266398172716729 59.709761797631444,11.271387017271916 59.66495854458339,11.182836996354101 59.662408664541466)))"
22900006620000,1213,640,573,41.5,"MULTIPOLYGON(((11.271387017271916 59.66495854458339,11.266398172716729 59.709761797631444,11.355081614697871 59.71225642353524,11.359952606957684 59.66744871997688,11.271387017271916 59.66495854458339)))"
22950006620000,187,99,88,44.7,"MULTIPOLYGON(((11.359952606957684 59.66744871997688,11.355081614697871 59.71225642353524,11.443780327133126 59.71469121786469,11.448533400207088 59.66987916989978,11.359952606957684 59.66744871997688)))"
23000006620000,271,138,133,43.7,"MULTIPOLYGON(((11.448533400207088 59.66987916989978,11.443780327133126 59.71469121786469,11.532493942831938 59.717066160207885,11.537129031422436 59.6722498740229,11.448533400207088 59.66987916989978)))"
23050006620000,123,59,64,47.1,"MULTIPOLYGON(((11.537129031422436 59.6722498740229,11.532493942831938 59.717066160207885,11.621222094216805 59.7193812306485,11.625739134621892 59.67456081251069,11.537129031422436 59.6722498740229)))"
23100006620000,1,1,0,0,"MULTIPOLYGON(((11.625739134621892 59.67456081251069,11.621222094216805 59.7193812306485,11.709964413332587 59.72163640976646,11.714363343448772 59.67681196602186,11.625739134621892 59.67456081251069)))"
23150006620000,76,36,40,44.8,"MULTIPOLYGON(((11.714363343448772 59.67681196602186,11.709964413332587 59.72163640976646,11.798720531855912 59.72383167863859,11.803001291180838 59.67900331571002,11.714363343448772 59.67681196602186)))"
23200006620000,48,26,22,44.9,"MULTIPOLYGON(((11.803001291180838 59.67900331571002,11.798720531855912 59.72383167863859,11.887490081104536 59.72596701883911,11.891652610739632 59.681134843224164,11.803001291180838 59.67900331571002)))"
19450006625000,18751,9748,9003,41.2,"MULTIPOLYGON(((5.20457274094772 59.394803823881944,5.191661304465419 59.43904841954644,5.278545518338568 59.44560615492288,5.291347019083156 59.40135006551065,5.20457274094772 59.394803823881944)))"
19500006625000,11241,5628,5613,40,"MULTIPOLYGON(((5.291347019083156 59.40135006551065,5.278545518338568 59.44560615492288,5.365469070870082 59.45210651750748,5.378160468496213 59.407839030517486,5.291347019083156 59.40135006551065)))"
19550006625000,5042,2512,2530,38.5,"MULTIPOLYGON(((5.378160468496213 59.407839030517486,5.365469070870082 59.45210651750748,5.452431640928641 59.45854945479796,5.465012769315925 59.414270666605184,5.378160468496213 59.407839030517486)))"
19600006625000,1178,584,594,34.4,"MULTIPOLYGON(((5.465012769315925 59.414270666605184,5.452431640928641 59.45854945479796,5.539432906433454 59.4649349147131,5.55190360072851 59.420644921896034,5.465012769315925 59.414270666605184)))"
19650006625000,477,249,228,40.1,"MULTIPOLYGON(((5.55190360072851 59.420644921896034,5.539432906433454 59.4649349147131,5.626472544360772 59.47126284559408,5.638832640983833 59.42696174493326,5.55190360072851 59.420644921896034)))"
19700006625000,25,13,12,29.4,"MULTIPOLYGON(((5.638832640983833 59.42696174493326,5.626472544360772 59.47126284559408,5.713550230750424 59.477533196206146,5.72579956740193 59.43322108468264,5.638832640983833 59.42696174493326)))"
19750006625000,266,142,124,44.3,"MULTIPOLYGON(((5.72579956740193 59.43322108468264,5.713550230750424 59.477533196206146,5.800665640712424 59.48374591574002,5.812804056379539 59.43942289053395,5.72579956740193 59.43322108468264)))"
19800006625000,2,2,0,0,"MULTIPOLYGON(((5.812804056379539 59.43942289053395,5.800665640712424 59.48374591574002,5.887818448433636 59.48990095381342,5.899845783396748 59.44556711230238,5.812804056379539 59.43942289053395)))"
19850006625000,167,76,91,33.7,"MULTIPOLYGON(((5.899845783396748 59.44556711230238,5.887818448433636 59.48990095381342,5.975008327184468 59.49599826047252,5.986924423023646 59.45165370023013,5.899845783396748 59.44556711230238)))"
19900006625000,142,72,70,44.4,"MULTIPOLYGON(((5.986924423023646 59.45165370023013,5.975008327184468 59.49599826047252,6.062234949325678 59.5020377861934,6.07403964892708 59.45768260498772,5.986924423023646 59.45165370023013)))"
19950006625000,68,35,33,45.6,"MULTIPOLYGON(((6.07403964892708 59.45768260498772,6.062234949325678 59.5020377861934,6.149497986315149 59.508019481883565,6.1611911338774 59.46365377767555,6.07403964892708 59.45768260498772)))"
20000006625000,9,4,5,55.9,"MULTIPOLYGON(((6.1611911338774 59.46365377767555,6.149497986315149 59.508019481883565,6.236797108714796 59.513943298883355,6.2483785497553 59.469567169825346,6.1611911338774 59.46365377767555)))"
20050006625000,1318,652,666,41,"MULTIPOLYGON(((6.2483785497553 59.469567169825346,6.236797108714796 59.513943298883355,6.324131986197498 59.519809188967386,6.335601567558725 59.475422733401466,6.2483785497553 59.469567169825346)))"
20100006625000,9,4,5,43.7,"MULTIPOLYGON(((6.335601567558725 59.475422733401466,6.324131986197498 59.519809188967386,6.411502287554057 59.52561710434592,6.422859857409789 59.481220420802416,6.335601567558725 59.475422733401466)))"
20150006625000,381,185,196,42.1,"MULTIPOLYGON(((6.422859857409789 59.481220420802416,6.411502287554057 59.52561710434592,6.49890768070026 59.53136699766639,6.510153088561778 59.48696018486226,6.422859857409789 59.481220420802416)))"
20200006625000,196,92,104,44.4,"MULTIPOLYGON(((6.510153088561778 59.48696018486226,6.49890768070026 59.53136699766639,6.58634783268395 59.537058822014735,6.597480929406194 59.492641978851985,6.510153088561778 59.48696018486226)))"
20250006625000,70,33,37,34.4,"MULTIPOLYGON(((6.597480929406194 59.492641978851985,6.58634783268395 59.537058822014735,6.67382240969218 59.542692530916796,6.684843047479834 59.49826575648086,6.597480929406194 59.492641978851985)))"
20600006625000,6,2,4,50.8,"MULTIPOLYGON(((7.209716853917434 59.530787541965466,7.199373997094826 59.57527181317804,7.287080131728879 59.58049744991905,7.297309533345991 59.536003946031116,7.209716853917434 59.530787541965466)))"
20650006625000,544,298,246,39.1,"MULTIPOLYGON(((7.297309533345991 59.536003946031116,7.287080131728879 59.58049744991905,7.374817990769174 59.585664615420576,7.384933800397699 59.54116197935144,7.297309533345991 59.536003946031116)))"
20700006625000,3,2,1,0,"MULTIPOLYGON(((7.384933800397699 59.54116197935144,7.374817990769174 59.585664615420576,7.46258723298542 59.59077326722842,7.472589315244844 59.546261599640886,7.384933800397699 59.54116197935144)))"
20900006625000,44,22,22,42.6,"MULTIPOLYGON(((7.735739936613424 59.56120956624836,7.726079834634532 59.60574772275367,7.813971181635842 59.61062190432795,7.823517028861073 59.56607512060755,7.735739936613424 59.56120956624836)))"
20950006625000,39,20,19,46.2,"MULTIPOLYGON(((7.823517028861073 59.56607512060755,7.813971181635842 59.61062190432795,7.901892194017584 59.61543736676082,7.91132365820486 59.570882057305646,7.823517028861073 59.56607512060755)))"
21000006625000,348,180,168,40.6,"MULTIPOLYGON(((7.91132365820486 59.570882057305646,7.901892194017584 59.61543736676082,7.989842525946367 59.62019407033604,7.99915948024694 59.575630336784755,7.91132365820486 59.570882057305646)))"
21050006625000,83,41,42,39.8,"MULTIPOLYGON(((7.99915948024694 59.575630336784755,7.989842525946367 59.62019407033604,8.077821830849086 59.62489197579803,8.08702414985508 59.58031991994587,7.99915948024694 59.575630336784755)))"
21100006625000,35,22,13,41.2,"MULTIPOLYGON(((8.08702414985508 59.58031991994587,8.077821830849086 59.62489197579803,8.165829761420929 59.62953104435296,8.174917321170577 59.58495076815004,8.08702414985508 59.58031991994587)))"
21150006625000,91,45,46,39.1,"MULTIPOLYGON(((8.174917321170577 59.58495076815004,8.165829761420929 59.62953104435296,8.253865969633358 59.63411123767002,8.262838647616217 59.58952284321953,8.174917321170577 59.58495076815004)))"
21200006625000,12,6,6,45.8,"MULTIPOLYGON(((8.262838647616217 59.58952284321953,8.253865969633358 59.63411123767002,8.341930106742213 59.63863251788252,8.350787781904318 59.594036107438974,8.262838647616217 59.58952284321953)))"
21250006625000,88,48,40,45.2,"MULTIPOLYGON(((8.350787781904318 59.594036107438974,8.341930106742213 59.63863251788252,8.430021823295803 59.64309484758907,8.438764376044755 59.598490523556514,8.350787781904318 59.594036107438974)))"
21300006625000,36,19,17,50.9,"MULTIPOLYGON(((8.438764376044755 59.598490523556514,8.430021823295803 59.64309484758907,8.518140769143061 59.64749818985472,8.526768081353074 59.602886054785024,8.438764376044755 59.598490523556514)))"
21350006625000,12,5,7,57.2,"MULTIPOLYGON(((8.526768081353074 59.602886054785024,8.518140769143061 59.64749818985472,8.606286593441759 59.65184250821213,8.614798548458639 59.60722266480307,8.526768081353074 59.602886054785024)))"
21400006625000,68,35,33,46.3,"MULTIPOLYGON(((8.614798548458639 59.60722266480307,8.606286593441759 59.65184250821213,8.694458944666733 59.65612776666252,8.702855427312805 59.61150031775614,8.614798548458639 59.60722266480307)))"
21450006625000,1,1,0,0,"MULTIPOLYGON(((8.702855427312805 59.61150031775614,8.694458944666733 59.65612776666252,8.78265747061818 59.660353929677036,8.79093836719716 59.6157189782577,8.702855427312805 59.61150031775614)))"
21500006625000,83,47,36,47,"MULTIPOLYGON(((8.79093836719716 59.6157189782577,8.78265747061818 59.660353929677036,8.87088181842998 59.664520962197585,8.879047016731796 59.61987861139026,8.79093836719716 59.6157189782577)))"
21550006625000,150,75,75,39.5,"MULTIPOLYGON(((8.879047016731796 59.61987861139026,8.87088181842998 59.664520962197585,8.959131634578076 59.668628829638045,8.967181023883608 59.62397918270646,8.879047016731796 59.61987861139026)))"
21600006625000,27,14,13,43.2,"MULTIPOLYGON(((8.967181023883608 59.62397918270646,8.959131634578076 59.668628829638045,9.047406564888865 59.672677497885296,9.05534003597466 59.628020658230064,8.967181023883608 59.62397918270646)))"
21700006625000,77,38,39,47.2,"MULTIPOLYGON(((9.143523699690588 59.63200300445714,9.135706254547673 59.67666693330029,9.22403034810724 59.68059710271898,9.231731661089004 59.635926188356905,9.143523699690588 59.63200300445714)))"
21750006625000,4,2,2,0,"MULTIPOLYGON(((9.231731661089004 59.635926188356905,9.22403034810724 59.68059710271898,9.312378489496249 59.6844679734535,9.319963565607999 59.639790177372895,9.231731661089004 59.635926188356905)))"
21950006625000,14386,7152,7234,43.1,"MULTIPOLYGON(((9.584799383155419 59.65102665668796,9.577563630746237 59.69572447383563,9.666004390559625 59.6993578325114,9.673123502445755 59.65465355012368,9.584799383155419 59.65102665668796)))"
22000006625000,2530,1300,1230,38.7,"MULTIPOLYGON(((9.673123502445755 59.65465355012368,9.666004390559625 59.6993578325114,9.754467408786454 59.7029317362398,9.76146978305344 59.65822109304143,9.673123502445755 59.65465355012368)))"
22050006625000,910,484,426,42,"MULTIPOLYGON(((9.76146978305344 59.65822109304143,9.754467408786454 59.7029317362398,9.842952325792467 59.70644615521012,9.849837866879493 59.6617292557508,9.76146978305344 59.65822109304143)))"
22100006625000,111,60,51,42.5,"MULTIPOLYGON(((9.849837866879493 59.6617292557508,9.842952325792467 59.70644615521012,9.93145878138016 59.70990106009456,9.938227395265779 59.66517800904222,9.849837866879493 59.6617292557508)))"
22250006625000,4005,1991,2014,41.1,"MULTIPOLYGON(((10.115069348343454 59.67189717294349,10.108534864747377 59.71663221271436,10.197103769395378 59.71990840421645,10.203521053001994 59.67516752754712,10.115069348343454 59.67189717294349)))"
22300006625000,10682,5366,5316,38,"MULTIPOLYGON(((10.203521053001994 59.67516752754712,10.197103769395378 59.71990840421645,10.28569276637984 59.723124969167976,10.291992762172779 59.678378360722206,10.203521053001994 59.67516752754712)))"
22350006625000,1907,1008,899,40,"MULTIPOLYGON(((10.291992762172779 59.678378360722206,10.28569276637984 59.723124969167976,10.374301492820289 59.72628188066871,10.380484114534237 59.68152964567726,10.291992762172779 59.678378360722206)))"
22400006625000,436,239,197,43,"MULTIPOLYGON(((10.380484114534237 59.68152964567726,10.374301492820289 59.72628188066871,10.462929585326522 59.72937911230653,10.468994748258826 59.68462135610698,10.380484114534237 59.68152964567726)))"
22450006625000,3295,1683,1612,40.5,"MULTIPOLYGON(((10.468994748258826 59.68462135610698,10.462929585326522 59.72937911230653,10.551576680007686 59.732416638158256,10.55752430102198 59.687653466193034,10.468994748258826 59.68462135610698)))"
22500006625000,849,440,409,40.9,"MULTIPOLYGON(((10.55752430102198 59.687653466193034,10.551576680007686 59.732416638158256,10.640242412481326 59.735394432790386,10.64607241001113 59.69062595060484,10.55752430102198 59.687653466193034)))"
22550006625000,493,261,232,44.6,"MULTIPOLYGON(((10.64607241001113 59.69062595060484,10.640242412481326 59.735394432790386,10.728926417882498 59.73831247125995,10.734638711934743 59.6935387845004,10.64607241001113 59.69062595060484)))"
22600006625000,10311,5220,5091,38.4,"MULTIPOLYGON(((10.734638711934743 59.6935387845004,10.728926417882498 59.73831247125995,10.817628330872907 59.74117072911528,10.823222843031392 59.69639194352708,10.734638711934743 59.6935387845004)))"
22650006625000,10466,5151,5315,41.1,"MULTIPOLYGON(((10.823222843031392 59.69639194352708,10.817628330872907 59.74117072911528,10.906347785650059 59.743969182396725,10.911824439078854 59.69918540382228,10.823222843031392 59.69639194352708)))"
22700006625000,310,160,150,42.6,"MULTIPOLYGON(((10.911824439078854 59.69918540382228,10.906347785650059 59.743969182396725,10.995084415956478 59.74670780763743,11.000443135403247 59.70191914201427,10.911824439078854 59.69918540382228)))"
22750006625000,4659,2365,2294,40,"MULTIPOLYGON(((11.000443135403247 59.70191914201427,10.995084415956478 59.74670780763743,11.083837855088918 59.74938658186414,11.08907856688818 59.70459313522289,11.000443135403247 59.70191914201427)))"
22800006625000,436,234,202,43.2,"MULTIPOLYGON(((11.08907856688818 59.70459313522289,11.083837855088918 59.74938658186414,11.172607735907617 59.75200548259774,11.177730367983944 59.707207361060256,11.08907856688818 59.70459313522289)))"
22850006625000,187,96,91,41,"MULTIPOLYGON(((11.177730367983944 59.707207361060256,11.172607735907617 59.75200548259774,11.261393690845583 59.754564487854196,11.266398172716729 59.709761797631444,11.177730367983944 59.707207361060256)))"
22900006625000,344,186,158,42.3,"MULTIPOLYGON(((11.266398172716729 59.709761797631444,11.261393690845583 59.754564487854196,11.350195351917908 59.757063576145015,11.355081614697871 59.71225642353524,11.266398172716729 59.709761797631444)))"
22950006625000,335,175,160,44.3,"MULTIPOLYGON(((11.355081614697871 59.71225642353524,11.350195351917908 59.757063576145015,11.439012350731103 59.75950272647809,11.443780327133126 59.71469121786469,11.355081614697871 59.71225642353524)))"
23000006625000,998,502,496,45,"MULTIPOLYGON(((11.443780327133126 59.71469121786469,11.439012350731103 59.75950272647809,11.527844318492454 59.761881918358235,11.532493942831938 59.717066160207885,11.443780327133126 59.71469121786469)))"
23050006625000,18,9,9,51.8,"MULTIPOLYGON(((11.532493942831938 59.717066160207885,11.527844318492454 59.761881918358235,11.616690886019423 59.76420113178796,11.621222094216805 59.7193812306485,11.532493942831938 59.717066160207885)))"
23100006625000,26,13,13,45.6,"MULTIPOLYGON(((11.621222094216805 59.7193812306485,11.616690886019423 59.76420113178796,11.705551683749059 59.766460347267916,11.709964413332587 59.72163640976646,11.621222094216805 59.7193812306485)))"
23150006625000,40,23,17,47.2,"MULTIPOLYGON(((11.709964413332587 59.72163640976646,11.705551683749059 59.766460347267916,11.794426341747442 59.76865954579769,11.798720531855912 59.72383167863859,11.709964413332587 59.72163640976646)))"
23200006625000,441,217,224,48.5,"MULTIPOLYGON(((11.798720531855912 59.72383167863859,11.794426341747442 59.76865954579769,11.88331448971914 59.77079870887631,11.887490081104536 59.72596701883911,11.798720531855912 59.72383167863859)))"
19350006630000,83,39,44,38.4,"MULTIPOLYGON(((5.018012172433692 59.425761042522524,5.004841075172132 59.46998027574815,5.091755567632083 59.47666431301892,5.104816749426076 59.43243336429979,5.018012172433692 59.425761042522524)))"
19450006630000,357,184,173,38,"MULTIPOLYGON(((5.191661304465419 59.43904841954644,5.178710208988945 59.483290987781515,5.265704678776295 59.489860246487325,5.278545518338568 59.44560615492288,5.191661304465419 59.43904841954644)))"
19500006630000,916,468,448,33.8,"MULTIPOLYGON(((5.278545518338568 59.44560615492288,5.265704678776295 59.489860246487325,5.352738655558666 59.49637203600705,5.365469070870082 59.45210651750748,5.278545518338568 59.44560615492288)))"
19550006630000,33,15,18,47.3,"MULTIPOLYGON(((5.365469070870082 59.45210651750748,5.352738655558666 59.49637203600705,5.439811816937941 59.50282630363241,5.452431640928641 59.45854945479796,5.365469070870082 59.45210651750748)))"
19600006630000,215,121,94,42.4,"MULTIPOLYGON(((5.452431640928641 59.45854945479796,5.439811816937941 59.50282630363241,5.526923839559832 59.50922299707747,5.539432906433454 59.4649349147131,5.452431640928641 59.45854945479796)))"
19650006630000,1203,606,597,37.3,"MULTIPOLYGON(((5.539432906433454 59.4649349147131,5.526923839559832 59.50922299707747,5.614074399120411 59.51556206448036,5.626472544360772 59.47126284559408,5.539432906433454 59.4649349147131)))"
19700006630000,116,59,57,39.5,"MULTIPOLYGON(((5.626472544360772 59.47126284559408,5.614074399120411 59.51556206448036,5.701263170372718 59.521843454404646,5.713550230750424 59.477533196206146,5.626472544360772 59.47126284559408)))"
19750006630000,394,187,207,44,"MULTIPOLYGON(((5.713550230750424 59.477533196206146,5.701263170372718 59.521843454404646,5.788489827133372 59.528067115840955,5.800665640712424 59.48374591574002,5.713550230750424 59.477533196206146)))"
19800006630000,283,154,129,38.7,"MULTIPOLYGON(((5.800665640712424 59.48374591574002,5.788489827133372 59.528067115840955,5.875754042289291 59.53423299820844,5.887818448433636 59.48990095381342,5.800665640712424 59.48374591574002)))"
19850006630000,633,338,295,43,"MULTIPOLYGON(((5.887818448433636 59.48990095381342,5.875754042289291 59.53423299820844,5.963055487804453 59.54034105135615,5.975008327184468 59.49599826047252,5.887818448433636 59.48990095381342)))"
19900006630000,110,51,59,41.7,"MULTIPOLYGON(((5.975008327184468 59.49599826047252,5.963055487804453 59.54034105135615,6.05039383472668 59.54639122556471,6.062234949325678 59.5020377861934,5.975008327184468 59.49599826047252)))"
20000006630000,10,5,5,32.3,"MULTIPOLYGON(((6.149497986315149 59.508019481883565,6.137768753194543 59.55238347154767,6.225179912444233 59.55831774045292,6.236797108714796 59.513943298883355,6.149497986315149 59.508019481883565)))"
20050006630000,38,21,17,45.4,"MULTIPOLYGON(((6.236797108714796 59.513943298883355,6.225179912444233 59.55831774045292,6.312626980816574 59.564193983864264,6.324131986197498 59.519809188967386,6.236797108714796 59.513943298883355)))"
20100006630000,58,30,28,45.6,"MULTIPOLYGON(((6.324131986197498 59.519809188967386,6.312626980816574 59.564193983864264,6.400109625764027 59.57001215380275,6.411502287554057 59.52561710434592,6.324131986197498 59.519809188967386)))"
20150006630000,16,8,8,45.9,"MULTIPOLYGON(((6.411502287554057 59.52561710434592,6.400109625764027 59.57001215380275,6.487627513857788 59.57577220272813,6.49890768070026 59.53136699766639,6.411502287554057 59.52561710434592)))"
20250006630000,8,4,4,29.4,"MULTIPOLYGON(((6.58634783268395 59.537058822014735,6.575180310794907 59.58147408354028,6.662767681405482 59.587117749580614,6.67382240969218 59.542692530916796,6.58634783268395 59.537058822014735)))"
20300006630000,9,6,3,42.7,"MULTIPOLYGON(((6.67382240969218 59.542692530916796,6.662767681405482 59.587117749580614,6.750389289659901 59.5927031546334,6.761331077058394 59.54826807833967,6.67382240969218 59.542692530916796)))"
20350006630000,19,9,10,38.7,"MULTIPOLYGON(((6.761331077058394 59.54826807833967,6.750389289659901 59.5927031546334,6.838044798676122 59.59823025292726,6.848873499269675 59.55378541869317,6.761331077058394 59.54826807833967)))"
20900006630000,75,41,34,46.6,"MULTIPOLYGON(((7.726079834634532 59.60574772275367,7.716389722063528 59.65028461478419,7.804395668905574 59.65516744622933,7.813971181635842 59.61062190432795,7.726079834634532 59.60574772275367)))"
20950006630000,158,82,76,42.9,"MULTIPOLYGON(((7.813971181635842 59.61062190432795,7.804395668905574 59.65516744622933,7.89243141015999 59.659991456799375,7.901892194017584 59.61543736676082,7.813971181635842 59.61062190432795)))"
21000006630000,12,8,4,48.5,"MULTIPOLYGON(((7.901892194017584 59.61543736676082,7.89243141015999 59.659991456799375,7.980496598549895 59.664756606618916,7.989842525946367 59.62019407033604,7.901892194017584 59.61543736676082)))"
21050006630000,46,23,23,50.2,"MULTIPOLYGON(((7.989842525946367 59.62019407033604,7.980496598549895 59.664756606618916,8.068590886053357 59.66946285627488,8.077821830849086 59.62489197579803,7.989842525946367 59.62019407033604)))"
21100006630000,1,1,0,0,"MULTIPOLYGON(((8.077821830849086 59.62489197579803,8.068590886053357 59.66946285627488,8.15671392391142 59.67411016681775,8.165829761420929 59.62953104435296,8.077821830849086 59.62489197579803)))"
21150006630000,54,33,21,42.1,"MULTIPOLYGON(((8.165829761420929 59.62953104435296,8.15671392391142 59.67411016681775,8.244865362636151 59.678698499762724,8.253865969633358 59.63411123767002,8.165829761420929 59.62953104435296)))"
21200006630000,3,2,1,0,"MULTIPOLYGON(((8.253865969633358 59.63411123767002,8.244865362636151 59.678698499762724,8.333044852018814 59.68322781709096,8.341930106742213 59.63863251788252,8.253865969633358 59.63411123767002)))"
21250006630000,85,49,36,44.8,"MULTIPOLYGON(((8.341930106742213 59.63863251788252,8.333044852018814 59.68322781709096,8.421252041137981 59.68769808125072,8.430021823295803 59.64309484758907,8.341930106742213 59.63863251788252)))"
21550006630000,18,8,10,53.4,"MULTIPOLYGON(((8.87088181842998 59.664520962197585,8.862691151683622 59.709162323049064,8.951057131003 59.71327750591005,8.959131634578076 59.668628829638045,8.87088181842998 59.664520962197585)))"
21600006630000,273,137,136,45.7,"MULTIPOLYGON(((8.959131634578076 59.668628829638045,8.951057131003 59.71327750591005,9.039448334349615 59.717333385913115,9.047406564888865 59.672677497885296,8.959131634578076 59.668628829638045)))"
21650006630000,136,73,63,43.4,"MULTIPOLYGON(((9.047406564888865 59.672677497885296,9.039448334349615 59.717333385913115,9.127864405399992 59.721329929283336,9.135706254547673 59.67666693330029,9.047406564888865 59.672677497885296)))"
21700006630000,49,27,22,38.1,"MULTIPOLYGON(((9.135706254547673 59.67666693330029,9.127864405399992 59.721329929283336,9.216304987193455 59.72526710272272,9.22403034810724 59.68059710271898,9.135706254547673 59.67666693330029)))"
21750006630000,55,33,22,42.5,"MULTIPOLYGON(((9.22403034810724 59.68059710271898,9.216304987193455 59.72526710272272,9.30476972214071 59.72914487341123,9.312378489496249 59.6844679734535,9.22403034810724 59.68059710271898)))"
21800006630000,32,17,15,52.8,"MULTIPOLYGON(((9.312378489496249 59.6844679734535,9.30476972214071 59.72914487341123,9.39325825203248 59.73296320900779,9.4007503220279 59.68827951329306,9.312378489496249 59.6844679734535)))"
21850006630000,149,73,76,39.3,"MULTIPOLYGON(((9.4007503220279 59.68827951329306,9.39325825203248 59.73296320900779,9.481770218048169 59.73672207765129,9.489145488408527 59.69203169050497,9.4007503220279 59.68827951329306)))"
21900006630000,223,129,94,44.4,"MULTIPOLYGON(((9.489145488408527 59.69203169050497,9.481770218048169 59.73672207765129,9.570305260764592 59.740421447961594,9.577563630746237 59.69572447383563,9.489145488408527 59.69203169050497)))"
21950006630000,319,166,153,42.6,"MULTIPOLYGON(((9.577563630746237 59.69572447383563,9.570305260764592 59.740421447961594,9.658863020164706 59.744061289040474,9.666004390559625 59.6993578325114,9.577563630746237 59.69572447383563)))"
22000006630000,55,32,23,46.4,"MULTIPOLYGON(((9.666004390559625 59.6993578325114,9.658863020164706 59.744061289040474,9.747443135646412 59.74764157047262,9.754467408786454 59.7029317362398,9.666004390559625 59.6993578325114)))"
22050006630000,118,61,57,39.9,"MULTIPOLYGON(((9.754467408786454 59.7029317362398,9.747443135646412 59.74764157047262,9.836045246031368 59.75116226232649,9.842952325792467 59.70644615521012,9.754467408786454 59.7029317362398)))"
22100006630000,3905,1998,1907,41.4,"MULTIPOLYGON(((9.842952325792467 59.70644615521012,9.836045246031368 59.75116226232649,9.92466898957386 59.75462333515534,9.93145878138016 59.70990106009456,9.842952325792467 59.70644615521012)))"
22150006630000,5036,2522,2514,43.1,"MULTIPOLYGON(((9.93145878138016 59.70990106009456,9.92466898957386 59.75462333515534,10.013314003969686 59.75802475999808,10.019986414797613 59.713296422049105,9.93145878138016 59.70990106009456)))"
22200006630000,7417,3813,3604,39.8,"MULTIPOLYGON(((10.019986414797613 59.713296422049105,10.013314003969686 59.75802475999808,10.10197992636512 59.7613665083802,10.108534864747377 59.71663221271436,10.019986414797613 59.713296422049105)))"
22250006630000,32658,15993,16665,40.4,"MULTIPOLYGON(((10.108534864747377 59.71663221271436,10.10197992636512 59.7613665083802,10.190666393365843 59.76464855231466,10.197103769395378 59.71990840421645,10.108534864747377 59.71663221271436)))"
22300006630000,26596,13495,13101,41.8,"MULTIPOLYGON(((10.197103769395378 59.71990840421645,10.190666393365843 59.76464855231466,10.279373041045975 59.7678708643027,10.28569276637984 59.723124969167976,10.197103769395378 59.71990840421645)))"
22350006630000,7732,3814,3918,41.6,"MULTIPOLYGON(((10.28569276637984 59.723124969167976,10.279373041045975 59.7678708643027,10.368099504957105 59.7710334173348,10.374301492820289 59.72628188066871,10.28569276637984 59.723124969167976)))"
22400006630000,5341,2695,2646,38.9,"MULTIPOLYGON(((10.374301492820289 59.72628188066871,10.368099504957105 59.7710334173348,10.456845420137356 59.77413618489145,10.462929585326522 59.72937911230653,10.374301492820289 59.72628188066871)))"
22450006630000,6318,3188,3130,38.9,"MULTIPOLYGON(((10.462929585326522 59.72937911230653,10.456845420137356 59.77413618489145,10.545610421120504 59.777179140943964,10.551576680007686 59.732416638158256,10.462929585326522 59.72937911230653)))"
22500006630000,3000,1493,1507,40.1,"MULTIPOLYGON(((10.551576680007686 59.732416638158256,10.545610421120504 59.777179140943964,10.634394141945101 59.78016225995539,10.640242412481326 59.735394432790386,10.551576680007686 59.732416638158256)))"
22550006630000,1171,590,581,45.3,"MULTIPOLYGON(((10.640242412481326 59.735394432790386,10.634394141945101 59.78016225995539,10.72319621616366 59.78308551688117,10.728926417882498 59.73831247125995,10.640242412481326 59.735394432790386)))"
22600006630000,9471,4799,4672,38,"MULTIPOLYGON(((10.728926417882498 59.73831247125995,10.72319621616366 59.78308551688117,10.812016276851843 59.78594888717005,10.817628330872907 59.74117072911528,10.728926417882498 59.73831247125995)))"
22650006630000,14116,7101,7015,38.6,"MULTIPOLYGON(((10.817628330872907 59.74117072911528,10.812016276851843 59.78594888717005,10.900853956617704 59.78875234676478,10.906347785650059 59.743969182396725,10.817628330872907 59.74117072911528)))"
22700006630000,1462,816,646,40.6,"MULTIPOLYGON(((10.906347785650059 59.743969182396725,10.900853956617704 59.78875234676478,10.989708887610941 59.79149587210287,10.995084415956478 59.74670780763743,10.906347785650059 59.743969182396725)))"
22750006630000,243,131,112,42.9,"MULTIPOLYGON(((10.995084415956478 59.74670780763743,10.989708887610941 59.79149587210287,11.078580701532195 59.79417944011736,11.083837855088918 59.74938658186414,10.995084415956478 59.74670780763743)))"
22800006630000,1057,544,513,43.1,"MULTIPOLYGON(((11.083837855088918 59.74938658186414,11.078580701532195 59.79417944011736,11.167469029642369 59.79680302823751,11.172607735907617 59.75200548259774,11.083837855088918 59.74938658186414)))"
22850006630000,277,148,129,42.5,"MULTIPOLYGON(((11.172607735907617 59.75200548259774,11.167469029642369 59.79680302823751,11.256373502771982 59.799366614389534,11.261393690845583 59.754564487854196,11.172607735907617 59.75200548259774)))"
22900006630000,258,146,112,45.7,"MULTIPOLYGON(((11.261393690845583 59.754564487854196,11.256373502771982 59.799366614389534,11.34529375133054 59.801870176997284,11.350195351917908 59.757063576145015,11.261393690845583 59.754564487854196)))"
22950006630000,173,97,76,41.6,"MULTIPOLYGON(((11.350195351917908 59.757063576145015,11.34529375133054 59.801870176997284,11.434229405315953 59.804313694982916,11.439012350731103 59.75950272647809,11.350195351917908 59.757063576145015)))"
23000006630000,1853,931,922,42.9,"MULTIPOLYGON(((11.439012350731103 59.75950272647809,11.434229405315953 59.804313694982916,11.523180094323948 59.80669714776758,11.527844318492454 59.761881918358235,11.439012350731103 59.75950272647809)))"
23050006630000,58,34,24,41.5,"MULTIPOLYGON(((11.527844318492454 59.761881918358235,11.523180094323948 59.80669714776758,11.612145447557545 59.809020515272046,11.616690886019423 59.76420113178796,11.527844318492454 59.761881918358235)))"
23100006630000,34,15,19,52.7,"MULTIPOLYGON(((11.616690886019423 59.76420113178796,11.612145447557545 59.809020515272046,11.701125093836534 59.81128377791733,11.705551683749059 59.766460347267916,11.616690886019423 59.76420113178796)))"
23150006630000,181,91,90,39.9,"MULTIPOLYGON(((11.705551683749059 59.766460347267916,11.701125093836534 59.81128377791733,11.79011866160699 59.81348691662535,11.794426341747442 59.76865954579769,11.705551683749059 59.766460347267916)))"
23200006630000,28,18,10,40.2,"MULTIPOLYGON(((11.794426341747442 59.76865954579769,11.79011866160699 59.81348691662535,11.879125778950796 59.81562991281946,11.88331448971914 59.77079870887631,11.794426341747442 59.76865954579769)))"
19450006635000,34,17,17,33,"MULTIPOLYGON(((5.178710208988945 59.483290987781515,5.165719284920454 59.52753152131246,5.252824332058559 59.53411233305572,5.265704678776295 59.489860246487325,5.178710208988945 59.483290987781515)))"
19500006635000,682,380,302,38.6,"MULTIPOLYGON(((5.265704678776295 59.489860246487325,5.252824332058559 59.53411233305572,5.339969055490983 59.5406355789937,5.352738655558666 59.49637203600705,5.265704678776295 59.489860246487325)))"
19550006635000,332,175,157,34.9,"MULTIPOLYGON(((5.352738655558666 59.49637203600705,5.339969055490983 59.5406355789937,5.427153131546347 59.54710120621082,5.439811816937941 59.50282630363241,5.352738655558666 59.49637203600705)))"
19600006635000,302,157,145,41.7,"MULTIPOLYGON(((5.439811816937941 59.50282630363241,5.427153131546347 59.54710120621082,5.514376235590332 59.55350916221547,5.526923839559832 59.50922299707747,5.439811816937941 59.50282630363241)))"
19650006635000,217,113,104,40.4,"MULTIPOLYGON(((5.526923839559832 59.50922299707747,5.514376235590332 59.55350916221547,5.601638042032254 59.55985939494153,5.614074399120411 59.51556206448036,5.526923839559832 59.50922299707747)))"
19700006635000,346,168,178,38.5,"MULTIPOLYGON(((5.614074399120411 59.51556206448036,5.601638042032254 59.55985939494153,5.688938224331705 59.56615185274985,5.701263170372718 59.521843454404646,5.614074399120411 59.51556206448036)))"
19750006635000,245,129,116,42.3,"MULTIPOLYGON(((5.701263170372718 59.521843454404646,5.688938224331705 59.56615185274985,5.776276455005212 59.572386484429856,5.788489827133372 59.528067115840955,5.701263170372718 59.521843454404646)))"
19800006635000,722,382,340,43.1,"MULTIPOLYGON(((5.788489827133372 59.528067115840955,5.776276455005212 59.572386484429856,5.86365240563301 59.578563239200996,5.875754042289291 59.53423299820844,5.788489827133372 59.528067115840955)))"
19850006635000,100,46,54,34,"MULTIPOLYGON(((5.875754042289291 59.53423299820844,5.86365240563301 59.578563239200996,5.951065746865808 59.584682066714215,5.963055487804453 59.54034105135615,5.875754042289291 59.53423299820844)))"
19900006635000,17,9,8,45,"MULTIPOLYGON(((5.963055487804453 59.54034105135615,5.951065746865808 59.584682066714215,6.03851614843166 59.59074291705357,6.05039383472668 59.54639122556471,5.963055487804453 59.54034105135615)))"
19950006635000,2,2,0,0,"MULTIPOLYGON(((6.05039383472668 59.54639122556471,6.03851614843166 59.59074291705357,6.126003279142872 59.59674574073753,6.137768753194543 59.55238347154767,6.05039383472668 59.54639122556471)))"
20050006635000,2,1,1,0,"MULTIPOLYGON(((6.225179912444233 59.55831774045292,6.213526806902952 59.60269048872063,6.301086398713649 59.6085771123947,6.312626980816574 59.564193983864264,6.225179912444233 59.55831774045292)))"
20100006635000,20,11,9,40.6,"MULTIPOLYGON(((6.312626980816574 59.564193983864264,6.301086398713649 59.6085771123947,6.388681720681998 59.614405563590545,6.400109625764027 59.57001215380275,6.312626980816574 59.564193983864264)))"
20300006635000,17,10,7,48.1,"MULTIPOLYGON(((6.662767681405482 59.587117749580614,6.651678715332868 59.63154140722953,6.739413601358748 59.6371366956475,6.750389289659901 59.5927031546334,6.662767681405482 59.587117749580614)))"
20350006635000,6,4,2,58,"MULTIPOLYGON(((6.750389289659901 59.5927031546334,6.739413601358748 59.6371366956475,6.827182534908261 59.642673577373905,6.838044798676122 59.59823025292726,6.750389289659901 59.5927031546334)))"
20450006635000,3,1,2,0,"MULTIPOLYGON(((6.925733870727037 59.60369899913642,6.914985176871745 59.64815200690245,7.002821187295851 59.653571939175485,7.013456167247852 59.60910934838213,6.925733870727037 59.60369899913642)))"
20700006635000,9,2,7,64.1,"MULTIPOLYGON(((7.3646707978336 59.63016589387633,7.354492085422932 59.67466581033886,7.442489809847717 59.67979259626737,7.452554109437088 59.635283600862735,7.3646707978336 59.63016589387633)))"
20750006635000,7,4,3,40,"MULTIPOLYGON(((7.452554109437088 59.635283600862735,7.442489809847717 59.67979259626737,7.53051884571851 59.68486062409163,7.540468596950872 59.64034265107504,7.452554109437088 59.635283600862735)))"
20950006635000,80,40,40,44.8,"MULTIPOLYGON(((7.804395668905574 59.65516744622933,7.794790361637429 59.69971174243862,7.882941179042718 59.70454432364657,7.89243141015999 59.659991456799375,7.804395668905574 59.65516744622933)))"
21000006635000,21,11,10,41.2,"MULTIPOLYGON(((7.89243141015999 59.659991456799375,7.882941179042718 59.70454432364657,7.971121571917021 59.709317941955874,7.980496598549895 59.664756606618916,7.89243141015999 59.659991456799375)))"
21050006635000,686,328,358,41.5,"MULTIPOLYGON(((7.980496598549895 59.664756606618916,7.971121571917021 59.709317941955874,8.059331190781542 59.71403255779507,8.068590886053357 59.66946285627488,7.980496598549895 59.664756606618916)))"
21100006635000,227,118,109,45.7,"MULTIPOLYGON(((8.068590886053357 59.66946285627488,8.059331190781542 59.71403255779507,8.147569685415093 59.71868813205812,8.15671392391142 59.67411016681775,8.068590886053357 59.66946285627488)))"
21150006635000,12,8,4,28.3,"MULTIPOLYGON(((8.15671392391142 59.67411016681775,8.147569685415093 59.71868813205812,8.235836704862246 59.723284626105375,8.244865362636151 59.678698499762724,8.15671392391142 59.67411016681775)))"
21200006635000,1,0,1,0,"MULTIPOLYGON(((8.244865362636151 59.678698499762724,8.235836704862246 59.723284626105375,8.324131897441495 59.72782200176503,8.333044852018814 59.68322781709096,8.244865362636151 59.678698499762724)))"
21500006635000,152,87,65,48.7,"MULTIPOLYGON(((8.77435075206919 59.704987871580975,8.766018098681355 59.74962080111877,8.85447490512327 59.753802691180354,8.862691151683622 59.709162323049064,8.77435075206919 59.704987871580975)))"
21550006635000,2,1,1,0,"MULTIPOLYGON(((8.862691151683622 59.709162323049064,8.85447490512327 59.753802691180354,8.94295740329306 59.7579252088434,8.951057131003 59.71327750591005,8.862691151683622 59.709162323049064)))"
21600006635000,150,80,70,45.8,"MULTIPOLYGON(((8.951057131003 59.71327750591005,8.94295740329306 59.7579252088434,9.031465236000393 59.76198831971867,9.039448334349615 59.717333385913115,8.951057131003 59.71327750591005)))"
21650006635000,4,2,2,0,"MULTIPOLYGON(((9.039448334349615 59.717333385913115,9.031465236000393 59.76198831971867,9.11999804540445 59.76599198989454,9.127864405399992 59.721329929283336,9.039448334349615 59.717333385913115)))"
21700006635000,9,4,5,68,"MULTIPOLYGON(((9.127864405399992 59.721329929283336,9.11999804540445 59.76599198989454,9.208555473022544 59.76993618593833,9.216304987193455 59.72526710272272,9.127864405399992 59.721329929283336)))"
21750006635000,36,23,13,55.4,"MULTIPOLYGON(((9.216304987193455 59.72526710272272,9.208555473022544 59.76993618593833,9.297137159738773 59.77382087489707,9.30476972214071 59.72914487341123,9.216304987193455 59.72526710272272)))"
21800006635000,22,14,8,49.8,"MULTIPOLYGON(((9.30476972214071 59.72914487341123,9.297137159738773 59.77382087489707,9.385742745812701 59.777646024298676,9.39325825203248 59.73296320900779,9.30476972214071 59.72914487341123)))"
21900006635000,4,2,2,0,"MULTIPOLYGON(((9.481770218048169 59.73672207765129,9.474371870888099 59.781411602152936,9.563024174001733 59.785117576952445,9.570305260764592 59.740421447961594,9.481770218048169 59.73672207765129)))"
21950006635000,225,131,94,44.7,"MULTIPOLYGON(((9.570305260764592 59.740421447961594,9.563024174001733 59.785117576952445,9.651699293592154 59.78876391767363,9.658863020164706 59.744061289040474,9.570305260764592 59.740421447961594)))"
22000006635000,60,28,32,35.6,"MULTIPOLYGON(((9.658863020164706 59.744061289040474,9.651699293592154 59.78876391767363,9.74039686750855 59.79235059377772,9.747443135646412 59.74764157047262,9.658863020164706 59.744061289040474)))"
22050006635000,1856,935,921,32.2,"MULTIPOLYGON(((9.747443135646412 59.74764157047262,9.74039686750855 59.79235059377772,9.829116533019649 59.79587757521163,9.836045246031368 59.75116226232649,9.747443135646412 59.74764157047262)))"
22100006635000,8777,4358,4419,43,"MULTIPOLYGON(((9.836045246031368 59.75116226232649,9.829116533019649 59.79587757521163,9.917857926822622 59.79934483240898,9.92466898957386 59.75462333515534,9.836045246031368 59.75116226232649)))"
22150006635000,7659,3928,3731,38.8,"MULTIPOLYGON(((9.92466898957386 59.75462333515534,9.917857926822622 59.79934483240898,10.006620685052061 59.802752336291,10.013314003969686 59.75802475999808,9.92466898957386 59.75462333515534)))"
22200006635000,7417,3693,3724,39.3,"MULTIPOLYGON(((10.013314003969686 59.75802475999808,10.006620685052061 59.802752336291,10.095404443288976 59.80610005826738,10.10197992636512 59.7613665083802,10.013314003969686 59.75802475999808)))"
22250006635000,866,409,457,46.8,"MULTIPOLYGON(((10.10197992636512 59.7613665083802,10.095404443288976 59.80610005826738,10.184208836569807 59.80938797023724,10.190666393365843 59.76464855231466,10.10197992636512 59.7613665083802)))"
22300006635000,7854,3906,3948,41.2,"MULTIPOLYGON(((10.190666393365843 59.76464855231466,10.184208836569807 59.80938797023724,10.273033499395535 59.81261604458991,10.279373041045975 59.7678708643027,10.190666393365843 59.76464855231466)))"
22350006635000,2151,1105,1046,40.3,"MULTIPOLYGON(((10.279373041045975 59.7678708643027,10.273033499395535 59.81261604458991,10.361878065740736 59.81578425420592,10.368099504957105 59.7710334173348,10.279373041045975 59.7678708643027)))"
22400006635000,9661,4830,4831,39.9,"MULTIPOLYGON(((10.368099504957105 59.7710334173348,10.361878065740736 59.81578425420592,10.450742169062755 59.8188925724577,10.456845420137356 59.77413618489145,10.368099504957105 59.7710334173348)))"
22450006635000,9817,4910,4907,40.9,"MULTIPOLYGON(((10.456845420137356 59.77413618489145,10.450742169062755 59.8188925724577,10.539625442310856 59.821940973210566,10.545610421120504 59.777179140943964,10.456845420137356 59.77413618489145)))"
22500006635000,2121,1058,1063,40.6,"MULTIPOLYGON(((10.545610421120504 59.777179140943964,10.539625442310856 59.821940973210566,10.628527517935435 59.82492943082344,10.634394141945101 59.78016225995539,10.545610421120504 59.777179140943964)))"
22550006635000,1808,902,906,40.8,"MULTIPOLYGON(((10.634394141945101 59.78016225995539,10.628527517935435 59.82492943082344,10.717448027897257 59.82785792014964,10.72319621616366 59.78308551688117,10.634394141945101 59.78016225995539)))"
22600006635000,16264,7981,8283,42,"MULTIPOLYGON(((10.72319621616366 59.78308551688117,10.717448027897257 59.82785792014964,10.80638660367671 59.83072641653777,10.812016276851843 59.78594888717005,10.72319621616366 59.78308551688117)))"
22650006635000,18740,9355,9385,37.4,"MULTIPOLYGON(((10.812016276851843 59.78594888717005,10.80638660367671 59.83072641653777,10.895342876283127 59.83353489583239,10.900853956617704 59.78875234676478,10.812016276851843 59.78594888717005)))"
22700006635000,190,99,91,45.9,"MULTIPOLYGON(((10.900853956617704 59.78875234676478,10.895342876283127 59.83353489583239,10.984316476264091 59.83628333437487,10.989708887610941 59.79149587210287,10.900853956617704 59.78875234676478)))"
22750006635000,11,5,6,46.5,"MULTIPOLYGON(((10.989708887610941 59.79149587210287,10.984316476264091 59.83628333437487,11.073307033714816 59.83897170900399,11.078580701532195 59.79417944011736,10.989708887610941 59.79149587210287)))"
22800006635000,3905,2001,1904,37.4,"MULTIPOLYGON(((11.078580701532195 59.79417944011736,11.073307033714816 59.83897170900399,11.162314178287513 59.84159999705685,11.167469029642369 59.79680302823751,11.078580701532195 59.79417944011736)))"
22850006635000,341,192,149,43.8,"MULTIPOLYGON(((11.167469029642369 59.79680302823751,11.162314178287513 59.84159999705685,11.251337539200831 59.844168176369436,11.256373502771982 59.799366614389534,11.167469029642369 59.79680302823751)))"
22900006635000,47,28,19,44.9,"MULTIPOLYGON(((11.256373502771982 59.799366614389534,11.251337539200831 59.844168176369436,11.340376745249293 59.84667622527742,11.34529375133054 59.801870176997284,11.256373502771982 59.799366614389534)))"
22950006635000,785,412,373,40.5,"MULTIPOLYGON(((11.34529375133054 59.801870176997284,11.340376745249293 59.84667622527742,11.429431424812764 59.84912412261674,11.434229405315953 59.804313694982916,11.34529375133054 59.801870176997284)))"
23000006635000,982,512,470,41.2,"MULTIPOLYGON(((11.434229405315953 59.804313694982916,11.429431424812764 59.84912412261674,11.518501205865965 59.851511847724396,11.523180094323948 59.80669714776758,11.434229405315953 59.804313694982916)))"
23050006635000,213,102,111,39.4,"MULTIPOLYGON(((11.523180094323948 59.80669714776758,11.518501205865965 59.851511847724396,11.607585715987984 59.853839380439,11.612145447557545 59.809020515272046,11.523180094323948 59.80669714776758)))"
23100006635000,58,31,27,48.4,"MULTIPOLYGON(((11.612145447557545 59.809020515272046,11.607585715987984 59.853839380439,11.696684582371844 59.85610670110141,11.701125093836534 59.81128377791733,11.612145447557545 59.809020515272046)))"
23150006635000,404,203,201,44.8,"MULTIPOLYGON(((11.701125093836534 59.81128377791733,11.696684582371844 59.85610670110141,11.785797431834082 59.85831379055546,11.79011866160699 59.81348691662535,11.701125093836534 59.81128377791733)))"
23200006635000,6,3,3,54.3,"MULTIPOLYGON(((11.79011866160699 59.81348691662535,11.785797431834082 59.85831379055546,11.874923890824338 59.860460630148395,11.879125778950796 59.81562991281946,11.79011866160699 59.81348691662535)))"
19500006640000,339,179,160,39.8,"MULTIPOLYGON(((5.252824332058559 59.53411233305572,5.239904308884925 59.578362407437844,5.327160102639871 59.58489713940349,5.339969055490983 59.5406355789937,5.252824332058559 59.53411233305572)))"
19550006640000,1407,699,708,40.6,"MULTIPOLYGON(((5.339969055490983 59.5406355789937,5.327160102639871 59.58489713940349,5.414455418006739 59.59137415559484,5.427153131546347 59.54710120621082,5.339969055490983 59.5406355789937)))"
19600006640000,108,64,44,45,"MULTIPOLYGON(((5.427153131546347 59.54710120621082,5.414455418006739 59.59137415559484,5.501789929064604 59.59779340331341,5.514376235590332 59.55350916221547,5.427153131546347 59.54710120621082)))"
19650006640000,312,156,156,43.2,"MULTIPOLYGON(((5.514376235590332 59.55350916221547,5.501789929064604 59.59779340331341,5.589163308929398 59.604154830287726,5.601638042032254 59.55985939494153,5.514376235590332 59.55350916221547)))"
19700006640000,77,42,35,41.8,"MULTIPOLYGON(((5.601638042032254 59.55985939494153,5.589163308929398 59.604154830287726,5.676575229760579 59.61045838467484,5.688938224331705 59.56615185274985,5.601638042032254 59.55985939494153)))"
19750006640000,777,425,352,38.4,"MULTIPOLYGON(((5.688938224331705 59.56615185274985,5.676575229760579 59.61045838467484,5.764025362767852 59.61670401506185,5.776276455005212 59.572386484429856,5.688938224331705 59.56615185274985)))"
19800006640000,1781,916,865,40.1,"MULTIPOLYGON(((5.776276455005212 59.572386484429856,5.764025362767852 59.61670401506185,5.85151337821795 59.622891670467425,5.86365240563301 59.578563239200996,5.776276455005212 59.572386484429856)))"
19850006640000,70,40,30,45.6,"MULTIPOLYGON(((5.86365240563301 59.578563239200996,5.85151337821795 59.622891670467425,5.939038945441482 59.62902130034335,5.951065746865808 59.584682066714215,5.86365240563301 59.578563239200996)))"
20050006640000,82,41,41,44.4,"MULTIPOLYGON(((6.213526806902952 59.60269048872063,6.201837637161946 59.6470615378385,6.289510086305144 59.652958568827366,6.301086398713649 59.6085771123947,6.213526806902952 59.60269048872063)))"
20100006640000,2998,1510,1488,43.2,"MULTIPOLYGON(((6.301086398713649 59.6085771123947,6.289510086305144 59.652958568827366,6.377218420076114 59.658797328093726,6.388681720681998 59.614405563590545,6.301086398713649 59.6085771123947)))"
20150006640000,362,176,186,41.7,"MULTIPOLYGON(((6.388681720681998 59.614405563590545,6.377218420076114 59.658797328093726,6.464962302335414 59.66457776771894,6.476312438027458 59.62017579457926,6.388681720681998 59.614405563590545)))"
20350006640000,118,63,55,49.6,"MULTIPOLYGON(((6.739413601358748 59.6371366956475,6.728403865392119 59.68156869621973,6.816286562585801 59.68711538698186,6.827182534908261 59.642673577373905,6.739413601358748 59.6371366956475)))"
20400006640000,16,9,7,47.8,"MULTIPOLYGON(((6.827182534908261 59.642673577373905,6.816286562585801 59.68711538698186,6.90420311441646 59.69260352518792,6.914985176871745 59.64815200690245,6.827182534908261 59.642673577373905)))"
20450006640000,14,9,5,46.3,"MULTIPOLYGON(((6.914985176871745 59.64815200690245,6.90420311441646 59.69260352518792,6.992153179534678 59.69803306560044,7.002821187295851 59.653571939175485,6.914985176871745 59.64815200690245)))"
20800006640000,3,2,1,0,"MULTIPOLYGON(((7.53051884571851 59.68486062409163,7.520538128556329 59.729377278192054,7.608713159120195 59.73439540551007,7.618578847388739 59.68986985193187,7.53051884571851 59.68486062409163)))"
20850006640000,26,15,11,47.1,"MULTIPOLYGON(((7.618578847388739 59.68986985193187,7.608713159120195 59.73439540551007,7.696918942500516 59.73935458950735,7.70666946842949 59.694820238367576,7.618578847388739 59.68986985193187)))"
20900006640000,93,49,44,46.8,"MULTIPOLYGON(((7.70666946842949 59.694820238367576,7.696918942500516 59.73935458950735,7.785155130045512 59.74425478905928,7.794790361637429 59.69971174243862,7.70666946842949 59.694820238367576)))"
20950006640000,18,10,8,41.7,"MULTIPOLYGON(((7.794790361637429 59.69971174243862,7.785155130045512 59.74425478905928,7.873421372331354 59.74909596350464,7.882941179042718 59.70454432364657,7.794790361637429 59.69971174243862)))"
21000006640000,41,17,24,32,"MULTIPOLYGON(((7.882941179042718 59.70454432364657,7.873421372331354 59.74909596350464,7.961717319170206 59.75387807264686,7.971121571917021 59.709317941955874,7.882941179042718 59.70454432364657)))"
21050006640000,138,75,63,46.4,"MULTIPOLYGON(((7.971121571917021 59.709317941955874,7.961717319170206 59.75387807264686,8.050042619618315 59.75860107675532,8.059331190781542 59.71403255779507,7.971121571917021 59.709317941955874)))"
21100006640000,7,5,2,46.7,"MULTIPOLYGON(((8.059331190781542 59.71403255779507,8.050042619618315 59.75860107675532,8.138396921984151 59.763264936566436,8.147569685415093 59.71868813205812,8.059331190781542 59.71403255779507)))"
21150006640000,34,20,14,49.9,"MULTIPOLYGON(((8.147569685415093 59.71868813205812,8.138396921984151 59.763264936566436,8.226779873836595 59.767869613284965,8.235836704862246 59.723284626105375,8.147569685415093 59.71868813205812)))"
21200006640000,13,6,7,41.1,"MULTIPOLYGON(((8.235836704862246 59.723284626105375,8.226779873836595 59.767869613284965,8.315191122013166 59.77241506858518,8.324131897441495 59.72782200176503,8.235836704862246 59.723284626105375)))"
21450006640000,32,17,15,49.3,"MULTIPOLYGON(((8.677587340498603 59.74537957352462,8.669111989578525 59.79000392558571,8.7576593969231 59.79425271542206,8.766018098681355 59.74962080111877,8.677587340498603 59.74537957352462)))"
21500006640000,82,41,41,46.6,"MULTIPOLYGON(((8.766018098681355 59.74962080111877,8.7576593969231 59.79425271542206,8.846232966725195 59.79844206381002,8.85447490512327 59.753802691180354,8.766018098681355 59.74962080111877)))"
21600006640000,1,0,1,0,"MULTIPOLYGON(((8.94295740329306 59.7579252088434,8.934832340937163 59.80257193574249,9.023457160847471 59.80664229669095,9.031465236000393 59.76198831971867,8.94295740329306 59.7579252088434)))"
21650006640000,22,12,10,45.9,"MULTIPOLYGON(((9.031465236000393 59.76198831971867,9.023457160847471 59.80664229669095,9.11210706708934 59.81065311260645,9.11999804540445 59.76599198989454,9.031465236000393 59.76198831971867)))"
21850006640000,4,2,2,0,"MULTIPOLYGON(((9.385742745812701 59.777646024298676,9.37820370049027 59.8223279568821,9.466950345590094 59.82610026180525,9.474371870888099 59.781411602152936,9.385742745812701 59.777646024298676)))"
21900006640000,29,15,14,40,"MULTIPOLYGON(((9.474371870888099 59.781411602152936,9.466950345590094 59.82610026180525,9.555720270663866 59.82981285868132,9.563024174001733 59.785117576952445,9.474371870888099 59.781411602152936)))"
21950006640000,554,307,247,42.9,"MULTIPOLYGON(((9.563024174001733 59.785117576952445,9.555720270663866 59.82981285868132,9.644513112596877 59.83346571636067,9.651699293592154 59.78876391767363,9.563024174001733 59.785117576952445)))"
22050006640000,18,10,8,45.8,"MULTIPOLYGON(((9.74039686750855 59.79235059377772,9.733328507680737 59.83705880418038,9.82216609162229 59.84059209196515,9.829116533019649 59.79587757521163,9.74039686750855 59.79235059377772)))"
22100006640000,909,482,427,41,"MULTIPOLYGON(((9.829116533019649 59.79587757521163,9.82216609162229 59.84059209196515,9.911025499552654 59.84406555002828,9.917857926822622 59.79934483240898,9.829116533019649 59.79587757521163)))"
22150006640000,71,42,29,42.6,"MULTIPOLYGON(((9.917857926822622 59.79934483240898,9.911025499552654 59.84406555002828,9.999906366036205 59.84747914917262,10.006620685052061 59.802752336291,9.917857926822622 59.79934483240898)))"
22250006640000,20,10,10,48.9,"MULTIPOLYGON(((10.095404443288976 59.80610005826738,10.088808325079656 59.85083286069144,10.177731010141153 59.854126656369345,10.184208836569807 59.80938797023724,10.095404443288976 59.80610005826738)))"
22300006640000,3068,1595,1473,42.2,"MULTIPOLYGON(((10.184208836569807 59.80938797023724,10.177731010141153 59.854126656369345,10.26667405413941 59.85736050848315,10.273033499395535 59.81261604458991,10.184208836569807 59.80938797023724)))"
22350006640000,5257,2676,2581,38.6,"MULTIPOLYGON(((10.273033499395535 59.81261604458991,10.26667405413941 59.85736050848315,10.355637089462872 59.860534389802766,10.361878065740736 59.81578425420592,10.273033499395535 59.81261604458991)))"
22400006640000,18098,8903,9195,41.3,"MULTIPOLYGON(((10.361878065740736 59.81578425420592,10.355637089462872 59.860534389802766,10.444619747978926 59.86364827359203,10.450742169062755 59.8188925724577,10.361878065740736 59.81578425420592)))"
22450006640000,18646,9362,9284,40,"MULTIPOLYGON(((10.450742169062755 59.8188925724577,10.444619747978926 59.86364827359203,10.533621661043124 59.86670213360957,10.539625442310856 59.821940973210566,10.450742169062755 59.8188925724577)))"
22500006640000,216,109,107,39,"MULTIPOLYGON(((10.539625442310856 59.821940973210566,10.533621661043124 59.86670213360957,10.622642459508468 59.86969594410961,10.628527517935435 59.82492943082344,10.539625442310856 59.821940973210566)))"
22550006640000,12545,6119,6426,41,"MULTIPOLYGON(((10.628527517935435 59.82492943082344,10.622642459508468 59.86969594410961,10.711681773734705 59.87262967984282,10.717448027897257 59.82785792014964,10.628527517935435 59.82492943082344)))"
22600006640000,24453,11818,12635,41.8,"MULTIPOLYGON(((10.717448027897257 59.82785792014964,10.711681773734705 59.87262967984282,10.800739233597662 59.87550331605703,10.80638660367671 59.83072641653777,10.717448027897257 59.82785792014964)))"
22650006640000,41210,20348,20862,38.4,"MULTIPOLYGON(((10.80638660367671 59.83072641653777,10.800739233597662 59.87550331605703,10.889814468498603 59.87831682849812,10.895342876283127 59.83353489583239,10.80638660367671 59.83072641653777)))"
22750006640000,5,3,2,39.8,"MULTIPOLYGON(((10.984316476264091 59.83628333437487,10.978907107373654 59.88107019341062,11.068016778703198 59.883763387538714,11.073307033714816 59.83897170900399,10.984316476264091 59.83628333437487)))"
22800006640000,1382,708,674,38.5,"MULTIPOLYGON(((11.073307033714816 59.83897170900399,11.068016778703198 59.883763387538714,11.157143110521346 59.88639638812668,11.162314178287513 59.84159999705685,11.073307033714816 59.83897170900399)))"
22850006640000,1328,708,620,40.1,"MULTIPOLYGON(((11.162314178287513 59.84159999705685,11.157143110521346 59.88639638812668,11.24628573042543 59.88896917291979,11.251337539200831 59.844168176369436,11.162314178287513 59.84159999705685)))"
22900006640000,223,118,105,43.9,"MULTIPOLYGON(((11.251337539200831 59.844168176369436,11.24628573042543 59.88896917291979,11.335444265585508 59.89148172016506,11.340376745249293 59.84667622527742,11.251337539200831 59.844168176369436)))"
22950006640000,3,0,3,0,"MULTIPOLYGON(((11.340376745249293 59.84667622527742,11.335444265585508 59.89148172016506,11.424618342753915 59.893934008611716,11.429431424812764 59.84912412261674,11.340376745249293 59.84667622527742)))"
23000006640000,32,16,16,50.7,"MULTIPOLYGON(((11.429431424812764 59.84912412261674,11.424618342753915 59.893934008611716,11.513807588274817 59.8963260175121,11.518501205865965 59.851511847724396,11.429431424812764 59.84912412261674)))"
23050006640000,4450,2201,2249,42,"MULTIPOLYGON(((11.518501205865965 59.851511847724396,11.513807588274817 59.8963260175121,11.603011628093828 59.89865772662219,11.607585715987984 59.853839380439,11.518501205865965 59.851511847724396)))"
23100006640000,39,20,19,46.5,"MULTIPOLYGON(((11.607585715987984 59.853839380439,11.603011628093828 59.89865772662219,11.692230087767632 59.90092911620225,11.696684582371844 59.85610670110141,11.607585715987984 59.853839380439)))"
23150006640000,4,2,2,0,"MULTIPOLYGON(((11.696684582371844 59.85610670110141,11.692230087767632 59.90092911620225,11.78146259247361 59.90314016701757,11.785797431834082 59.85831379055546,11.696684582371844 59.85610670110141)))"
23200006640000,27,14,13,51,"MULTIPOLYGON(((11.785797431834082 59.85831379055546,11.78146259247361 59.90314016701757,11.87070876701954 59.9052908603389,11.874923890824338 59.860460630148395,11.785797431834082 59.85831379055546)))"
23250006640000,11,8,3,43.1,"MULTIPOLYGON(((11.874923890824338 59.860460630148395,11.87070876701954 59.9052908603389,11.959968235853282 59.90738117794319,11.964063585434996 59.86254720173168,11.874923890824338 59.860460630148395)))"
23300006640000,11,6,5,46.3,"MULTIPOLYGON(((11.964063585434996 59.86254720173168,11.959968235853282 59.90738117794319,12.049240623072494 59.90941110211411,12.053216141410825 59.86457348766135,11.964063585434996 59.86254720173168)))"
23350006640000,5,4,1,55.4,"MULTIPOLYGON(((12.053216141410825 59.86457348766135,12.049240623072494 59.90941110211411,12.1385255524344 59.91138061564258,12.142381184158673 59.86653947079869,12.053216141410825 59.86457348766135)))"
23400006640000,4,3,1,0,"MULTIPOLYGON(((12.142381184158673 59.86653947079869,12.1385255524344 59.91138061564258,12.22782264736553 59.91328970182741,12.23155833875713 59.86844513451082,12.142381184158673 59.86653947079869)))"
19400006645000,27,13,14,52.7,"MULTIPOLYGON(((5.065512585039128 59.565120009103154,5.052330439604794 59.609344741533484,5.139617267763926 59.61600645494904,5.152688361693058 59.571770012821794,5.065512585039128 59.565120009103154)))"
19450006645000,963,499,464,43.8,"MULTIPOLYGON(((5.152688361693058 59.571770012821794,5.139617267763926 59.61600645494904,5.226944438985493 59.62261046240112,5.239904308884925 59.578362407437844,5.152688361693058 59.571770012821794)))"
19500006645000,112,60,52,40.9,"MULTIPOLYGON(((5.239904308884925 59.578362407437844,5.226944438985493 59.62261046240112,5.314311628015216 59.62915671013102,5.327160102639871 59.58489713940349,5.239904308884925 59.578362407437844)))"
19550006645000,235,126,109,44.5,"MULTIPOLYGON(((5.327160102639871 59.58489713940349,5.314311628015216 59.62915671013102,5.401718508615608 59.63564514480529,5.414455418006739 59.59137415559484,5.327160102639871 59.58489713940349)))"
19600006645000,714,373,341,37.9,"MULTIPOLYGON(((5.414455418006739 59.59137415559484,5.401718508615608 59.63564514480529,5.489164753572532 59.64207571351747,5.501789929064604 59.59779340331341,5.414455418006739 59.59137415559484)))"
19650006645000,48,27,21,49.1,"MULTIPOLYGON(((5.501789929064604 59.59779340331341,5.489164753572532 59.64207571351747,5.576650034701861 59.648448363789655,5.589163308929398 59.604154830287726,5.501789929064604 59.59779340331341)))"
19700006645000,78,41,37,45.1,"MULTIPOLYGON(((5.589163308929398 59.604154830287726,5.576650034701861 59.648448363789655,5.664174022856205 59.654763043573915,5.676575229760579 59.61045838467484,5.589163308929398 59.604154830287726)))"
19750006645000,22,12,10,52.6,"MULTIPOLYGON(((5.676575229760579 59.61045838467484,5.664174022856205 59.654763043573915,5.751736387931642 59.66101970125398,5.764025362767852 59.61670401506185,5.676575229760579 59.61045838467484)))"
19800006645000,161,89,72,45,"MULTIPOLYGON(((5.764025362767852 59.61670401506185,5.751736387931642 59.66101970125398,5.839336798874589 59.667218285646655,5.85151337821795 59.622891670467425,5.764025362767852 59.61670401506185)))"
19850006645000,728,374,354,39.7,"MULTIPOLYGON(((5.85151337821795 59.622891670467425,5.839336798874589 59.667218285646655,5.926974923688642 59.6733587460034,5.939038945441482 59.62902130034335,5.85151337821795 59.622891670467425)))"
19900006645000,1459,730,729,41.5,"MULTIPOLYGON(((5.939038945441482 59.62902130034335,5.926974923688642 59.6733587460034,6.014650429441538 59.67944103201183,6.026601732839817 59.63509285457596,5.939038945441482 59.62902130034335)))"
19950006645000,53,32,21,39.5,"MULTIPOLYGON(((6.026601732839817 59.63509285457596,6.014650429441538 59.67944103201183,6.102362982272136 59.685465093797184,6.114201407892034 59.6411062834877,6.026601732839817 59.63509285457596)))"
20100006645000,408,216,192,41.4,"MULTIPOLYGON(((6.289510086305144 59.652958568827366,6.277897889119878 59.69733834739687,6.365719570834114 59.703187441663204,6.377218420076114 59.658797328093726,6.289510086305144 59.652958568827366)))"
20150006645000,629,306,323,40.6,"MULTIPOLYGON(((6.377218420076114 59.658797328093726,6.365719570834114 59.703187441663204,6.453576955034611 59.708978116613515,6.464962302335414 59.66457776771894,6.377218420076114 59.658797328093726)))"
20200006645000,43,16,27,51.6,"MULTIPOLYGON(((6.464962302335414 59.66457776771894,6.453576955034611 59.708978116613515,6.541469703322739 59.714710324583315,6.552741396056911 59.67029984022766,6.464962302335414 59.66457776771894)))"
20350006645000,7,6,1,23.1,"MULTIPOLYGON(((6.728403865392119 59.68156869621973,6.71735993414601 59.72599915115696,6.805356735484751 59.73155567666954,6.816286562585801 59.68711538698186,6.728403865392119 59.68156869621973)))"
20700006645000,5,2,3,52,"MULTIPOLYGON(((7.344281716576856 59.71916436040192,7.334039553537081 59.76366153963261,7.422267139608998 59.76880655515261,7.432394198680638 59.72430024914009,7.344281716576856 59.71916436040192)))"
20750006645000,9,4,5,47.4,"MULTIPOLYGON(((7.432394198680638 59.72430024914009,7.422267139608998 59.76880655515261,7.510526310574633 59.773892609151616,7.520538128556329 59.729377278192054,7.432394198680638 59.72430024914009)))"
20800006645000,419,220,199,43.9,"MULTIPOLYGON(((7.520538128556329 59.729377278192054,7.510526310574633 59.773892609151616,7.598816717905199 59.77891965941303,7.608713159120195 59.73439540551007,7.520538128556329 59.729377278192054)))"
20850006645000,29,15,14,41.3,"MULTIPOLYGON(((7.608713159120195 59.73439540551007,7.598816717905199 59.77891965941303,7.687138012278192 59.78388766418285,7.696918942500516 59.73935458950735,7.608713159120195 59.73439540551007)))"
20900006645000,51,30,21,48,"MULTIPOLYGON(((7.696918942500516 59.73935458950735,7.687138012278192 59.78388766418285,7.775489843585416 59.78879658217105,7.785155130045512 59.74425478905928,7.696918942500516 59.73935458950735)))"
20950006645000,19,11,8,44.3,"MULTIPOLYGON(((7.785155130045512 59.74425478905928,7.775489843585416 59.78879658217105,7.863871860940995 59.79364637255271,7.873421372331354 59.74909596350464,7.785155130045512 59.74425478905928)))"
21050006645000,1,1,0,0,"MULTIPOLYGON(((7.961717319170206 59.75387807264686,7.952283712689503 59.798436994969414,8.040725046414098 59.80316840953036,8.050042619618315 59.75860107675532,7.961717319170206 59.75387807264686)))"
21150006645000,32,13,19,40.8,"MULTIPOLYGON(((8.138396921984151 59.763264936566436,8.129195508944711 59.80784057681368,8.217694746366304 59.81245345786755,8.226779873836595 59.767869613284965,8.138396921984151 59.763264936566436)))"
21200006645000,7,3,4,23.4,"MULTIPOLYGON(((8.226779873836595 59.767869613284965,8.217694746366304 59.81245345786755,8.30622240402714 59.817007014211526,8.315191122013166 59.77241506858518,8.226779873836595 59.767869613284965)))"
21250006645000,1,1,0,0,"MULTIPOLYGON(((8.315191122013166 59.77241506858518,8.30622240402714 59.817007014211526,8.394778126547136 59.821501207837585,8.403630312628305 59.77690126461198,8.315191122013166 59.77241506858518)))"
21400006645000,17,9,8,49.5,"MULTIPOLYGON(((8.580591102066668 59.78569572978543,8.571972341052822 59.83031135727335,8.660610118712237 59.83462723943996,8.669111989578525 59.79000392558571,8.580591102066668 59.78569572978543)))"
21450006645000,11,5,6,34.6,"MULTIPOLYGON(((8.669111989578525 59.79000392558571,8.660610118712237 59.83462723943996,8.749274532595239 59.83888361160474,8.7576593969231 59.79425271542206,8.669111989578525 59.79000392558571)))"
21600006645000,33,19,14,60,"MULTIPOLYGON(((8.934832340937163 59.80257193574249,8.92668183277372 59.84721768389488,9.015423999255221 59.85129531420273,9.023457160847471 59.80664229669095,8.934832340937163 59.80257193574249)))"
21650006645000,65,34,31,47.9,"MULTIPOLYGON(((9.023457160847471 59.80664229669095,9.015423999255221 59.85129531420273,9.104191362349704 59.855313294875835,9.11210706708934 59.81065311260645,9.023457160847471 59.80664229669095)))"
21800006645000,4,3,1,0,"MULTIPOLYGON(((9.289480697876503 59.818495975547236,9.281800231524166 59.86317017298315,9.370641012579876 59.86700900446007,9.37820370049027 59.8223279568821,9.289480697876503 59.818495975547236)))"
21850006645000,369,196,173,42.6,"MULTIPOLYGON(((9.37820370049027 59.8223279568821,9.370641012579876 59.86700900446007,9.459505540217705 59.870788054389664,9.466950345590094 59.82610026180525,9.37820370049027 59.8223279568821)))"
21900006645000,165,84,81,44.3,"MULTIPOLYGON(((9.466950345590094 59.82610026180525,9.459505540217705 59.870788054389664,9.548393450367808 59.87450729100793,9.555720270663866 59.82981285868132,9.466950345590094 59.82610026180525)))"
21950006645000,645,298,347,42.9,"MULTIPOLYGON(((9.555720270663866 59.82981285868132,9.548393450367808 59.87450729100793,9.637304378353308 59.87816668303842,9.644513112596877 59.83346571636067,9.555720270663866 59.82981285868132)))"
22000006645000,13,8,5,54.8,"MULTIPOLYGON(((9.644513112596877 59.83346571636067,9.637304378353308 59.87816668303842,9.72623795889926 59.88176619969338,9.733328507680737 59.83705880418038,9.644513112596877 59.83346571636067)))"
22050006645000,56,29,27,43.9,"MULTIPOLYGON(((9.733328507680737 59.83705880418038,9.72623795889926 59.88176619969338,9.815193826141671 59.88530581067456,9.82216609162229 59.84059209196515,9.733328507680737 59.83705880418038)))"
22100006645000,1137,603,534,41.7,"MULTIPOLYGON(((9.82216609162229 59.84059209196515,9.815193826141671 59.88530581067456,9.904171613636557 59.888785486174314,9.911025499552654 59.84406555002828,9.82216609162229 59.84059209196515)))"
22150006645000,723,380,343,43.1,"MULTIPOLYGON(((9.911025499552654 59.84406555002828,9.904171613636557 59.888785486174314,9.99317095436902 59.89220519687643,9.999906366036205 59.84747914917262,9.911025499552654 59.84406555002828)))"
22250006645000,2,1,1,0,"MULTIPOLYGON(((10.088808325079656 59.85083286069144,10.082191480762384 59.89556491395706,10.171232824687358 59.898864609085685,10.177731010141153 59.854126656369345,10.088808325079656 59.85083286069144)))"
22300006645000,1116,585,531,40.2,"MULTIPOLYGON(((10.177731010141153 59.854126656369345,10.171232824687358 59.898864609085685,10.260294617471235 59.902104254425915,10.26667405413941 59.85736050848315,10.177731010141153 59.854126656369345)))"
22350006645000,1016,515,501,41.5,"MULTIPOLYGON(((10.26667405413941 59.85736050848315,10.260294617471235 59.902104254425915,10.349376489907115 59.905283822636434,10.355637089462872 59.860534389802766,10.26667405413941 59.85736050848315)))"
22400006645000,61,30,31,44.1,"MULTIPOLYGON(((10.355637089462872 59.860534389802766,10.349376489907115 59.905283822636434,10.438478072263191 59.90840328687188,10.444619747978926 59.86364827359203,10.355637089462872 59.860534389802766)))"
22450006645000,32578,16294,16284,40.3,"MULTIPOLYGON(((10.444619747978926 59.86364827359203,10.438478072263191 59.90840328687188,10.527598994292038 59.911462620783595,10.533621661043124 59.86670213360957,10.444619747978926 59.86364827359203)))"
22500006645000,30857,15443,15414,40,"MULTIPOLYGON(((10.533621661043124 59.86670213360957,10.527598994292038 59.911462620783595,10.616738885239958 59.91446179852055,10.622642459508468 59.86969594410961,10.533621661043124 59.86670213360957)))"
22550006645000,12092,6043,6049,41.3,"MULTIPOLYGON(((10.622642459508468 59.86969594410961,10.616738885239958 59.91446179852055,10.705897373856347 59.917400794730035,10.711681773734705 59.87262967984282,10.622642459508468 59.86969594410961)))"
22600006645000,92908,48187,44721,36.5,"MULTIPOLYGON(((10.711681773734705 59.87262967984282,10.705897373856347 59.917400794730035,10.795074088403094 59.920279584558685,10.800739233597662 59.87550331605703,10.711681773734705 59.87262967984282)))"
22650006645000,75707,36844,38863,39,"MULTIPOLYGON(((10.800739233597662 59.87550331605703,10.795074088403094 59.920279584558685,10.884268656664021 59.92309814365302,10.889814468498603 59.87831682849812,10.800739233597662 59.87550331605703)))"
22700006645000,20164,10037,10127,38.8,"MULTIPOLYGON(((10.889814468498603 59.87831682849812,10.884268656664021 59.92309814365302,10.973480705954344 59.925856448160346,10.978907107373654 59.88107019341062,10.889814468498603 59.87831682849812)))"
22750006645000,837,423,414,41.9,"MULTIPOLYGON(((10.978907107373654 59.88107019341062,10.973480705954344 59.925856448160346,11.062709863130175 59.92855447472946,11.068016778703198 59.883763387538714,10.978907107373654 59.88107019341062)))"
22800006645000,6240,3185,3055,35.5,"MULTIPOLYGON(((11.068016778703198 59.883763387538714,11.062709863130175 59.92855447472946,11.151955754598033 59.93119220051148,11.157143110521346 59.88639638812668,11.068016778703198 59.883763387538714)))"
22850006645000,4254,2177,2077,40.7,"MULTIPOLYGON(((11.157143110521346 59.88639638812668,11.151955754598033 59.93119220051148,11.241218006324415 59.93376960316046,11.24628573042543 59.88896917291979,11.157143110521346 59.88639638812668)))"
22900006645000,5,4,1,60,"MULTIPOLYGON(((11.24628573042543 59.88896917291979,11.241218006324415 59.93376960316046,11.330496243845376 59.93628666083409,11.335444265585508 59.89148172016506,11.24628573042543 59.88896917291979)))"
22950006645000,291,151,140,43.2,"MULTIPOLYGON(((11.335444265585508 59.89148172016506,11.330496243845376 59.93628666083409,11.419790092276138 59.938743352194514,11.424618342753915 59.893934008611716,11.335444265585508 59.89148172016506)))"
23000006645000,3928,1913,2015,40.9,"MULTIPOLYGON(((11.424618342753915 59.893934008611716,11.419790092276138 59.938743352194514,11.509099176320731 59.94113965640891,11.513807588274817 59.8963260175121,11.424618342753915 59.893934008611716)))"
23050006645000,674,351,323,41.8,"MULTIPOLYGON(((11.513807588274817 59.8963260175121,11.509099176320731 59.94113965640891,11.598423120281673 59.9434755531501,11.603011628093828 59.89865772662219,11.513807588274817 59.8963260175121)))"
23100006645000,42,19,23,42.5,"MULTIPOLYGON(((11.603011628093828 59.89865772662219,11.598423120281673 59.9434755531501,11.68776154806964 59.9457510225974,11.692230087767632 59.90092911620225,11.603011628093828 59.89865772662219)))"
23150006645000,14,9,5,52.2,"MULTIPOLYGON(((11.692230087767632 59.90092911620225,11.68776154806964 59.9457510225974,11.7771140832132 59.94796604543699,11.78146259247361 59.90314016701757,11.692230087767632 59.90092911620225)))"
23200006645000,13,10,3,49.1,"MULTIPOLYGON(((11.78146259247361 59.90314016701757,11.7771140832132 59.94796604543699,11.866480348868567 59.95012060286275,11.87070876701954 59.9052908603389,11.78146259247361 59.90314016701757)))"
23250006645000,20,13,7,57.5,"MULTIPOLYGON(((11.87070876701954 59.9052908603389,11.866480348868567 59.95012060286275,11.955859967829351 59.95221467657669,11.959968235853282 59.90738117794319,11.87070876701954 59.9052908603389)))"
23300006645000,354,194,160,46.2,"MULTIPOLYGON(((11.959968235853282 59.90738117794319,11.955859967829351 59.95221467657669,12.04525256253636 59.95424824878965,12.049240623072494 59.90941110211411,11.959968235853282 59.90738117794319)))"
23350006645000,80,42,38,48,"MULTIPOLYGON(((12.049240623072494 59.90941110211411,12.04525256253636 59.95424824878965,12.134657755087423 59.956221302221806,12.1385255524344 59.91138061564258,12.049240623072494 59.90941110211411)))"
23400006645000,1221,595,626,46.8,"MULTIPOLYGON(((12.1385255524344 59.91138061564258,12.134657755087423 59.956221302221806,12.224075167247218 59.95813382010327,12.22782264736553 59.91328970182741,12.1385255524344 59.91138061564258)))"
23450006645000,39,25,14,58.4,"MULTIPOLYGON(((12.22782264736553 59.91328970182741,12.224075167247218 59.95813382010327,12.313504420457143 59.959985786174535,12.317131530971523 59.915138344475686,12.22782264736553 59.91328970182741)))"
19450006650000,37,19,18,63.9,"MULTIPOLYGON(((5.139617267763926 59.61600645494904,5.126505830607392 59.66024084029045,5.21394455111401 59.66685649067053,5.226944438985493 59.62261046240112,5.139617267763926 59.61600645494904)))"
19500006650000,26,15,11,49.1,"MULTIPOLYGON(((5.226944438985493 59.62261046240112,5.21394455111401 59.66685649067053,5.301423461657114 59.67341428402897,5.314311628015216 59.62915671013102,5.226944438985493 59.62261046240112)))"
19550006650000,244,127,117,45.4,"MULTIPOLYGON(((5.314311628015216 59.62915671013102,5.301423461657114 59.67341428402897,5.388942234706275 59.67991416682177,5.401718508615608 59.63564514480529,5.314311628015216 59.62915671013102)))"
19600006650000,276,156,120,43.2,"MULTIPOLYGON(((5.401718508615608 59.63564514480529,5.388942234706275 59.67991416682177,5.476500541747503 59.686356085933355,5.489164753572532 59.64207571351747,5.401718508615608 59.63564514480529)))"
19650006650000,28,15,13,32.9,"MULTIPOLYGON(((5.489164753572532 59.64207571351747,5.476500541747503 59.686356085933355,5.564098053289893 59.69273998867819,5.576650034701861 59.648448363789655,5.489164753572532 59.64207571351747)))"
19700006650000,256,136,120,48.6,"MULTIPOLYGON(((5.576650034701861 59.648448363789655,5.564098053289893 59.69273998867819,5.651734438872439 59.699065822802325,5.664174022856205 59.654763043573915,5.576650034701861 59.648448363789655)))"
19750006650000,115,60,55,41,"MULTIPOLYGON(((5.664174022856205 59.654763043573915,5.651734438872439 59.699065822802325,5.739409367070788 59.70533353648495,5.751736387931642 59.66101970125398,5.664174022856205 59.654763043573915)))"
19800006650000,79,50,29,45.3,"MULTIPOLYGON(((5.751736387931642 59.66101970125398,5.739409367070788 59.70533353648495,5.827122505504136 59.71154307833991,5.839336798874589 59.667218285646655,5.751736387931642 59.66101970125398)))"
19850006650000,98,50,48,45.4,"MULTIPOLYGON(((5.839336798874589 59.667218285646655,5.827122505504136 59.71154307833991,5.914873520842145 59.71769439741723,5.926974923688642 59.6733587460034,5.839336798874589 59.667218285646655)))"
19900006650000,384,199,185,36.7,"MULTIPOLYGON(((5.926974923688642 59.6733587460034,5.914873520842145 59.71769439741723,6.002662078811915 59.72378744320475,6.014650429441538 59.67944103201183,5.926974923688642 59.6733587460034)))"
19950006650000,131,77,54,41.7,"MULTIPOLYGON(((6.014650429441538 59.67944103201183,6.002662078811915 59.72378744320475,6.090487844205032 59.72982216562944,6.102362982272136 59.685465093797184,6.014650429441538 59.67944103201183)))"
20000006650000,88,45,43,46.2,"MULTIPOLYGON(((6.102362982272136 59.685465093797184,6.090487844205032 59.72982216562944,6.178350480884669 59.73579851505901,6.190112247397474 59.691430881923864,6.102362982272136 59.685465093797184)))"
20350006650000,11,6,5,33,"MULTIPOLYGON(((6.71735993414601 59.72599915115696,6.706281659149132 59.77042805523499,6.794392906531292 59.775994441324976,6.805356735484751 59.73155567666954,6.71735993414601 59.72599915115696)))"
20700006650000,32,15,17,41.8,"MULTIPOLYGON(((7.334039553537081 59.76366153963261,7.32376545774153 59.80815734357137,7.412108495510035 59.81331150995045,7.422267139608998 59.76880655515261,7.334039553537081 59.76366153963261)))"
20750006650000,6,3,3,46,"MULTIPOLYGON(((7.422267139608998 59.76880655515261,7.412108495510035 59.81331150995045,7.500483256095722 59.81840661272003,7.510526310574633 59.773892609151616,7.422267139608998 59.76880655515261)))"
21100006650000,10,6,4,46.3,"MULTIPOLYGON(((8.040725046414098 59.80316840953036,8.03137834427969 59.84773455247286,8.119965320891508 59.85241504924921,8.129195508944711 59.80784057681368,8.040725046414098 59.80316840953036)))"
21150006650000,10,6,4,54.9,"MULTIPOLYGON(((8.129195508944711 59.80784057681368,8.119965320891508 59.85241504924921,8.20858119853537 59.857036156398195,8.217694746366304 59.81245345786755,8.129195508944711 59.80784057681368)))"
21200006650000,1,1,0,0,"MULTIPOLYGON(((8.217694746366304 59.81245345786755,8.20858119853537 59.857036156398195,8.297225621061955 59.8615978352837,8.30622240402714 59.817007014211526,8.217694746366304 59.81245345786755)))"
21250006650000,6,3,3,72.2,"MULTIPOLYGON(((8.30622240402714 59.817007014211526,8.297225621061955 59.8615978352837,8.385898231588268 59.86610004774394,8.394778126547136 59.821501207837585,8.30622240402714 59.817007014211526)))"
21300006650000,13,7,6,39.9,"MULTIPOLYGON(((8.394778126547136 59.821501207837585,8.385898231588268 59.86610004774394,8.474598672506072 59.87054275609261,8.483361557826228 59.82593600121137,8.394778126547136 59.821501207837585)))"
21400006650000,71,33,38,45,"MULTIPOLYGON(((8.571972341052822 59.83031135727335,8.56332658549039 59.87492592312007,8.65208161150802 59.879249512094404,8.660610118712237 59.83462723943996,8.571972341052822 59.83031135727335)))"
21450006650000,42,24,18,39.8,"MULTIPOLYGON(((8.660610118712237 59.83462723943996,8.65208161150802 59.879249512094404,8.740863390826116 59.88351348676277,8.749274532595239 59.83888361160474,8.660610118712237 59.83462723943996)))"
21500006650000,9,5,4,40.2,"MULTIPOLYGON(((8.749274532595239 59.83888361160474,8.740863390826116 59.88351348676277,8.829671563020804 59.88771781135231,8.837965223806608 59.84308043813935,8.749274532595239 59.83888361160474)))"
21600006650000,25,15,10,54.4,"MULTIPOLYGON(((8.92668183277372 59.84721768389488,8.918505766985874 59.89186245057132,9.007365640941432 59.89594736961045,9.015423999255221 59.85129531420273,8.92668183277372 59.84721768389488)))"
21650006650000,80,41,39,46.4,"MULTIPOLYGON(((9.015423999255221 59.85129531420273,9.007365640941432 59.89594736961045,9.096250822442718 59.89997253414364,9.104191362349704 59.855313294875835,9.015423999255221 59.85129531420273)))"
21700006650000,3,2,1,0,"MULTIPOLYGON(((9.104191362349704 59.855313294875835,9.096250822442718 59.89997253414364,9.185160948388853 59.903937910329326,9.192983560504443 59.85927159220964,9.104191362349704 59.855313294875835)))"
21800006650000,42,19,23,48.6,"MULTIPOLYGON(((9.281800231524166 59.86317017298315,9.274095655031688 59.90784346481136,9.363054577984695 59.911689164720165,9.370641012579876 59.86700900446007,9.281800231524166 59.86317017298315)))"
21850006650000,57,30,27,43.6,"MULTIPOLYGON(((9.370641012579876 59.86700900446007,9.363054577984695 59.911689164720165,9.45203735223186 59.915474977673696,9.459505540217705 59.870788054389664,9.370641012579876 59.86700900446007)))"
21900006650000,230,108,122,42.4,"MULTIPOLYGON(((9.459505540217705 59.870788054389664,9.45203735223186 59.915474977673696,9.541043612136672 59.91920087177851,9.548393450367808 59.87450729100793,9.459505540217705 59.870788054389664)))"
21950006650000,17,11,6,46.5,"MULTIPOLYGON(((9.548393450367808 59.87450729100793,9.541043612136672 59.91920087177851,9.630072991451103 59.92286681563069,9.637304378353308 59.87816668303842,9.548393450367808 59.87450729100793)))"
22000006650000,13,7,6,44.9,"MULTIPOLYGON(((9.637304378353308 59.87816668303842,9.630072991451103 59.92286681563069,9.719125123324654 59.92647277831688,9.72623795889926 59.88176619969338,9.637304378353308 59.87816668303842)))"
22050006650000,156,82,74,43.7,"MULTIPOLYGON(((9.72623795889926 59.88176619969338,9.719125123324654 59.92647277831688,9.808199640313426 59.93001872941525,9.815193826141671 59.88530581067456,9.72623795889926 59.88176619969338)))"
22100006650000,751,403,348,40.6,"MULTIPOLYGON(((9.815193826141671 59.88530581067456,9.808199640313426 59.93001872941525,9.897296174389249 59.933504638996475,9.904171613636557 59.888785486174314,9.815193826141671 59.88530581067456)))"
22150006650000,5825,2915,2910,41.7,"MULTIPOLYGON(((9.904171613636557 59.888785486174314,9.897296174389249 59.933504638996475,9.986414356948822 59.93693047762462,9.99317095436902 59.89220519687643,9.904171613636557 59.888785486174314)))"
22200006650000,83,42,41,45.3,"MULTIPOLYGON(((9.99317095436902 59.89220519687643,9.986414356948822 59.93693047762462,10.07555381882293 59.940296216358036,10.082191480762384 59.89556491395706,9.99317095436902 59.89220519687643)))"
22300006650000,71,40,31,38.1,"MULTIPOLYGON(((10.171232824687358 59.898864609085685,10.164714190285633 59.943601826750424,10.253895101063565 59.94684728085161,10.260294617471235 59.902104254425915,10.171232824687358 59.898864609085685)))"
22350006650000,589,308,281,38.8,"MULTIPOLYGON(((10.260294617471235 59.902104254425915,10.253895101063565 59.94684728085161,10.343096180345222 59.950032551208366,10.349376489907115 59.905283822636434,10.260294617471235 59.902104254425915)))"
22400006650000,158,91,67,43.8,"MULTIPOLYGON(((10.349376489907115 59.905283822636434,10.343096180345222 59.950032551208366,10.432317056790302 59.95315761086549,10.438478072263191 59.90840328687188,10.349376489907115 59.905283822636434)))"
22450006650000,24121,11956,12165,41.8,"MULTIPOLYGON(((10.438478072263191 59.90840328687188,10.432317056790302 59.95315761086549,10.521557358539056 59.956222433366435,10.527598994292038 59.911462620783595,10.438478072263191 59.90840328687188)))"
22500006650000,31048,15270,15778,41.1,"MULTIPOLYGON(((10.527598994292038 59.911462620783595,10.521557358539056 59.956222433366435,10.610816713221721 59.95922699275428,10.616738885239958 59.91446179852055,10.527598994292038 59.911462620783595)))"
22550006650000,88389,43266,45123,40.1,"MULTIPOLYGON(((10.616738885239958 59.91446179852055,10.610816713221721 59.95922699275428,10.700094747967945 59.962171263572486,10.705897373856347 59.917400794730035,10.616738885239958 59.91446179852055)))"
22600006650000,216116,107263,108853,36.4,"MULTIPOLYGON(((10.705897373856347 59.917400794730035,10.700094747967945 59.962171263572486,10.78939108941624 59.96505522086577,10.795074088403094 59.920279584558685,10.705897373856347 59.917400794730035)))"
22650006650000,76963,38563,38400,37.1,"MULTIPOLYGON(((10.795074088403094 59.920279584558685,10.78939108941624 59.96505522086577,10.878705363723517 59.96787884018079,10.884268656664021 59.92309814365302,10.795074088403094 59.920279584558685)))"
22700006650000,73696,37291,36405,38.7,"MULTIPOLYGON(((10.884268656664021 59.92309814365302,10.878705363723517 59.96787884018079,10.968037196574599 59.970642097567016,10.973480705954344 59.925856448160346,10.884268656664021 59.92309814365302)))"
22750006650000,56293,28417,27876,40,"MULTIPOLYGON(((10.973480705954344 59.925856448160346,10.968037196574599 59.970642097567016,11.057386213191783 59.97334496957744,11.062709863130175 59.92855447472946,10.973480705954344 59.925856448160346)))"
22800006650000,9623,4926,4697,37.9,"MULTIPOLYGON(((11.062709863130175 59.92855447472946,11.057386213191783 59.97334496957744,11.146752038344452 59.97598743326936,11.151955754598033 59.93119220051148,11.062709863130175 59.92855447472946)))"
22850006650000,3003,1552,1451,38.2,"MULTIPOLYGON(((11.151955754598033 59.93119220051148,11.146752038344452 59.97598743326936,11.23613429635868 59.97856946620508,11.241218006324415 59.93376960316046,11.151955754598033 59.93119220051148)))"
22900006650000,2051,997,1054,39.1,"MULTIPOLYGON(((11.241218006324415 59.93376960316046,11.23613429635868 59.97856946620508,11.325532611126903 59.9810910464526,11.330496243845376 59.93628666083409,11.241218006324415 59.93376960316046)))"
22950006650000,1332,688,644,39.4,"MULTIPOLYGON(((11.330496243845376 59.93628666083409,11.325532611126903 59.9810910464526,11.414946606117601 59.983552152586334,11.419790092276138 59.938743352194514,11.330496243845376 59.93628666083409)))"
23000006650000,451,229,222,42.2,"MULTIPOLYGON(((11.419790092276138 59.938743352194514,11.414946606117601 59.983552152586334,11.504375904384998 59.98595276368783,11.509099176320731 59.94113965640891,11.419790092276138 59.938743352194514)))"
23050006650000,115,56,59,41.1,"MULTIPOLYGON(((11.509099176320731 59.94113965640891,11.504375904384998 59.98595276368783,11.593820128578804 59.98829285934641,11.598423120281673 59.9434755531501,11.509099176320731 59.94113965640891)))"
23100006650000,12,8,4,48.2,"MULTIPOLYGON(((11.598423120281673 59.9434755531501,11.593820128578804 59.98829285934641,11.683278900953985 59.990572419659784,11.68776154806964 59.9457510225974,11.598423120281673 59.9434755531501)))"
23150006650000,31,16,15,50.7,"MULTIPOLYGON(((11.68776154806964 59.9457510225974,11.683278900953985 59.990572419659784,11.772751843380552 59.99279142523473,11.7771140832132 59.94796604543699,11.68776154806964 59.9457510225974)))"
23200006650000,12,9,3,50.7,"MULTIPOLYGON(((11.7771140832132 59.94796604543699,11.772751843380552 59.99279142523473,11.862238577353375 59.99494985718766,11.866480348868567 59.95012060286275,11.7771140832132 59.94796604543699)))"
23250006650000,14,9,5,60.1,"MULTIPOLYGON(((11.866480348868567 59.95012060286275,11.862238577353375 59.99494985718766,11.951738724002027 59.99704769714536,11.955859967829351 59.95221467657669,11.866480348868567 59.95012060286275)))"
23300006650000,114,63,51,44,"MULTIPOLYGON(((11.955859967829351 59.95221467657669,11.951738724002027 59.99704769714536,12.041251904100644 59.99908492724538,12.04525256253636 59.95424824878965,11.955859967829351 59.95221467657669)))"
23350006650000,1760,839,921,48.6,"MULTIPOLYGON(((12.04525256253636 59.95424824878965,12.041251904100644 59.99908492724538,12.130777738077828 60.00106153013672,12.134657755087423 59.956221302221806,12.04525256253636 59.95424824878965)))"
23400006650000,912,450,462,48,"MULTIPOLYGON(((12.134657755087423 59.956221302221806,12.130777738077828 60.00106153013672,12.220315846026542 60.002977488980385,12.224075167247218 59.95813382010327,12.134657755087423 59.956221302221806)))"
23450006650000,135,71,64,42,"MULTIPOLYGON(((12.224075167247218 59.95813382010327,12.220315846026542 60.002977488980385,12.309865847714054 60.00483278744993,12.313504420457143 59.959985786174535,12.224075167247218 59.95813382010327)))"
23500006650000,111,59,52,52.5,"MULTIPOLYGON(((12.313504420457143 59.959985786174535,12.309865847714054 60.00483278744993,12.399427362591892 60.006627409731855,12.402945135845194 59.96177718468708,12.313504420457143 59.959985786174535)))"
19450006655000,165,84,81,45.3,"MULTIPOLYGON(((5.126505830607392 59.66024084029045,5.113353876708034 59.704473161398624,5.200904473041017 59.711100484927925,5.21394455111401 59.66685649067053,5.126505830607392 59.66024084029045)))"
19500006655000,6,5,1,56.3,"MULTIPOLYGON(((5.21394455111401 59.66685649067053,5.200904473041017 59.711100484927925,5.288495432629029 59.717669853907786,5.301423461657114 59.67341428402897,5.21394455111401 59.66685649067053)))"
19550006655000,1550,777,773,40.4,"MULTIPOLYGON(((5.301423461657114 59.67341428402897,5.288495432629029 59.717669853907786,5.376126426642076 59.72418121458239,5.388942234706275 59.67991416682177,5.301423461657114 59.67341428402897)))"
19600006655000,301,156,145,43.3,"MULTIPOLYGON(((5.388942234706275 59.67991416682177,5.376126426642076 59.72418121458239,5.463797125259612 59.730634513625915,5.476500541747503 59.686356085933355,5.388942234706275 59.67991416682177)))"
19650006655000,286,151,135,49.2,"MULTIPOLYGON(((5.476500541747503 59.686356085933355,5.463797125259612 59.730634513625915,5.551507197677224 59.73702969814413,5.564098053289893 59.69273998867819,5.476500541747503 59.686356085933355)))"
19750006655000,66,38,28,57.6,"MULTIPOLYGON(((5.651734438872439 59.699065822802325,5.639256312113461 59.74336671567587,5.727044135816679 59.74964551419466,5.739409367070788 59.70533353648495,5.651734438872439 59.699065822802325)))"
19800006655000,62,30,32,50.4,"MULTIPOLYGON(((5.739409367070788 59.70533353648495,5.727044135816679 59.74964551419466,5.814870335071939 59.755866042110306,5.827122505504136 59.71154307833991,5.739409367070788 59.70533353648495)))"
19850006655000,154,77,77,42.5,"MULTIPOLYGON(((5.827122505504136 59.71154307833991,5.814870335071939 59.755866042110306,5.902734575207967 59.76202824827035,5.914873520842145 59.71769439741723,5.827122505504136 59.71154307833991)))"
19900006655000,626,333,293,47.2,"MULTIPOLYGON(((5.914873520842145 59.71769439741723,5.902734575207967 59.76202824827035,5.990636520604206 59.768132081961596,6.002662078811915 59.72378744320475,5.914873520842145 59.71769439741723)))"
19950006655000,52,28,24,49.5,"MULTIPOLYGON(((6.002662078811915 59.72378744320475,5.990636520604206 59.768132081961596,6.078575834697875 59.77417749291178,6.090487844205032 59.72982216562944,6.002662078811915 59.72378744320475)))"
20000006655000,86,49,37,41.6,"MULTIPOLYGON(((6.090487844205032 59.72982216562944,6.078575834697875 59.77417749291178,6.166552179991116 59.78016443129084,6.178350480884669 59.73579851505901,6.090487844205032 59.72982216562944)))"
20050006655000,6,4,2,42.8,"MULTIPOLYGON(((6.178350480884669 59.73579851505901,6.166552179991116 59.78016443129084,6.254565218058183 59.78609284771258,6.266249651792712 59.741716442303435,6.178350480884669 59.73579851505901)))"
20350006655000,35,17,18,42.2,"MULTIPOLYGON(((6.706281659149132 59.77042805523499,6.69516889106677 59.81485540319817,6.783394927795722 59.820431675805345,6.794392906531292 59.775994441324976,6.706281659149132 59.77042805523499)))"
20400006655000,24,10,14,46,"MULTIPOLYGON(((6.794392906531292 59.775994441324976,6.783394927795722 59.820431675805345,6.871655262953877 59.82594909330201,6.882538303551882 59.78150207340356,6.794392906531292 59.775994441324976)))"
20600006655000,12,5,7,31.8,"MULTIPOLYGON(((7.147175946537899 59.797671991844716,7.136638598878051 59.84214775958211,7.225032663355469 59.8474293033793,7.235454491964524 59.80294415643232,7.147175946537899 59.797671991844716)))"
21050006655000,8,4,4,56.9,"MULTIPOLYGON(((7.942820624107175 59.842994705178306,7.933327924302255 59.88755119950538,8.022002385580917 59.892299501913016,8.03137834427969 59.84773455247286,7.942820624107175 59.842994705178306)))"
21100006655000,8,2,6,35.3,"MULTIPOLYGON(((8.03137834427969 59.84773455247286,8.022002385580917 59.892299501913016,8.110706231682585 59.8969883503006,8.119965320891508 59.85241504924921,8.03137834427969 59.84773455247286)))"
21150006655000,2,0,2,0,"MULTIPOLYGON(((8.119965320891508 59.85241504924921,8.110706231682585 59.8969883503006,8.199439105699438 59.901617705400675,8.20858119853537 59.857036156398195,8.119965320891508 59.85241504924921)))"
21350006655000,106,58,48,48.8,"MULTIPOLYGON(((8.474598672506072 59.87054275609261,8.465808315001372 59.91514842543178,8.554653716778041 59.91953942422323,8.56332658549039 59.87492592312007,8.474598672506072 59.87054275609261)))"
21400006655000,2412,1176,1236,46.1,"MULTIPOLYGON(((8.56332658549039 59.87492592312007,8.554653716778041 59.91953942422323,8.643526350888168 59.92387074053741,8.65208161150802 59.879249512094404,8.56332658549039 59.87492592312007)))"
21450006655000,574,296,278,46.4,"MULTIPOLYGON(((8.65208161150802 59.879249512094404,8.643526350888168 59.92387074053741,8.732425856066667 59.928142337974144,8.740863390826116 59.88351348676277,8.65208161150802 59.879249512094404)))"
21500006655000,447,220,227,45,"MULTIPOLYGON(((8.740863390826116 59.88351348676277,8.732425856066667 59.928142337974144,8.821351870352364 59.932354180615235,8.829671563020804 59.88771781135231,8.740863390826116 59.88351348676277)))"
21550006655000,7,5,2,63.3,"MULTIPOLYGON(((8.829671563020804 59.88771781135231,8.821351870352364 59.932354180615235,8.910304031096715 59.93650623302549,8.918505766985874 59.89186245057132,8.829671563020804 59.88771781135231)))"
21600006655000,17,12,5,50.3,"MULTIPOLYGON(((8.918505766985874 59.89186245057132,8.910304031096715 59.93650623302549,8.999281974972574 59.9405984602539,9.007365640941432 59.89594736961045,8.918505766985874 59.89186245057132)))"
21650006655000,5,4,1,66.4,"MULTIPOLYGON(((9.007365640941432 59.89594736961045,8.999281974972574 59.9405984602539,9.088285337983011 59.944630827834736,9.096250822442718 59.89997253414364,9.007365640941432 59.89594736961045)))"
21800006655000,113,59,54,50.1,"MULTIPOLYGON(((9.274095655031688 59.90784346481136,9.266366862124137 59.95251584862326,9.355444291991935 59.95636843533532,9.363054577984695 59.911689164720165,9.274095655031688 59.90784346481136)))"
21850006655000,68,40,28,46.6,"MULTIPOLYGON(((9.363054577984695 59.911689164720165,9.355444291991935 59.95636843533532,9.444545678486454 59.960161029410635,9.45203735223186 59.915474977673696,9.363054577984695 59.911689164720165)))"
21900006655000,95,58,37,47.6,"MULTIPOLYGON(((9.45203735223186 59.915474977673696,9.444545678486454 59.960161029410635,9.533670654395511 59.963893598825535,9.541043612136672 59.91920087177851,9.45203735223186 59.915474977673696)))"
21950006655000,45,27,18,45.6,"MULTIPOLYGON(((9.541043612136672 59.91920087177851,9.533670654395511 59.963893598825535,9.622818851890887 59.96756611204794,9.630072991451103 59.92286681563069,9.541043612136672 59.91920087177851)))"
22000006655000,17,12,5,49.4,"MULTIPOLYGON(((9.630072991451103 59.92286681563069,9.622818851890887 59.96756611204794,9.711989902537445 59.971178538038224,9.719125123324654 59.92647277831688,9.630072991451103 59.92286681563069)))"
22050006655000,167,80,87,45.9,"MULTIPOLYGON(((9.719125123324654 59.92647277831688,9.711989902537445 59.971178538038224,9.801183437302274 59.97473084625021,9.808199640313426 59.93001872941525,9.719125123324654 59.92647277831688)))"
22100006655000,250,127,123,47.8,"MULTIPOLYGON(((9.808199640313426 59.93001872941525,9.801183437302274 59.97473084625021,9.890399086563864 59.97822300663218,9.897296174389249 59.933504638996475,9.808199640313426 59.93001872941525)))"
22150006655000,1618,824,794,41.1,"MULTIPOLYGON(((9.897296174389249 59.933504638996475,9.890399086563864 59.97822300663218,9.97963648012132 59.98165498962782,9.986414356948822 59.93693047762462,9.897296174389249 59.933504638996475)))"
22200006655000,3067,1481,1586,47.1,"MULTIPOLYGON(((9.986414356948822 59.93693047762462,9.97963648012132 59.98165498962782,10.06889524720364 59.98502676617706,10.07555381882293 59.940296216358036,9.986414356948822 59.93693047762462)))"
22300006655000,12,10,2,42.8,"MULTIPOLYGON(((10.164714190285633 59.943601826750424,10.158175016478987 59.988338307717115,10.24747541606404 59.99158958618333,10.253895101063565 59.94684728085161,10.164714190285633 59.943601826750424)))"
22350006655000,75,44,31,47.9,"MULTIPOLYGON(((10.253895101063565 59.94684728085161,10.24747541606404 59.99158958618333,10.336796073533346 59.99478057401005,10.343096180345222 59.950032551208366,10.253895101063565 59.94684728085161)))"
22400006655000,359,218,141,46.1,"MULTIPOLYGON(((10.343096180345222 59.950032551208366,10.336796073533346 59.99478057401005,10.426136615928732 59.99791124413148,10.432317056790302 59.95315761086549,10.343096180345222 59.950032551208366)))"
22450006655000,3534,1840,1694,36.2,"MULTIPOLYGON(((10.432317056790302 59.95315761086549,10.426136615928732 59.99791124413148,10.515496669768735 60.00098156998267,10.521557358539056 59.956222433366435,10.432317056790302 59.95315761086549)))"
22500006655000,14,8,6,53.4,"MULTIPOLYGON(((10.521557358539056 59.956222433366435,10.515496669768735 60.00098156998267,10.604875861058082 60.00399152550016,10.610816713221721 59.95922699275428,10.521557358539056 59.956222433366435)))"
22550006655000,8756,4317,4439,41,"MULTIPOLYGON(((10.610816713221721 59.95922699275428,10.604875861058082 60.00399152550016,10.694273815297198 60.00694108512297,10.700094747967945 59.962171263572486,10.610816713221721 59.95922699275428)))"
22600006655000,7226,3560,3666,34.4,"MULTIPOLYGON(((10.700094747967945 59.962171263572486,10.694273815297198 60.00694108512297,10.783690157491732 60.0098302237933,10.78939108941624 59.96505522086577,10.700094747967945 59.962171263572486)))"
22650006655000,1902,978,924,38.4,"MULTIPOLYGON(((10.78939108941624 59.96505522086577,10.783690157491732 60.0098302237933,10.873124512162132 60.01265891695745,10.878705363723517 59.96787884018079,10.78939108941624 59.96505522086577)))"
22700006655000,16713,8398,8315,39.4,"MULTIPOLYGON(((10.878705363723517 59.96787884018079,10.873124512162132 60.01265891695745,10.962576503353263 60.01542714056642,10.968037196574599 59.970642097567016,10.878705363723517 59.96787884018079)))"
22750006655000,17733,9012,8721,38,"MULTIPOLYGON(((10.968037196574599 59.970642097567016,10.962576503353263 60.01542714056642,11.05204575464403 60.0181348710769,11.057386213191783 59.97334496957744,10.968037196574599 59.970642097567016)))"
22800006655000,2057,1053,1004,39.4,"MULTIPOLYGON(((11.057386213191783 59.97334496957744,11.05204575464403 60.0181348710769,11.141531889157033 60.02078208545179,11.146752038344452 59.97598743326936,11.057386213191783 59.97334496957744)))"
22850006655000,3456,1811,1645,36.2,"MULTIPOLYGON(((11.146752038344452 59.97598743326936,11.141531889157033 60.02078208545179,11.231034529568289 60.02336876116113,11.23613429635868 59.97856946620508,11.146752038344452 59.97598743326936)))"
22900006655000,4322,2147,2175,42,"MULTIPOLYGON(((11.23613429635868 59.97856946620508,11.231034529568289 60.02336876116113,11.320553298116922 60.0258948761827,11.325532611126903 59.9810910464526,11.23613429635868 59.97856946620508)))"
22950006655000,925,461,464,41.1,"MULTIPOLYGON(((11.325532611126903 59.9810910464526,11.320553298116922 60.0258948761827,11.410087816614954 60.02836040900274,11.414946606117601 59.983552152586334,11.325532611126903 59.9810910464526)))"
23000006655000,45,24,21,34.7,"MULTIPOLYGON(((11.414946606117601 59.983552152586334,11.410087816614954 60.02836040900274,11.499637706457063 60.03076533861665,11.504375904384998 59.98595276368783,11.414946606117601 59.983552152586334)))"
23050006655000,26,16,10,41.2,"MULTIPOLYGON(((11.504375904384998 59.98595276368783,11.499637706457063 60.03076533861665,11.589202588630402 60.03310964452971,11.593820128578804 59.98829285934641,11.504375904384998 59.98595276368783)))"
23150006655000,20,9,11,47.4,"MULTIPOLYGON(((11.683278900953985 59.990572419659784,11.678782083724425 60.03539330675763,11.768375811940766 60.037616305827285,11.772751843380552 59.99279142523473,11.683278900953985 59.990572419659784)))"
23250006655000,7,3,4,42.4,"MULTIPOLYGON(((11.862238577353375 59.99494985718766,11.857983393103115 60.03977862277727,11.947604446667144 60.04188023915857,11.951738724002027 59.99704769714536,11.862238577353375 59.99494985718766)))"
23300006655000,8,3,5,49.1,"MULTIPOLYGON(((11.951738724002027 59.99704769714536,11.947604446667144 60.04188023915857,12.037238591730429 60.04392113703508,12.041251904100644 59.99908492724538,11.951738724002027 59.99704769714536)))"
23350006655000,502,255,247,43.6,"MULTIPOLYGON(((12.041251904100644 59.99908492724538,12.037238591730429 60.04392113703508,12.126885447042424 60.045901298984234,12.130777738077828 60.00106153013672,12.041251904100644 59.99908492724538)))"
23400006655000,135,72,63,48.3,"MULTIPOLYGON(((12.130777738077828 60.00106153013672,12.126885447042424 60.045901298984234,12.216544631014447 60.04782070809756,12.220315846026542 60.002977488980385,12.130777738077828 60.00106153013672)))"
23450006655000,52,28,24,44.7,"MULTIPOLYGON(((12.220315846026542 60.002977488980385,12.216544631014447 60.04782070809756,12.30621576172968 60.049679347981204,12.309865847714054 60.00483278744993,12.220315846026542 60.002977488980385)))"
23500006655000,130,67,63,46,"MULTIPOLYGON(((12.309865847714054 60.00483278744993,12.30621576172968 60.049679347981204,12.395898456953207 60.05147720275642,12.399427362591892 60.006627409731855,12.309865847714054 60.00483278744993)))"
23550006655000,6,2,4,40.2,"MULTIPOLYGON(((12.399427362591892 60.006627409731855,12.395898456953207 60.05147720275642,12.48559233414206 60.05321425706018,12.489000009805814 60.008361340526356,12.399427362591892 60.006627409731855)))"
19450006660000,57,31,26,44.6,"MULTIPOLYGON(((5.113353876708034 59.704473161398624,5.100161231553588 59.74870341078225,5.187824031546786 59.75534243781212,5.200904473041017 59.711100484927925,5.113353876708034 59.704473161398624)))"
19500006660000,719,370,349,39.4,"MULTIPOLYGON(((5.200904473041017 59.711100484927925,5.187824031546786 59.75534243781212,5.275527369010797 59.76192341253545,5.288495432629029 59.717669853907786,5.200904473041017 59.711100484927925)))"
19550006660000,435,222,213,40.1,"MULTIPOLYGON(((5.288495432629029 59.717669853907786,5.275527369010797 59.76192341253545,5.363270913809419 59.76844628098349,5.376126426642076 59.72418121458239,5.288495432629029 59.717669853907786)))"
19600006660000,2299,1178,1121,33.8,"MULTIPOLYGON(((5.376126426642076 59.72418121458239,5.363270913809419 59.76844628098349,5.451054334808796 59.77491098961902,5.463797125259612 59.730634513625915,5.376126426642076 59.72418121458239)))"
19650006660000,5188,2713,2475,39.6,"MULTIPOLYGON(((5.463797125259612 59.730634513625915,5.451054334808796 59.77491098961902,5.538877299884216 59.781317485337915,5.551507197677224 59.73702969814413,5.463797125259612 59.730634513625915)))"
19750006660000,274,129,145,42.1,"MULTIPOLYGON(((5.639256312113461 59.74336671567587,5.626739475926953 59.78766571547069,5.714640528851142 59.793955627784115,5.727044135816679 59.74964551419466,5.639256312113461 59.74336671567587)))"
19800006660000,725,355,370,43.7,"MULTIPOLYGON(((5.727044135816679 59.74964551419466,5.714640528851142 59.793955627784115,5.802580123600739 59.8001871704828,5.814870335071939 59.755866042110306,5.727044135816679 59.74964551419466)))"
19850006660000,221,116,105,41.9,"MULTIPOLYGON(((5.814870335071939 59.755866042110306,5.802580123600739 59.8001871704828,5.890557924156537 59.80636029221063,5.902734575207967 59.76202824827035,5.814870335071939 59.755866042110306)))"
19900006660000,123,66,57,45.8,"MULTIPOLYGON(((5.902734575207967 59.76202824827035,5.890557924156537 59.80636029221063,5.978573593543221 59.812474942052425,5.990636520604206 59.768132081961596,5.902734575207967 59.76202824827035)))"
19950006660000,6,3,3,62.7,"MULTIPOLYGON(((5.990636520604206 59.768132081961596,5.978573593543221 59.812474942052425,6.066626793836496 59.818531069535446,6.078575834697875 59.77417749291178,5.990636520604206 59.768132081961596)))"
20000006660000,103,52,51,47.3,"MULTIPOLYGON(((6.078575834697875 59.77417749291178,6.066626793836496 59.818531069535446,6.15471718617029 59.8245286246308,6.166552179991116 59.78016443129084,6.078575834697875 59.77417749291178)))"
20050006660000,67,35,32,48.1,"MULTIPOLYGON(((6.166552179991116 59.78016443129084,6.15471718617029 59.8245286246308,6.242844430743967 59.83046755775509,6.254565218058183 59.78609284771258,6.166552179991116 59.78016443129084)))"
20100006660000,2,1,1,0,"MULTIPOLYGON(((6.254565218058183 59.78609284771258,6.242844430743967 59.83046755775509,6.33100818682965 59.83634781977185,6.342614609552703 59.79196269323614,6.254565218058183 59.78609284771258)))"
20400006660000,357,180,177,46.8,"MULTIPOLYGON(((6.783394927795722 59.820431675805345,6.772362650486224 59.86486737493699,6.860738269366253 59.87039460365603,6.871655262953877 59.82594909330201,6.783394927795722 59.820431675805345)))"
20450006660000,3,2,1,0,"MULTIPOLYGON(((6.871655262953877 59.82594909330201,6.860738269366253 59.87039460365603,6.949147989325024 59.875862829949334,6.959949550958218 59.83140760990493,6.871655262953877 59.82594909330201)))"
21000006660000,1,0,1,0,"MULTIPOLYGON(((7.844683203998503 59.88274348281899,7.835043796474865 59.92729017627831,7.923805483395037 59.932106474159475,7.933327924302255 59.88755119950538,7.844683203998503 59.88274348281899)))"
21100006660000,12,5,7,46.9,"MULTIPOLYGON(((8.022002385580917 59.892299501913016,8.012597041933159 59.93686325415863,8.101418114433887 59.94156047637352,8.110706231682585 59.8969883503006,8.022002385580917 59.892299501913016)))"
21500006660000,36,20,16,45.1,"MULTIPOLYGON(((8.732425856066667 59.928142337974144,8.723961812085458 59.97277016229867,8.81300603111216 59.97698954307694,8.821351870352364 59.932354180615235,8.732425856066667 59.928142337974144)))"
21550006660000,31,15,16,54.8,"MULTIPOLYGON(((8.821351870352364 59.932354180615235,8.81300603111216 59.97698954307694,8.90207651196441 59.98114902849399,8.910304031096715 59.93650623302549,8.821351870352364 59.932354180615235)))"
21800006660000,249,121,128,46.9,"MULTIPOLYGON(((9.266366862124137 59.95251584862326,9.25861374589707 59.997187321995135,9.347810049268267 60.001046813963875,9.355444291991935 59.95636843533532,9.266366862124137 59.95251584862326)))"
21900006660000,34,16,18,37.8,"MULTIPOLYGON(((9.444545678486454 59.960161029410635,9.437030415223845 60.00484620733962,9.526274474966872 60.00858546996787,9.533670654395511 59.963893598825535,9.444545678486454 59.960161029410635)))"
21950006660000,30,16,14,45.1,"MULTIPOLYGON(((9.533670654395511 59.963893598825535,9.526274474966872 60.00858546996787,9.615541859079853 60.012264570187504,9.622818851890887 59.96756611204794,9.533670654395511 59.963893598825535)))"
22000006660000,10,7,3,41,"MULTIPOLYGON(((9.622818851890887 59.96756611204794,9.615541859079853 60.012264570187504,9.704832197533868 60.015883476831974,9.711989902537445 59.971178538038224,9.622818851890887 59.96756611204794)))"
22050006660000,559,305,254,42.3,"MULTIPOLYGON(((9.711989902537445 59.971178538038224,9.704832197533868 60.015883476831974,9.7941451196978 60.01944215923003,9.801183437302274 59.97473084625021,9.711989902537445 59.971178538038224)))"
22100006660000,176,93,83,45.6,"MULTIPOLYGON(((9.801183437302274 59.97473084625021,9.7941451196978 60.01944215923003,9.883480254347585 60.022940587206946,9.890399086563864 59.97822300663218,9.801183437302274 59.97473084625021)))"
22150006660000,670,328,342,39.4,"MULTIPOLYGON(((9.890399086563864 59.97822300663218,9.883480254347585 60.022940587206946,9.972837229675477 60.02637873108524,9.97963648012132 59.98165498962782,9.890399086563864 59.97822300663218)))"
22200006660000,644,342,302,42.3,"MULTIPOLYGON(((9.97963648012132 59.98165498962782,9.972837229675477 60.02637873108524,10.062215673299399 60.02975656168579,10.06889524720364 59.98502676617706,9.97963648012132 59.98165498962782)))"
22250006660000,123,72,51,44.7,"MULTIPOLYGON(((10.06889524720364 59.98502676617706,10.062215673299399 60.02975656168579,10.151615212272278 60.03307405032865,10.158175016478987 59.988338307717115,10.06889524720364 59.98502676617706)))"
22300006660000,28,13,15,44.4,"MULTIPOLYGON(((10.158175016478987 59.988338307717115,10.151615212272278 60.03307405032865,10.24103547309147 60.036331168834046,10.24747541606404 59.99158958618333,10.158175016478987 59.988338307717115)))"
22350006660000,275,149,126,46.1,"MULTIPOLYGON(((10.24747541606404 59.99158958618333,10.24103547309147 60.036331168834046,10.330476081708172 60.0395278895232,10.336796073533346 59.99478057401005,10.24747541606404 59.99158958618333)))"
22400006660000,8,3,5,38.5,"MULTIPOLYGON(((10.336796073533346 59.99478057401005,10.330476081708172 60.0395278895232,10.419936663536905 60.0426641852192,10.426136615928732 59.99791124413148,10.336796073533346 59.99478057401005)))"
22450006660000,14,6,8,37.8,"MULTIPOLYGON(((10.426136615928732 59.99791124413148,10.419936663536905 60.0426641852192,10.509416843465011 60.04574002924794,10.515496669768735 60.00098156998267,10.426136615928732 59.99791124413148)))"
22500006660000,179,96,83,45.4,"MULTIPOLYGON(((10.515496669768735 60.00098156998267,10.509416843465011 60.04574002924794,10.598916245862215 60.04875539543892,10.604875861058082 60.00399152550016,10.515496669768735 60.00098156998267)))"
22550006660000,259,127,132,44.7,"MULTIPOLYGON(((10.604875861058082 60.00399152550016,10.598916245862215 60.04875539543892,10.688434494590169 60.05171025812601,10.694273815297198 60.00694108512297,10.604875861058082 60.00399152550016)))"
22600006660000,135,66,69,41.7,"MULTIPOLYGON(((10.694273815297198 60.00694108512297,10.688434494590169 60.05171025812601,10.77797121301208 60.05460459214846,10.783690157491732 60.0098302237933,10.694273815297198 60.00694108512297)))"
22650006660000,3500,1745,1755,35.3,"MULTIPOLYGON(((10.783690157491732 60.0098302237933,10.77797121301208 60.05460459214846,10.867526024002352 60.05743837285149,10.873124512162132 60.01265891695745,10.783690157491732 60.0098302237933)))"
22700006660000,4148,2042,2106,41.1,"MULTIPOLYGON(((10.873124512162132 60.01265891695745,10.867526024002352 60.05743837285149,10.957098549956246 60.06021157608716,10.962576503353263 60.01542714056642,10.873124512162132 60.01265891695745)))"
22750006660000,803,418,385,38.7,"MULTIPOLYGON(((10.962576503353263 60.01542714056642,10.957098549956246 60.06021157608716,11.046688412799602 60.06292417821523,11.05204575464403 60.0181348710769,10.962576503353263 60.01542714056642)))"
22800006660000,7276,3763,3513,36.6,"MULTIPOLYGON(((11.05204575464403 60.0181348710769,11.046688412799602 60.06292417821523,11.136295233998558 60.06557615610374,11.141531889157033 60.02078208545179,11.05204575464403 60.0181348710769)))"
22850006660000,770,421,349,39.7,"MULTIPOLYGON(((11.141531889157033 60.02078208545179,11.136295233998558 60.06557615610374,11.225918634569323 60.0681674871299,11.231034529568289 60.02336876116113,11.141531889157033 60.02078208545179)))"
22900006660000,317,172,145,40.9,"MULTIPOLYGON(((11.231034529568289 60.02336876116113,11.225918634569323 60.0681674871299,11.31555823508798 60.07069814918073,11.320553298116922 60.0258948761827,11.231034529568289 60.02336876116113)))"
22950006660000,3982,2026,1956,38.9,"MULTIPOLYGON(((11.320553298116922 60.0258948761827,11.31555823508798 60.07069814918073,11.405213655700306 60.0731681206538,11.410087816614954 60.02836040900274,11.320553298116922 60.0258948761827)))"
23000006660000,245,131,114,41.4,"MULTIPOLYGON(((11.410087816614954 60.02836040900274,11.405213655700306 60.0731681206538,11.49488451613162 60.075577380457894,11.499637706457063 60.03076533861665,11.410087816614954 60.02836040900274)))"
23050006660000,4,2,2,0,"MULTIPOLYGON(((11.499637706457063 60.03076533861665,11.49488451613162 60.075577380457894,11.584570435696673 60.07792590801371,11.589202588630402 60.03310964452971,11.499637706457063 60.03076533861665)))"
23100006660000,12,4,8,43.7,"MULTIPOLYGON(((11.589202588630402 60.03310964452971,11.584570435696673 60.07792590801371,11.674271033309555 60.08021368325456,11.678782083724425 60.03539330675763,11.589202588630402 60.03310964452971)))"
23150006660000,21,10,11,37.2,"MULTIPOLYGON(((11.678782083724425 60.03539330675763,11.674271033309555 60.08021368325456,11.76398592749363 60.08244068662692,11.768375811940766 60.037616305827285,11.678782083724425 60.03539330675763)))"
23200006660000,9,7,2,47,"MULTIPOLYGON(((11.768375811940766 60.037616305827285,11.76398592749363 60.08244068662692,11.8537147363915 60.08460689909109,11.857983393103115 60.03977862277727,11.768375811940766 60.037616305827285)))"
23250006660000,1,1,0,0,"MULTIPOLYGON(((11.857983393103115 60.03977862277727,11.8537147363915 60.08460689909109,11.943457077774985 60.086712302121846,11.947604446667144 60.04188023915857,11.857983393103115 60.03977862277727)))"
23300006660000,25,12,13,46.2,"MULTIPOLYGON(((11.947604446667144 60.04188023915857,11.943457077774985 60.086712302121846,12.033212569055143 60.08875687770903,12.037238591730429 60.04392113703508,11.947604446667144 60.04188023915857)))"
23350006660000,94,53,41,44.1,"MULTIPOLYGON(((12.037238591730429 60.04392113703508,12.033212569055143 60.08875687770903,12.1229808272923 60.09074060835808,12.126885447042424 60.045901298984234,12.037238591730429 60.04392113703508)))"
23400006660000,118,65,53,46.5,"MULTIPOLYGON(((12.126885447042424 60.045901298984234,12.1229808272923 60.09074060835808,12.21276146920612 60.09266347709062,12.216544631014447 60.04782070809756,12.126885447042424 60.045901298984234)))"
23450006660000,49,26,23,57,"MULTIPOLYGON(((12.216544631014447 60.04782070809756,12.21276146920612 60.09266347709062,12.30255411118567 60.094525467445024,12.30621576172968 60.049679347981204,12.216544631014447 60.04782070809756)))"
23500006660000,140,75,65,45.9,"MULTIPOLYGON(((12.30621576172968 60.049679347981204,12.30255411118567 60.094525467445024,12.392358369299535 60.09632656347689,12.395898456953207 60.05147720275642,12.30621576172968 60.049679347981204)))"
23550006660000,7,4,3,39,"MULTIPOLYGON(((12.395898456953207 60.05147720275642,12.392358369299535 60.09632656347689,12.482173859305943 60.09806674975965,12.48559233414206 60.05321425706018,12.395898456953207 60.05147720275642)))"
23600006660000,3,2,1,0,"MULTIPOLYGON(((12.48559233414206 60.05321425706018,12.482173859305943 60.09806674975965,12.572000196662911 60.09974601138498,12.575297010455289 60.05489049604558,12.48559233414206 60.05321425706018)))"
19450006665000,2565,1338,1227,38.5,"MULTIPOLYGON(((5.100161231553588 59.74870341078225,5.086927719627948 59.79293158090566,5.174703052414336 59.79958234191829,5.187824031546786 59.75534243781212,5.100161231553588 59.74870341078225)))"
19500006665000,1898,964,934,38.4,"MULTIPOLYGON(((5.187824031546786 59.75534243781212,5.174703052414336 59.79958234191829,5.262519097891698 59.80617495263711,5.275527369010797 59.76192341253545,5.187824031546786 59.75534243781212)))"
19550006665000,549,298,251,43.4,"MULTIPOLYGON(((5.275527369010797 59.76192341253545,5.262519097891698 59.80617495263711,5.350375524610872 59.812709358879296,5.363270913809419 59.76844628098349,5.275527369010797 59.76192341253545)))"
19600006665000,3117,1632,1485,39.6,"MULTIPOLYGON(((5.363270913809419 59.76844628098349,5.350375524610872 59.812709358879296,5.438272000117934 59.81918550689507,5.451054334808796 59.77491098961902,5.363270913809419 59.76844628098349)))"
19650006665000,7846,3882,3964,41.7,"MULTIPOLYGON(((5.451054334808796 59.77491098961902,5.438272000117934 59.81918550689507,5.526208190961046 59.82560334336926,5.538877299884216 59.781317485337915,5.451054334808796 59.77491098961902)))"
19700006665000,209,99,110,42.4,"MULTIPOLYGON(((5.538877299884216 59.781317485337915,5.526208190961046 59.82560334336926,5.614183762697296 59.83196281542297,5.626739475926953 59.78766571547069,5.538877299884216 59.781317485337915)))"
19750006665000,696,350,346,41.6,"MULTIPOLYGON(((5.626739475926953 59.78766571547069,5.614183762697296 59.83196281542297,5.702198379899666 59.83826387061501,5.714640528851142 59.793955627784115,5.626739475926953 59.78766571547069)))"
19800006665000,2037,1047,990,40.2,"MULTIPOLYGON(((5.714640528851142 59.793955627784115,5.702198379899666 59.83826387061501,5.790251706163998 59.84450645694368,5.802580123600739 59.8001871704828,5.714640528851142 59.793955627784115)))"
19850006665000,356,188,168,38.3,"MULTIPOLYGON(((5.802580123600739 59.8001871704828,5.790251706163998 59.84450645694368,5.878343404116063 59.85069052284814,5.890557924156537 59.80636029221063,5.802580123600739 59.8001871704828)))"
19950006665000,62,32,30,42.4,"MULTIPOLYGON(((5.978573593543221 59.812474942052425,5.966473135418672 59.85681601721004,6.054640560778848 59.86288288935507,6.066626793836496 59.818531069535446,5.978573593543221 59.812474942052425)))"
20100006665000,4,3,1,0,"MULTIPOLYGON(((6.242844430743967 59.83046755775509,6.231087131764439 59.87484056652647,6.319365594090288 59.88073127243803,6.33100818682965 59.83634781977185,6.242844430743967 59.83046755775509)))"
20150006665000,28,13,15,55,"MULTIPOLYGON(((6.33100818682965 59.83634781977185,6.319365594090288 59.88073127243803,6.407680383889321 59.88656315790597,6.419208112779557 59.84216936199303,6.33100818682965 59.83634781977185)))"
20200006665000,21,11,10,57,"MULTIPOLYGON(((6.419208112779557 59.84216936199303,6.407680383889321 59.88656315790597,6.496031157199194 59.892336174498794,6.507443866033433 59.84793213618042,6.419208112779557 59.84216936199303)))"
20300006665000,4,1,3,0,"MULTIPOLYGON(((6.595715103125998 59.85363609454721,6.584417569146016 59.89805027423796,6.672839273951917 59.9037054095994,6.684021479694487 59.859281189759336,6.595715103125998 59.85363609454721)))"
21050006665000,2,1,1,0,"MULTIPOLYGON(((7.923805483395037 59.932106474159475,7.914253170741564 59.97666052532612,8.003162184195894 59.98142580549481,8.012597041933159 59.93686325415863,7.923805483395037 59.932106474159475)))"
21450006665000,115,64,51,46.6,"MULTIPOLYGON(((8.634944219083927 59.9684909217387,8.626335097630438 60.01311005264915,8.715471141963667 60.01739695677787,8.723961812085458 59.97277016229867,8.634944219083927 59.9684909217387)))"
21500006665000,358,181,177,45.3,"MULTIPOLYGON(((8.723961812085458 59.97277016229867,8.715471141963667 60.01739695677787,8.804633929932482 60.0216238958684,8.81300603111216 59.97698954307694,8.723961812085458 59.97277016229867)))"
21550006665000,594,277,317,46.5,"MULTIPOLYGON(((8.81300603111216 59.97698954307694,8.804633929932482 60.0216238958684,8.893823095777336 60.02579083419609,8.90207651196441 59.98114902849399,8.81300603111216 59.97698954307694)))"
21700006665000,43,25,18,52.2,"MULTIPOLYGON(((9.080294798937915 59.98928817335784,9.072279094622722 60.03394456810544,9.161545192696785 60.03793129468206,9.169441873277476 59.993267764080336,9.080294798937915 59.98928817335784)))"
21750006665000,231,122,109,46,"MULTIPOLYGON(((9.169441873277476 59.993267764080336,9.161545192696785 60.03793129468206,9.250836198811939 60.04185788248797,9.25861374589707 59.997187321995135,9.169441873277476 59.993267764080336)))"
21800006665000,115,64,51,44,"MULTIPOLYGON(((9.25861374589707 59.997187321995135,9.250836198811939 60.04185788248797,9.340151743855268 60.04572429824928,9.347810049268267 60.001046813963875,9.25861374589707 59.997187321995135)))"
21900006665000,20,13,7,43.3,"MULTIPOLYGON(((9.437030415223845 60.00484620733962,9.429491458070348 60.04953050918546,9.518854971066384 60.05327648301035,9.526274474966872 60.00858546996787,9.437030415223845 60.00484620733962)))"
21950006665000,244,120,124,44.6,"MULTIPOLYGON(((9.526274474966872 60.00858546996787,9.518854971066384 60.05327648301035,9.608241911827418 60.05696218793319,9.615541859079853 60.012264570187504,9.526274474966872 60.00858546996787)))"
22000006665000,838,414,424,46.2,"MULTIPOLYGON(((9.615541859079853 60.012264570187504,9.608241911827418 60.05696218793319,9.697651908721545 60.06058759265966,9.704832197533868 60.015883476831974,9.615541859079853 60.012264570187504)))"
22050006665000,86,43,43,47.8,"MULTIPOLYGON(((9.704832197533868 60.015883476831974,9.697651908721545 60.06058759265966,9.787084589510203 60.06415266639283,9.7941451196978 60.01944215923003,9.704832197533868 60.015883476831974)))"
22100006665000,201,107,94,43.9,"MULTIPOLYGON(((9.7941451196978 60.01944215923003,9.787084589510203 60.06415266639283,9.876539581357475 60.06765737883414,9.883480254347585 60.022940587206946,9.7941451196978 60.01944215923003)))"
22150006665000,25,13,12,40.4,"MULTIPOLYGON(((9.883480254347585 60.022940587206946,9.876539581357475 60.06765737883414,9.966016510839447 60.07110170018437,9.972837229675477 60.02637873108524,9.883480254347585 60.022940587206946)))"
22200006665000,762,392,370,44.3,"MULTIPOLYGON(((9.972837229675477 60.02637873108524,9.966016510839447 60.07110170018437,10.055515003953603 60.074485601144595,10.062215673299399 60.02975656168579,9.972837229675477 60.02637873108524)))"
22250006665000,157,77,80,46.1,"MULTIPOLYGON(((10.062215673299399 60.02975656168579,10.055515003953603 60.074485601144595,10.14503468612824 60.07780905291709,10.151615212272278 60.03307405032865,10.062215673299399 60.02975656168579)))"
22300006665000,834,436,398,43.6,"MULTIPOLYGON(((10.151615212272278 60.03307405032865,10.14503468612824 60.07780905291709,10.234575182231948 60.081072027206254,10.24103547309147 60.036331168834046,10.151615212272278 60.03307405032865)))"
22350006665000,2401,1173,1228,42.6,"MULTIPOLYGON(((10.24103547309147 60.036331168834046,10.234575182231948 60.081072027206254,10.324136116583107 60.08427449621953,10.330476081708172 60.0395278895232,10.24103547309147 60.036331168834046)))"
22400006665000,110,61,49,41.5,"MULTIPOLYGON(((10.330476081708172 60.0395278895232,10.324136116583107 60.08427449621953,10.413717112959427 60.087416432668284,10.419936663536905 60.0426641852192,10.330476081708172 60.0395278895232)))"
22550006665000,2,1,1,0,"MULTIPOLYGON(((10.598916245862215 60.04875539543892,10.59293778425252 60.09351860124238,10.682576704107708 60.09647878131773,10.688434494590169 60.05171025812601,10.598916245862215 60.04875539543892)))"
22650006665000,1668,862,806,39.5,"MULTIPOLYGON(((10.77797121301208 60.05460459214846,10.772234175884215 60.09937832473028,10.861909820800708 60.102217206723665,10.867526024002352 60.05743837285149,10.77797121301208 60.05460459214846)))"
22700006665000,2449,1256,1193,38.4,"MULTIPOLYGON(((10.867526024002352 60.05743837285149,10.861909820800708 60.102217206723665,10.951603259593155 60.104995403050445,10.957098549956246 60.06021157608716,10.867526024002352 60.05743837285149)))"
22750006665000,6015,3103,2912,40.8,"MULTIPOLYGON(((10.957098549956246 60.06021157608716,10.951603259593155 60.104995403050445,11.041314112524589 60.10771288997284,11.046688412799602 60.06292417821523,10.957098549956246 60.06021157608716)))"
22800006665000,4568,2356,2212,36.7,"MULTIPOLYGON(((11.046688412799602 60.06292417821523,11.041314112524589 60.10771288997284,11.131041999394911 60.1103696442635,11.136295233998558 60.06557615610374,11.046688412799602 60.06292417821523)))"
22850006665000,5688,2843,2845,37.8,"MULTIPOLYGON(((11.136295233998558 60.06557615610374,11.131041999394911 60.1103696442635,11.22078653955075 60.11296564320628,11.225918634569323 60.0681674871299,11.136295233998558 60.06557615610374)))"
22900006665000,360,197,163,45.1,"MULTIPOLYGON(((11.225918634569323 60.0681674871299,11.22078653955075 60.11296564320628,11.310547351895298 60.11550086459694,11.31555823508798 60.07069814918073,11.225918634569323 60.0681674871299)))"
22950006665000,1370,679,691,37.8,"MULTIPOLYGON(((11.31555823508798 60.07069814918073,11.310547351895298 60.11550086459694,11.40032405489824 60.11797528674384,11.405213655700306 60.0731681206538,11.31555823508798 60.07069814918073)))"
23000006665000,4591,2258,2333,41.8,"MULTIPOLYGON(((11.405213655700306 60.0731681206538,11.40032405489824 60.11797528674384,11.490116266605659 60.120388888468646,11.49488451613162 60.075577380457894,11.405213655700306 60.0731681206538)))"
23050006665000,711,387,324,40.2,"MULTIPOLYGON(((11.49488451613162 60.075577380457894,11.490116266605659 60.120388888468646,11.579923604649993 60.12274164910706,11.584570435696673 60.07792590801371,11.49488451613162 60.075577380457894)))"
23100006665000,42,21,21,55.6,"MULTIPOLYGON(((11.584570435696673 60.07792590801371,11.579923604649993 60.12274164910706,11.669745686260033 60.12503354850941,11.674271033309555 60.08021368325456,11.584570435696673 60.07792590801371)))"
23150006665000,28,14,14,57.3,"MULTIPOLYGON(((11.674271033309555 60.08021368325456,11.669745686260033 60.12503354850941,11.759582128270909 60.12726456704131,11.76398592749363 60.08244068662692,11.674271033309555 60.08021368325456)))"
23200006665000,47,23,24,58.6,"MULTIPOLYGON(((11.76398592749363 60.08244068662692,11.759582128270909 60.12726456704131,11.84943254713414 60.1294346855844,11.8537147363915 60.08460689909109,11.76398592749363 60.08244068662692)))"
23300006665000,36,21,15,50.3,"MULTIPOLYGON(((11.943457077774985 60.086712302121846,11.939296558927696 60.13154388553682,12.029173779366076 60.13359214881383,12.033212569055143 60.08875687770903,11.943457077774985 60.086712302121846)))"
23350006665000,467,243,224,44.1,"MULTIPOLYGON(((12.033212569055143 60.08875687770903,12.029173779366076 60.13359214881383,12.11906382381042 60.13557945784853,12.1229808272923 60.09074060835808,12.033212569055143 60.08875687770903)))"
23400006665000,54,30,24,47.8,"MULTIPOLYGON(((12.1229808272923 60.09074060835808,12.11906382381042 60.13557945784853,12.208966307278649 60.1375057955922,12.21276146920612 60.09266347709062,12.1229808272923 60.09074060835808)))"
23450006665000,102,50,52,44.9,"MULTIPOLYGON(((12.21276146920612 60.09266347709062,12.208966307278649 60.1375057955922,12.298880844455615 60.13937114551504,12.30255411118567 60.094525467445024,12.21276146920612 60.09266347709062)))"
23500006665000,352,185,167,48.9,"MULTIPOLYGON(((12.30255411118567 60.094525467445024,12.298880844455615 60.13937114551504,12.38880704970328 60.14117549160669,12.392358369299535 60.09632656347689,12.30255411118567 60.094525467445024)))"
23550006665000,65,34,31,53.4,"MULTIPOLYGON(((12.392358369299535 60.09632656347689,12.38880704970328 60.14117549160669,12.478744537070925 60.14291881837659,12.482173859305943 60.09806674975965,12.392358369299535 60.09632656347689)))"
19450006670000,858,437,421,39,"MULTIPOLYGON(((5.086927719627948 59.79293158090566,5.073653164403954 59.837157664188744,5.161541360422321 59.8438201897978,5.174703052414336 59.79958234191829,5.086927719627948 59.79293158090566)))"
19500006670000,923,482,441,37.5,"MULTIPOLYGON(((5.174703052414336 59.79958234191829,5.161541360422321 59.8438201897978,5.249470445363326 59.85042446689479,5.262519097891698 59.80617495263711,5.174703052414336 59.79958234191829)))"
19550006670000,1032,519,513,40.3,"MULTIPOLYGON(((5.262519097891698 59.80617495263711,5.249470445363326 59.85042446689479,5.337440086458099 59.85697044108165,5.350375524610872 59.812709358879296,5.262519097891698 59.80617495263711)))"
19650006670000,113,63,50,47.9,"MULTIPOLYGON(((5.438272000117934 59.81918550689507,5.425449949925846 59.86345805839482,5.513499700980703 59.869887265306986,5.526208190961046 59.82560334336926,5.438272000117934 59.81918550689507)))"
19700006670000,224,112,112,45.5,"MULTIPOLYGON(((5.526208190961046 59.82560334336926,5.513499700980703 59.869887265306986,5.601589003838663 59.87625800872861,5.614183762697296 59.83196281542297,5.526208190961046 59.82560334336926)))"
19750006670000,16,9,7,48.9,"MULTIPOLYGON(((5.614183762697296 59.83196281542297,5.601589003838663 59.87625800872861,5.68971752172454 59.882570236009514,5.702198379899666 59.83826387061501,5.614183762697296 59.83196281542297)))"
19800006670000,3027,1504,1523,42.5,"MULTIPOLYGON(((5.702198379899666 59.83826387061501,5.68971752172454 59.882570236009514,5.77788491687902 59.88882389494046,5.790251706163998 59.84450645694368,5.702198379899666 59.83826387061501)))"
19900006670000,15,8,7,36.4,"MULTIPOLYGON(((5.878343404116063 59.85069052284814,5.86609085056574 59.89501893375475,5.954334983078468 59.901155301129776,5.966473135418672 59.85681601721004,5.878343404116063 59.85069052284814)))"
19950006670000,34,18,16,40.1,"MULTIPOLYGON(((5.966473135418672 59.85681601721004,5.954334983078468 59.901155301129776,6.042616973748299 59.907232946188564,6.054640560778848 59.86288288935507,5.966473135418672 59.85681601721004)))"
20200006670000,1,1,0,0,"MULTIPOLYGON(((6.407680383889321 59.88656315790597,6.396116671336312 59.93095530140478,6.484582809577337 59.93673858743186,6.496031157199194 59.892336174498794,6.407680383889321 59.88656315790597)))"
20250006670000,21,10,11,37.2,"MULTIPOLYGON(((6.496031157199194 59.892336174498794,6.484582809577337 59.93673858743186,6.573084742157558 59.9424628553244,6.584417569146016 59.89805027423796,6.496031157199194 59.892336174498794)))"
20300006670000,383,193,190,43.2,"MULTIPOLYGON(((6.584417569146016 59.89805027423796,6.573084742157558 59.9424628553244,6.661622121876373 59.948128057367285,6.672839273951917 59.9037054095994,6.584417569146016 59.89805027423796)))"
21050006670000,6,3,3,66.3,"MULTIPOLYGON(((7.914253170741564 59.97666052532612,7.904670854928011 60.021213349167496,7.993697682467148 60.025987152183795,8.003162184195894 59.98142580549481,7.914253170741564 59.97666052532612)))"
21450006670000,2,1,1,0,"MULTIPOLYGON(((8.626335097630438 60.01311005264915,8.61769886736161 60.057728130200694,8.706953728090033 60.06202271843478,8.715471141963667 60.01739695677787,8.626335097630438 60.01311005264915)))"
21500006670000,95,55,40,47.6,"MULTIPOLYGON(((8.715471141963667 60.01739695677787,8.706953728090033 60.06202271843478,8.79623545076199 60.06625723610265,8.804633929932482 60.0216238958684,8.715471141963667 60.01739695677787)))"
21550006670000,239,118,121,44.4,"MULTIPOLYGON(((8.804633929932482 60.0216238958684,8.79623545076199 60.06625723610265,8.88554366804912 60.07043164733373,8.893823095777336 60.02579083419609,8.804633929932482 60.0216238958684)))"
21600006670000,2,1,1,0,"MULTIPOLYGON(((8.893823095777336 60.02579083419609,8.88554366804912 60.07043164733373,8.974878011929343 60.074545916747276,8.983038273050042 60.02989773652431,8.893823095777336 60.02579083419609)))"
21650006670000,3,2,1,0,"MULTIPOLYGON(((8.983038273050042 60.02989773652431,8.974878011929343 60.074545916747276,9.064238113695867 60.07860000945365,9.072279094622722 60.03394456810544,8.983038273050042 60.02989773652431)))"
21700006670000,476,224,252,45.9,"MULTIPOLYGON(((9.072279094622722 60.03394456810544,9.064238113695867 60.07860000945365,9.153623603966228 60.08259389105517,9.161545192696785 60.03793129468206,9.072279094622722 60.03394456810544)))"
21750006670000,108,58,50,47.6,"MULTIPOLYGON(((9.161545192696785 60.03793129468206,9.153623603966228 60.08259389105517,9.243034112691369 60.08652752764739,9.250836198811939 60.04185788248797,9.161545192696785 60.03793129468206)))"
21900006670000,199,110,89,47.4,"MULTIPOLYGON(((9.429491458070348 60.04953050918546,9.421928702031696 60.09421393265852,9.511412039298245 60.09796663574398,9.518854971066384 60.05327648301035,9.429491458070348 60.04953050918546)))"
21950006670000,110,56,54,44.4,"MULTIPOLYGON(((9.518854971066384 60.05327648301035,9.511412039298245 60.09796663574398,9.600918908340777 60.10165896315536,9.608241911827418 60.05696218793319,9.518854971066384 60.05327648301035)))"
22050006670000,25,12,13,51.3,"MULTIPOLYGON(((9.697651908721545 60.06058759265966,9.69044893591513 60.10529088346989,9.780001748165983 60.10886236576415,9.787084589510203 60.06415266639283,9.697651908721545 60.06058759265966)))"
22100006670000,108,67,41,40.7,"MULTIPOLYGON(((9.787084589510203 60.06415266639283,9.780001748165983 60.10886236576415,9.869576970636222 60.11237337961512,9.876539581357475 60.06765737883414,9.787084589510203 60.06415266639283)))"
22250006670000,1637,843,794,41.6,"MULTIPOLYGON(((10.055515003953603 60.074485601144595,10.048793145454036 60.11921388280266,10.138433345963424 60.12254331380365,10.14503468612824 60.07780905291709,10.055515003953603 60.074485601144595)))"
22300006670000,858,457,401,41.6,"MULTIPOLYGON(((10.14503468612824 60.07780905291709,10.138433345963424 60.12254331380365,10.22809445303486 60.125812159692,10.234575182231948 60.081072027206254,10.14503468612824 60.07780905291709)))"
22350006670000,2405,1216,1189,39.2,"MULTIPOLYGON(((10.234575182231948 60.081072027206254,10.22809445303486 60.125812159692,10.317776089344365 60.12902039256073,10.324136116583107 60.08427449621953,10.234575182231948 60.081072027206254)))"
22400006670000,361,194,167,45.7,"MULTIPOLYGON(((10.324136116583107 60.08427449621953,10.317776089344365 60.12902039256073,10.40747787702326 60.132167985008785,10.413717112959427 60.087416432668284,10.324136116583107 60.08427449621953)))"
22450006670000,2,2,0,0,"MULTIPOLYGON(((10.413717112959427 60.087416432668284,10.40747787702326 60.132167985008785,10.497199437667817 60.13525491014193,10.503317794607522 60.090497809768635,10.413717112959427 60.087416432668284)))"
22550006670000,7,5,2,49.3,"MULTIPOLYGON(((10.59293778425252 60.09351860124238,10.586940392348938 60.1382811415736,10.67670036162186 60.141246653425775,10.682576704107708 60.09647878131773,10.59293778425252 60.09351860124238)))"
22600006670000,1,1,0,0,"MULTIPOLYGON(((10.682576704107708 60.09647878131773,10.67670036162186 60.141246653425775,10.766478965535908 60.14415142032978,10.772234175884215 60.09937832473028,10.682576704107708 60.09647878131773)))"
22650006670000,3183,1594,1589,39.7,"MULTIPOLYGON(((10.772234175884215 60.09937832473028,10.766478965535908 60.14415142032978,10.856275823644289 60.14699541742708,10.861909820800708 60.102217206723665,10.772234175884215 60.09937832473028)))"
22700006670000,825,397,428,42.1,"MULTIPOLYGON(((10.861909820800708 60.102217206723665,10.856275823644289 60.14699541742708,10.946090555013887 60.14977862037013,10.951603259593155 60.104995403050445,10.861909820800708 60.102217206723665)))"
22750006670000,2016,1025,991,34.8,"MULTIPOLYGON(((10.951603259593155 60.104995403050445,10.946090555013887 60.14977862037013,11.03592277823513 60.15250100532312,11.041314112524589 60.10771288997284,10.951603259593155 60.104995403050445)))"
22800006670000,1402,753,649,38.9,"MULTIPOLYGON(((11.041314112524589 60.10771288997284,11.03592277823513 60.15250100532312,11.12577211143185 60.15516254896271,11.131041999394911 60.1103696442635,11.041314112524589 60.10771288997284)))"
22850006670000,19784,9969,9815,38.6,"MULTIPOLYGON(((11.131041999394911 60.1103696442635,11.12577211143185 60.15516254896271,11.215638172271207 60.15776322847892,11.22078653955075 60.11296564320628,11.131041999394911 60.1103696442635)))"
22900006670000,3106,1611,1495,35.3,"MULTIPOLYGON(((11.22078653955075 60.11296564320628,11.215638172271207 60.15776322847892,11.305520577973622 60.16030302157565,11.310547351895298 60.11550086459694,11.22078653955075 60.11296564320628)))"
22950006670000,3094,1584,1510,33.8,"MULTIPOLYGON(((11.310547351895298 60.11550086459694,11.305520577973622 60.16030302157565,11.395418945322758 60.162781906471544,11.40032405489824 60.11797528674384,11.310547351895298 60.11550086459694)))"
23000006670000,3418,1652,1766,46.1,"MULTIPOLYGON(((11.40032405489824 60.11797528674384,11.395418945322758 60.162781906471544,11.485332890675501 60.16519986190071,11.490116266605659 60.120388888468646,11.40032405489824 60.11797528674384)))"
23050006670000,551,282,269,44.1,"MULTIPOLYGON(((11.490116266605659 60.120388888468646,11.485332890675501 60.16519986190071,11.575262029972 60.16755686711329,11.579923604649993 60.12274164910706,11.490116266605659 60.120388888468646)))"
23100006670000,138,66,72,41.4,"MULTIPOLYGON(((11.579923604649993 60.12274164910706,11.575262029972 60.16755686711329,11.665205978745735 60.16985290187619,11.669745686260033 60.12503354850941,11.579923604649993 60.12274164910706)))"
23150006670000,8,5,3,62.9,"MULTIPOLYGON(((11.669745686260033 60.12503354850941,11.665205978745735 60.16985290187619,11.755164352133566 60.17208794647375,11.759582128270909 60.12726456704131,11.669745686260033 60.12503354850941)))"
23250006670000,23,15,8,34.5,"MULTIPOLYGON(((11.84943254713414 60.1294346855844,11.845136764885876 60.17426198170839,11.93512283137669 60.1763749889012,11.939296558927696 60.13154388553682,11.84943254713414 60.1294346855844)))"
23300006670000,460,223,237,40,"MULTIPOLYGON(((11.939296558927696 60.13154388553682,11.93512283137669 60.1763749889012,12.025122165613839 60.17842694989247,12.029173779366076 60.13359214881383,11.939296558927696 60.13154388553682)))"
23350006670000,1628,788,840,42.7,"MULTIPOLYGON(((12.029173779366076 60.13359214881383,12.025122165613839 60.17842694989247,12.115134381249145 60.18041784704248,12.11906382381042 60.13557945784853,12.029173779366076 60.13359214881383)))"
23400006670000,19,9,10,52.4,"MULTIPOLYGON(((12.11906382381042 60.13557945784853,12.115134381249145 60.18041784704248,12.205159091588627 60.18234766323181,12.208966307278649 60.1375057955922,12.11906382381042 60.13557945784853)))"
23450006670000,33,18,15,51,"MULTIPOLYGON(((12.208966307278649 60.1375057955922,12.205159091588627 60.18234766323181,12.295195909602745 60.184216381862115,12.298880844455615 60.13937114551504,12.208966307278649 60.1375057955922)))"
23500006670000,65,32,33,47.2,"MULTIPOLYGON(((12.298880844455615 60.13937114551504,12.295195909602745 60.184216381862115,12.385244447936635 60.186023986856576,12.38880704970328 60.14117549160669,12.298880844455615 60.13937114551504)))"
23550006670000,14,9,5,44.7,"MULTIPOLYGON(((12.38880704970328 60.14117549160669,12.385244447936635 60.186023986856576,12.47530431892041 60.1877704626604,12.478744537070925 60.14291881837659,12.38880704970328 60.14117549160669)))"
19450006675000,56,27,29,47.7,"MULTIPOLYGON(((5.073653164403954 59.837157664188744,5.060337388336271 59.88138165300633,5.148338779337888 59.88805597395778,5.161541360422321 59.8438201897978,5.073653164403954 59.837157664188744)))"
19500006675000,198,108,90,44.5,"MULTIPOLYGON(((5.161541360422321 59.8438201897978,5.148338779337888 59.88805597395778,5.236381236512537 59.894671947947046,5.249470445363326 59.85042446689479,5.161541360422321 59.8438201897978)))"
19550006675000,434,230,204,41.6,"MULTIPOLYGON(((5.249470445363326 59.85042446689479,5.236381236512537 59.894671947947046,5.324464425764846 59.901229520359585,5.337440086458099 59.85697044108165,5.249470445363326 59.85042446689479)))"
19600006675000,280,130,150,42.2,"MULTIPOLYGON(((5.337440086458099 59.85697044108165,5.324464425764846 59.901229520359585,5.412588011980286 59.90772863701699,5.425449949925846 59.86345805839482,5.337440086458099 59.85697044108165)))"
19650006675000,11,5,6,51.7,"MULTIPOLYGON(((5.425449949925846 59.86345805839482,5.412588011980286 59.90772863701699,5.500751659032064 59.91416924417856,5.513499700980703 59.869887265306986,5.425449949925846 59.86345805839482)))"
19700006675000,51,27,24,44.5,"MULTIPOLYGON(((5.513499700980703 59.869887265306986,5.500751659032064 59.91416924417856,5.58895502978809 59.92055128854299,5.601589003838663 59.87625800872861,5.513499700980703 59.869887265306986)))"
19750006675000,25,14,11,57.3,"MULTIPOLYGON(((5.601589003838663 59.87625800872861,5.58895502978809 59.92055128854299,5.677197786117982 59.92687471724988,5.68971752172454 59.882570236009514,5.601589003838663 59.87625800872861)))"
19800006675000,44,22,22,44.6,"MULTIPOLYGON(((5.68971752172454 59.882570236009514,5.677197786117982 59.92687471724988,5.765479588900157 59.93313947788141,5.77788491687902 59.88882389494046,5.68971752172454 59.882570236009514)))"
19850006675000,740,388,352,41.3,"MULTIPOLYGON(((5.77788491687902 59.88882389494046,5.765479588900157 59.93313947788141,5.853800098028974 59.939345518463874,5.86609085056574 59.89501893375475,5.77788491687902 59.88882389494046)))"
19900006675000,615,316,299,42.9,"MULTIPOLYGON(((5.86609085056574 59.89501893375475,5.853800098028974 59.939345518463874,5.94215897242193 59.945492787469256,5.954334983078468 59.901155301129776,5.86609085056574 59.89501893375475)))"
19950006675000,404,214,190,37.5,"MULTIPOLYGON(((5.954334983078468 59.901155301129776,5.94215897242193 59.945492787469256,6.030555870026928 59.9515812338168,6.042616973748299 59.907232946188564,5.954334983078468 59.901155301129776)))"
20300006675000,66,35,31,50.4,"MULTIPOLYGON(((6.573084742157558 59.9424628553244,6.561716467880038 59.98687383230664,6.650369870616495 59.99254912767956,6.661622121876373 59.948128057367285,6.573084742157558 59.9424628553244)))"
20350006675000,4,3,1,0,"MULTIPOLYGON(((6.661622121876373 59.948128057367285,6.650369870616495 59.99254912767956,6.73905852613351 59.99816520803302,6.750194600630331 59.95373414630299,6.661622121876373 59.948128057367285)))"
21000006675000,2,1,1,0,"MULTIPOLYGON(((7.815674162608067 60.01637982027387,7.805943669640927 60.06092276290778,7.895058403765074 60.06576494182208,7.904670854928011 60.021213349167496,7.815674162608067 60.01637982027387)))"
21450006675000,5,3,2,40.2,"MULTIPOLYGON(((8.61769886736161 60.057728130200694,8.609035408404964 60.10234515130614,8.698409452155758 60.106647444273875,8.706953728090033 60.06202271843478,8.61769886736161 60.057728130200694)))"
21500006675000,43,24,19,48.8,"MULTIPOLYGON(((8.706953728090033 60.06202271843478,8.698409452155758 60.106647444273875,8.787810476860708 60.11088956087469,8.79623545076199 60.06625723610265,8.706953728090033 60.06202271843478)))"
21550006675000,4,3,1,0,"MULTIPOLYGON(((8.79623545076199 60.06625723610265,8.787810476860708 60.11088956087469,8.877238113613688 60.11507146509121,8.88554366804912 60.07043164733373,8.79623545076199 60.06625723610265)))"
21650006675000,17,11,6,62.5,"MULTIPOLYGON(((8.974878011929343 60.074545916747276,8.96669199280973 60.119193121397856,9.05617174415408 60.12325449476199,9.064238113695867 60.07860000945365,8.974878011929343 60.074545916747276)))"
21700006675000,44,21,23,51.4,"MULTIPOLYGON(((9.064238113695867 60.07860000945365,9.05617174415408 60.12325449476199,9.145676996671314 60.12725555064502,9.153623603966228 60.08259389105517,9.064238113695867 60.07860000945365)))"
21850006675000,3,3,0,0,"MULTIPOLYGON(((9.33246926916479 60.09040088582013,9.324762517974312 60.13507657428992,9.414342041488437 60.13889647545455,9.421928702031696 60.09421393265852,9.33246926916479 60.09040088582013)))"
21900006675000,241,136,105,44.4,"MULTIPOLYGON(((9.421928702031696 60.09421393265852,9.414342041488437 60.13889647545455,9.503945575650697 60.1426559259456,9.511412039298245 60.09796663574398,9.421928702031696 60.09421393265852)))"
21950006675000,5,4,1,60.2,"MULTIPOLYGON(((9.511412039298245 60.09796663574398,9.503945575650697 60.1426559259456,9.593572746220447 60.14635489371072,9.600918908340777 60.10165896315536,9.511412039298245 60.09796663574398)))"
22000006675000,8,5,3,43.4,"MULTIPOLYGON(((9.600918908340777 60.10165896315536,9.593572746220447 60.14635489371072,9.683223178331922 60.149993347197956,9.69044893591513 60.10529088346989,9.600918908340777 60.10165896315536)))"
22050006675000,469,229,240,42.1,"MULTIPOLYGON(((9.69044893591513 60.10529088346989,9.683223178331922 60.149993347197956,9.772896496503657 60.15357125535672,9.780001748165983 60.10886236576415,9.69044893591513 60.10529088346989)))"
22100006675000,487,253,234,43.7,"MULTIPOLYGON(((9.780001748165983 60.10886236576415,9.772896496503657 60.15357125535672,9.862592324647917 60.157088587638825,9.869576970636222 60.11237337961512,9.780001748165983 60.10886236576415)))"
22300006675000,650,333,317,43.3,"MULTIPOLYGON(((10.138433345963424 60.12254331380365,10.131811099144178 60.1672768312986,10.221593194508921 60.17055156467283,10.22809445303486 60.125812159692,10.138433345963424 60.12254331380365)))"
22350006675000,8592,4281,4311,43.1,"MULTIPOLYGON(((10.22809445303486 60.125812159692,10.221593194508921 60.17055156467283,10.311395910647054 60.17376557699834,10.317776089344365 60.12902039256073,10.22809445303486 60.125812159692)))"
22400006675000,1518,777,741,39.7,"MULTIPOLYGON(((10.317776089344365 60.12902039256073,10.311395910647054 60.17376557699834,10.401218868033865 60.176918840761026,10.40747787702326 60.132167985008785,10.317776089344365 60.12902039256073)))"
22600006675000,62,38,24,44.5,"MULTIPOLYGON(((10.67670036162186 60.141246653425775,10.670805384412189 60.18601387316917,10.760705500912218 60.1889238777297,10.766478965535908 60.14415142032978,10.67670036162186 60.141246653425775)))"
22650006675000,2,2,0,0,"MULTIPOLYGON(((10.766478965535908 60.14415142032978,10.760705500912218 60.1889238777297,10.850623953147236 60.191773003806915,10.856275823644289 60.14699541742708,10.766478965535908 60.14415142032978)))"
22750006675000,1956,1037,919,35.9,"MULTIPOLYGON(((10.946090555013887 60.14977862037013,10.940560358505216 60.194561226952594,11.030514333894084 60.197288523232324,11.03592277823513 60.15250100532312,10.946090555013887 60.14977862037013)))"
22800006675000,983,558,425,38.5,"MULTIPOLYGON(((11.03592277823513 60.15250100532312,11.030514333894084 60.197288523232324,11.120485495751696 60.19995486922629,11.12577211143185 60.15516254896271,11.03592277823513 60.15250100532312)))"
22850006675000,3748,1933,1815,36.1,"MULTIPOLYGON(((11.12577211143185 60.15516254896271,11.120485495751696 60.19995486922629,11.210473460055809 60.202560242029975,11.215638172271207 60.15776322847892,11.12577211143185 60.15516254896271)))"
22900006675000,1880,933,947,38.6,"MULTIPOLYGON(((11.215638172271207 60.15776322847892,11.210473460055809 60.202560242029975,11.300477842334104 60.205104619255025,11.305520577973622 60.16030302157565,11.215638172271207 60.15776322847892)))"
22950006675000,339,177,162,43.1,"MULTIPOLYGON(((11.305520577973622 60.16030302157565,11.300477842334104 60.205104619255025,11.390498257674212 60.20758797902985,11.395418945322758 60.162781906471544,11.305520577973622 60.16030302157565)))"
23000006675000,630,334,296,43.9,"MULTIPOLYGON(((11.395418945322758 60.162781906471544,11.390498257674212 60.20758797902985,11.4805343207338 60.210010300000384,11.485332890675501 60.16519986190071,11.395418945322758 60.162781906471544)))"
23050006675000,1543,799,744,39.6,"MULTIPOLYGON(((11.485332890675501 60.16519986190071,11.4805343207338 60.210010300000384,11.57058564575068 60.21237156133081,11.575262029972 60.16755686711329,11.485332890675501 60.16519986190071)))"
23100006675000,633,335,298,45.3,"MULTIPOLYGON(((11.575262029972 60.16755686711329,11.57058564575068 60.21237156133081,11.660651846552923 60.21467174270414,11.665205978745735 60.16985290187619,11.575262029972 60.16755686711329)))"
23150006675000,115,64,51,47.1,"MULTIPOLYGON(((11.665205978745735 60.16985290187619,11.660651846552923 60.21467174270414,11.75073253656902 60.21691082432291,11.755164352133566 60.17208794647375,11.665205978745735 60.16985290187619)))"
23200006675000,96,55,41,38.4,"MULTIPOLYGON(((11.755164352133566 60.17208794647375,11.75073253656902 60.21691082432291,11.840827328838078 60.2190887869099,11.845136764885876 60.17426198170839,11.755164352133566 60.17208794647375)))"
23250006675000,695,369,326,43.7,"MULTIPOLYGON(((11.845136764885876 60.17426198170839,11.840827328838078 60.2190887869099,11.930935836020016 60.22120561170867,11.93512283137669 60.1763749889012,11.845136764885876 60.17426198170839)))"
23300006675000,9884,4740,5144,44.7,"MULTIPOLYGON(((11.93512283137669 60.1763749889012,11.930935836020016 60.22120561170867,12.021057670405813 60.22326128048416,12.025122165613839 60.17842694989247,11.93512283137669 60.1763749889012)))"
23350006675000,1051,501,550,44.4,"MULTIPOLYGON(((12.025122165613839 60.17842694989247,12.021057670405813 60.22326128048416,12.111192443927761 60.22525577552334,12.115134381249145 60.18041784704248,12.025122165613839 60.17842694989247)))"
23400006675000,18,10,8,35.1,"MULTIPOLYGON(((12.115134381249145 60.18041784704248,12.111192443927761 60.22525577552334,12.201339768169754 60.22718907963573,12.205159091588627 60.18234766323181,12.115134381249145 60.18041784704248)))"
23450006675000,7,5,2,52.7,"MULTIPOLYGON(((12.205159091588627 60.18234766323181,12.201339768169754 60.22718907963573,12.291499254377593 60.22906117615405,12.295195909602745 60.184216381862115,12.205159091588627 60.18234766323181)))"
23500006675000,34,19,15,56.9,"MULTIPOLYGON(((12.295195909602745 60.184216381862115,12.291499254377593 60.22906117615405,12.38167051346932 60.230872048934636,12.385244447936635 60.186023986856576,12.295195909602745 60.184216381862115)))"
23550006675000,19,11,8,40.6,"MULTIPOLYGON(((12.385244447936635 60.186023986856576,12.38167051346932 60.230872048934636,12.471853156045576 60.23262168235804,12.47530431892041 60.1877704626604,12.385244447936635 60.186023986856576)))"
23600006675000,1,1,0,0,"MULTIPOLYGON(((12.47530431892041 60.1877704626604,12.471853156045576 60.23262168235804,12.562046792399958 60.23431006132953,12.565375134579435 60.189455794241354,12.47530431892041 60.1877704626604)))"
19450006680000,85,50,35,56.1,"MULTIPOLYGON(((5.060337388336271 59.88138165300633,5.04698021285405 59.92560353968809,5.135095131909419 59.932289686860905,5.148338779337888 59.88805597395778,5.060337388336271 59.88138165300633)))"
19500006680000,1,1,0,0,"MULTIPOLYGON(((5.148338779337888 59.88805597395778,5.135095131909419 59.932289686860905,5.22325129541422 59.93891738838867,5.236381236512537 59.894671947947046,5.148338779337888 59.88805597395778)))"
19550006680000,918,486,432,40.1,"MULTIPOLYGON(((5.236381236512537 59.894671947947046,5.22325129541422 59.93891738838867,5.311448367939742 59.94548658943922,5.324464425764846 59.901229520359585,5.236381236512537 59.894671947947046)))"
19600006680000,1061,542,519,40.2,"MULTIPOLYGON(((5.324464425764846 59.901229520359585,5.311448367939742 59.94548658943922,5.399686013030832 59.951997235618016,5.412588011980286 59.90772863701699,5.324464425764846 59.901229520359585)))"
19650006680000,144,77,67,47.2,"MULTIPOLYGON(((5.412588011980286 59.90772863701699,5.399686013030832 59.951997235618016,5.487963893212796 59.95844927296992,5.500751659032064 59.91416924417856,5.412588011980286 59.90772863701699)))"
19700006680000,106,54,52,48.3,"MULTIPOLYGON(((5.500751659032064 59.91416924417856,5.487963893212796 59.95844927296992,5.576281669998446 59.964842647980575,5.58895502978809 59.92055128854299,5.500751659032064 59.91416924417856)))"
19750006680000,243,129,114,42.7,"MULTIPOLYGON(((5.58895502978809 59.92055128854299,5.576281669998446 59.964842647980575,5.664639003895118 59.971177307578294,5.677197786117982 59.92687471724988,5.58895502978809 59.92055128854299)))"
19850006680000,5,4,1,43,"MULTIPOLYGON(((5.765479588900157 59.93313947788141,5.753035554411834 59.97745319913548,5.84147098006646 59.98367027047026,5.853800098028974 59.939345518463874,5.765479588900157 59.93313947788141)))"
19900006680000,259,134,125,42.3,"MULTIPOLYGON(((5.853800098028974 59.939345518463874,5.84147098006646 59.98367027047026,5.929944938392969 59.989828469848064,5.94215897242193 59.945492787469256,5.853800098028974 59.939345518463874)))"
19950006680000,1489,728,761,45.6,"MULTIPOLYGON(((5.94215897242193 59.945492787469256,5.929944938392969 59.989828469848064,6.018457085948743 59.99592774598327,6.030555870026928 59.9515812338168,5.94215897242193 59.945492787469256)))"
20000006680000,68,36,32,46.7,"MULTIPOLYGON(((6.030555870026928 59.9515812338168,6.018457085948743 59.99592774598327,6.107007078321942 60.00196804804063,6.118990447829589 59.95761080687455,6.030555870026928 59.9515812338168)))"
20250006680000,52,25,27,37,"MULTIPOLYGON(((6.473098667464537 59.98113936936225,6.461578574246905 60.02553851463878,6.550312591129988 60.03128319965159,6.561716467880038 59.98687383230664,6.473098667464537 59.98113936936225)))"
20300006680000,66,30,36,40.9,"MULTIPOLYGON(((6.561716467880038 59.98687383230664,6.550312591129988 60.03128319965159,6.639082366425795 60.03696861512023,6.650369870616495 59.99254912767956,6.561716467880038 59.98687383230664)))"
21350006680000,3,1,2,0,"MULTIPOLYGON(((8.430369735842051 60.093560182791585,8.421440190645628 60.138160375812525,8.510878475655963 60.14259084865318,8.519688713806588 60.097982718479514,8.430369735842051 60.093560182791585)))"
21450006680000,66,35,31,47.4,"MULTIPOLYGON(((8.609035408404964 60.10234515130614,8.600344600176426 60.146961112858996,8.689838195149347 60.15127113128091,8.698409452155758 60.106647444273875,8.609035408404964 60.10234515130614)))"
21500006680000,42,22,20,50.9,"MULTIPOLYGON(((8.698409452155758 60.106647444273875,8.689838195149347 60.15127113128091,8.779358890794917 60.15552086726133,8.787810476860708 60.11088956087469,8.698409452155758 60.106647444273875)))"
21600006680000,2,1,1,0,"MULTIPOLYGON(((8.877238113613688 60.11507146509121,8.86890631662023 60.15971028463524,8.95848010142836 60.16383934773139,8.96669199280973 60.119193121397856,8.877238113613688 60.11507146509121)))"
21650006680000,142,74,68,46.8,"MULTIPOLYGON(((8.96669199280973 60.119193121397856,8.95848010142836 60.16383934773139,9.048079873327485 60.167908021373414,9.05617174415408 60.12325449476199,8.96669199280973 60.119193121397856)))"
21700006680000,3,2,1,0,"MULTIPOLYGON(((9.05617174415408 60.12325449476199,9.048079873327485 60.167908021373414,9.137705259740075 60.17191627088087,9.145676996671314 60.12725555064502,9.05617174415408 60.12325449476199)))"
21850006680000,95,47,48,40.8,"MULTIPOLYGON(((9.324762517974312 60.13507657428992,9.317031382422229 60.179751361257026,9.406731370191295 60.18357813525471,9.414342041488437 60.13889647545455,9.324762517974312 60.13507657428992)))"
21900006680000,154,76,78,44,"MULTIPOLYGON(((9.414342041488437 60.13889647545455,9.406731370191295 60.18357813525471,9.496455475491477 60.187344351377874,9.503945575650697 60.1426559259456,9.414342041488437 60.13889647545455)))"
21950006680000,50,31,19,47.7,"MULTIPOLYGON(((9.503945575650697 60.1426559259456,9.496455475491477 60.187344351377874,9.58620332245577 60.191049977442276,9.593572746220447 60.14635489371072,9.503945575650697 60.1426559259456)))"
22000006680000,656,307,349,43.6,"MULTIPOLYGON(((9.593572746220447 60.14635489371072,9.58620332245577 60.191049977442276,9.67597453458741 60.194694981766006,9.683223178331922 60.149993347197956,9.593572746220447 60.14635489371072)))"
22050006680000,101,56,45,40.3,"MULTIPOLYGON(((9.683223178331922 60.149993347197956,9.67597453458741 60.194694981766006,9.765768734769331 60.19827933317063,9.772896496503657 60.15357125535672,9.683223178331922 60.149993347197956)))"
22200006680000,44,22,22,37.1,"MULTIPOLYGON(((9.952310286080204 60.16054531399935,9.945424587771479 60.20526595503122,10.035285483341974 60.20866816565601,10.042050003528766 60.16394140489771,9.952310286080204 60.16054531399935)))"
22250006680000,311,159,152,39.7,"MULTIPOLYGON(((10.042050003528766 60.16394140489771,10.035285483341974 60.20866816565601,10.125167852482518 60.21200960370116,10.131811099144178 60.1672768312986,10.042050003528766 60.16394140489771)))"
22300006680000,2814,1360,1454,44,"MULTIPOLYGON(((10.131811099144178 60.1672768312986,10.125167852482518 60.21200960370116,10.215071315118129 60.215290240519664,10.221593194508921 60.17055156467283,10.131811099144178 60.1672768312986)))"
22350006680000,7391,3610,3781,42.4,"MULTIPOLYGON(((10.221593194508921 60.17055156467283,10.215071315118129 60.215290240519664,10.304995490611219 60.21851004797371,10.311395910647054 60.17376557699834,10.221593194508921 60.17055156467283)))"
22400006680000,2346,1149,1197,42.8,"MULTIPOLYGON(((10.311395910647054 60.17376557699834,10.304995490611219 60.21851004797371,10.394939997771328 60.22166899843551,10.401218868033865 60.176918840761026,10.311395910647054 60.17376557699834)))"
22600006680000,2787,1365,1422,41.8,"MULTIPOLYGON(((10.670805384412189 60.18601387316917,10.664891689262133 60.23078043925844,10.754913700471874 60.23369569570462,10.760705500912218 60.1889238777297,10.670805384412189 60.18601387316917)))"
22700006680000,18,11,7,48.9,"MULTIPOLYGON(((10.850623953147236 60.191773003806915,10.844954129447224 60.23654996470058,10.935012591887302 60.23934322169679,10.940560358505216 60.194561226952594,10.850623953147236 60.191773003806915)))"
22750006680000,3241,1694,1547,39.9,"MULTIPOLYGON(((10.940560358505216 60.194561226952594,10.935012591887302 60.23934322169679,11.025088703007606 60.24207544265964,11.030514333894084 60.197288523232324,10.940560358505216 60.194561226952594)))"
22800006680000,1498,805,693,41,"MULTIPOLYGON(((11.030514333894084 60.197288523232324,11.025088703007606 60.24207544265964,11.115182077550024 60.24474660407226,11.120485495751696 60.19995486922629,11.030514333894084 60.197288523232324)))"
22850006680000,2249,1167,1082,35.3,"MULTIPOLYGON(((11.120485495751696 60.19995486922629,11.115182077550024 60.24474660407226,11.205292329792895 60.247356682935184,11.210473460055809 60.202560242029975,11.120485495751696 60.19995486922629)))"
22900006680000,672,361,311,36,"MULTIPOLYGON(((11.210473460055809 60.202560242029975,11.205292329792895 60.247356682935184,11.295419073561108 60.24990565676715,11.300477842334104 60.205104619255025,11.210473460055809 60.202560242029975)))"
22950006680000,1398,730,668,39.1,"MULTIPOLYGON(((11.300477842334104 60.205104619255025,11.295419073561108 60.24990565676715,11.385561922236201 60.25239350360584,11.390498257674212 60.20758797902985,11.300477842334104 60.205104619255025)))"
23000006680000,737,377,360,43.2,"MULTIPOLYGON(((11.390498257674212 60.20758797902985,11.385561922236201 60.25239350360584,11.475720488766523 60.254820202008574,11.4805343207338 60.210010300000384,11.390498257674212 60.20758797902985)))"
23050006680000,919,468,451,42.4,"MULTIPOLYGON(((11.4805343207338 60.210010300000384,11.475720488766523 60.254820202008574,11.565894385677401 60.25718573105294,11.57058564575068 60.21237156133081,11.4805343207338 60.210010300000384)))"
23100006680000,741,371,370,43.9,"MULTIPOLYGON(((11.57058564575068 60.21237156133081,11.565894385677401 60.25718573105294,11.656083225081353 60.25949007033765,11.660651846552923 60.21467174270414,11.57058564575068 60.21237156133081)))"
23150006680000,3054,1496,1558,44.6,"MULTIPOLYGON(((11.660651846552923 60.21467174270414,11.656083225081353 60.25949007033765,11.746286618688314 60.26173319998297,11.75073253656902 60.21691082432291,11.660651846552923 60.21467174270414)))"
23200006680000,925,465,460,43.1,"MULTIPOLYGON(((11.75073253656902 60.21691082432291,11.746286618688314 60.26173319998297,11.836504177815902 60.26391510063157,11.840827328838078 60.2190887869099,11.75073253656902 60.21691082432291)))"
23250006680000,312,169,143,46,"MULTIPOLYGON(((11.840827328838078 60.2190887869099,11.836504177815902 60.26391510063157,11.9267355133997 60.26603575344902,11.930935836020016 60.22120561170867,11.840827328838078 60.2190887869099)))"
23300006680000,39,26,13,56,"MULTIPOLYGON(((11.930935836020016 60.22120561170867,11.9267355133997 60.26603575344902,12.016980236003567 60.268095140124444,12.021057670405813 60.22326128048416,11.930935836020016 60.22120561170867)))"
23350006680000,1155,583,572,45.1,"MULTIPOLYGON(((12.021057670405813 60.22326128048416,12.016980236003567 60.268095140124444,12.107237955829987 60.270093242871155,12.111192443927761 60.22525577552334,12.021057670405813 60.22326128048416)))"
23400006680000,145,82,63,45.3,"MULTIPOLYGON(((12.111192443927761 60.22525577552334,12.107237955829987 60.270093242871155,12.197508282730407 60.272030044427176,12.201339768169754 60.22718907963573,12.111192443927761 60.22525577552334)))"
23450006680000,5,3,2,63.2,"MULTIPOLYGON(((12.201339768169754 60.22718907963573,12.197508282730407 60.272030044427176,12.28779082621565 60.27390552805583,12.291499254377593 60.22906117615405,12.201339768169754 60.22718907963573)))"
23500006680000,1,0,1,0,"MULTIPOLYGON(((12.291499254377593 60.22906117615405,12.28779082621565 60.27390552805583,12.378085195466307 60.275719677546235,12.38167051346932 60.230872048934636,12.291499254377593 60.22906117615405)))"
23550006680000,51,28,23,45.3,"MULTIPOLYGON(((12.38167051346932 60.230872048934636,12.378085195466307 60.275719677546235,12.468390999343166 60.27747247721398,12.471853156045576 60.23262168235804,12.38167051346932 60.230872048934636)))"
23600006680000,16,9,7,48,"MULTIPOLYGON(((12.471853156045576 60.23262168235804,12.468390999343166 60.27747247721398,12.558707846397676 60.27916391190143,12.562046792399958 60.23431006132953,12.471853156045576 60.23262168235804)))"
19500006685000,35,17,18,41.6,"MULTIPOLYGON(((5.135095131909419 59.932289686860905,5.121810239859297 59.976521320924974,5.210080445124098 59.98316078077036,5.22325129541422 59.93891738838867,5.135095131909419 59.932289686860905)))"
19550006685000,22,12,10,46.1,"MULTIPOLYGON(((5.22325129541422 59.93891738838867,5.210080445124098 59.98316078077036,5.298391737379154 59.98974164100321,5.311448367939742 59.94548658943922,5.22325129541422 59.93891738838867)))"
19600006685000,146,83,63,49.7,"MULTIPOLYGON(((5.311448367939742 59.94548658943922,5.298391737379154 59.98974164100321,5.386743778821738 59.99626384701174,5.399686013030832 59.951997235618016,5.311448367939742 59.94548658943922)))"
19650006685000,113,59,54,47.6,"MULTIPOLYGON(((5.399686013030832 59.951997235618016,5.386743778821738 59.99626384701174,5.475136230622266 60.00272734462505,5.487963893212796 59.95844927296992,5.399686013030832 59.951997235618016)))"
19700006685000,386,188,198,42.5,"MULTIPOLYGON(((5.487963893212796 59.95844927296992,5.475136230622266 60.00272734462505,5.563568752931381 60.00913208011471,5.576281669998446 59.964842647980575,5.487963893212796 59.95844927296992)))"
19750006685000,27,17,10,53.4,"MULTIPOLYGON(((5.576281669998446 59.964842647980575,5.563568752931381 60.00913208011471,5.652041004887022 60.015478000196474,5.664639003895118 59.971177307578294,5.576281669998446 59.964842647980575)))"
19800006685000,175,84,91,49.4,"MULTIPOLYGON(((5.664639003895118 59.971177307578294,5.652041004887022 60.015478000196474,5.740552644621614 60.021765052031824,5.753035554411834 59.97745319913548,5.664639003895118 59.971177307578294)))"
19850006685000,281,138,143,49.5,"MULTIPOLYGON(((5.753035554411834 59.97745319913548,5.740552644621614 60.021765052031824,5.829103329269293 60.027993183229604,5.84147098006646 59.98367027047026,5.753035554411834 59.97745319913548)))"
19900006685000,62,30,32,46.4,"MULTIPOLYGON(((5.84147098006646 59.98367027047026,5.829103329269293 60.027993183229604,5.917692714973197 60.034162341847534,5.929944938392969 59.989828469848064,5.84147098006646 59.98367027047026)))"
19950006685000,350,167,183,44.1,"MULTIPOLYGON(((5.929944938392969 59.989828469848064,5.917692714973197 60.034162341847534,6.006320456892828 60.040272476393966,6.018457085948743 59.99592774598327,5.929944938392969 59.989828469848064)))"
20000006685000,22,13,9,55.9,"MULTIPOLYGON(((6.018457085948743 59.99592774598327,6.006320456892828 60.040272476393966,6.094986209211451 60.04632353582921,6.107007078321942 60.00196804804063,6.018457085948743 59.99592774598327)))"
20250006685000,1156,596,560,42.2,"MULTIPOLYGON(((6.461578574246905 60.02553851463878,6.450022372393426 60.06993601757613,6.538872955814532 60.07569095179265,6.550312591129988 60.03128319965159,6.461578574246905 60.02553851463878)))"
20300006685000,2917,1450,1467,46.7,"MULTIPOLYGON(((6.550312591129988 60.03128319965159,6.538872955814532 60.07569095179265,6.627759454656148 60.08138651424053,6.639082366425795 60.03696861512023,6.550312591129988 60.03128319965159)))"
21650006685000,242,120,122,43.1,"MULTIPOLYGON(((8.95848010142836 60.16383934773139,8.950242222841698 60.20848459298602,9.039962387874677 60.21256058661404,9.048079873327485 60.167908021373414,8.95848010142836 60.16383934773139)))"
21850006685000,59,33,26,60,"MULTIPOLYGON(((9.317031382422229 60.179751361257026,9.309275754003124 60.22442524430456,9.399096581256503 60.22825890972532,9.406731370191295 60.18357813525471,9.317031382422229 60.179751361257026)))"
21900006685000,3,3,0,0,"MULTIPOLYGON(((9.406731370191295 60.18357813525471,9.399096581256503 60.22825890972532,9.488941633563181 60.23203190978915,9.496455475491477 60.187344351377874,9.406731370191295 60.18357813525471)))"
21950006685000,49,28,21,45,"MULTIPOLYGON(((9.496455475491477 60.187344351377874,9.488941633563181 60.23203190978915,9.578810533420366 60.23574421217919,9.58620332245577 60.191049977442276,9.496455475491477 60.187344351377874)))"
22000006685000,192,106,86,48.1,"MULTIPOLYGON(((9.58620332245577 60.191049977442276,9.578810533420366 60.23574421217919,9.66870290269081 60.23939578508282,9.67597453458741 60.194694981766006,9.58620332245577 60.191049977442276)))"
22050006685000,50,28,22,44.4,"MULTIPOLYGON(((9.67597453458741 60.194694981766006,9.66870290269081 60.23939578508282,9.758618362612351 60.24298659719291,9.765768734769331 60.19827933317063,9.67597453458741 60.194694981766006)))"
22100006685000,63,37,26,49.9,"MULTIPOLYGON(((9.765768734769331 60.19827933317063,9.758618362612351 60.24298659719291,9.84855653380749 60.246516617708714,9.855585545273707 60.201803000981954,9.765768734769331 60.19827933317063)))"
22150006685000,691,351,340,44.6,"MULTIPOLYGON(((9.855585545273707 60.201803000981954,9.84855653380749 60.246516617708714,9.938517036293034 60.24998581633684,9.945424587771479 60.20526595503122,9.855585545273707 60.201803000981954)))"
22200006685000,310,157,153,42.8,"MULTIPOLYGON(((9.945424587771479 60.20526595503122,9.938517036293034 60.24998581633684,10.028499489489734 60.2533941632923,10.035285483341974 60.20866816565601,9.945424587771479 60.20526595503122)))"
22250006685000,177,95,82,40.8,"MULTIPOLYGON(((10.035285483341974 60.20866816565601,10.028499489489734 60.2533941632923,10.11850351223202 60.25674162929938,10.125167852482518 60.21200960370116,10.035285483341974 60.20866816565601)))"
22300006685000,404,210,194,44,"MULTIPOLYGON(((10.125167852482518 60.21200960370116,10.11850351223202 60.25674162929938,10.208528722777721 60.26002818559267,10.215071315118129 60.215290240519664,10.125167852482518 60.21200960370116)))"
22350006685000,425,230,195,45.7,"MULTIPOLYGON(((10.215071315118129 60.215290240519664,10.208528722777721 60.26002818559267,10.298574738817843 60.2632538039179,10.304995490611219 60.21851004797371,10.215071315118129 60.215290240519664)))"
22400006685000,3763,1817,1946,43,"MULTIPOLYGON(((10.304995490611219 60.21851004797371,10.298574738817843 60.2632538039179,10.38864117748641 60.26641845653294,10.394939997771328 60.22166899843551,10.304995490611219 60.21851004797371)))"
22450006685000,2210,1102,1108,41.6,"MULTIPOLYGON(((10.394939997771328 60.22166899843551,10.38864117748641 60.26641845653294,10.4787276553703 60.2695221162086,10.484904454864933 60.224767064788196,10.394939997771328 60.22166899843551)))"
22500006685000,232,122,110,41.5,"MULTIPOLYGON(((10.484904454864933 60.224767064788196,10.4787276553703 60.2695221162086,10.568833788519152 60.27256475622956,10.57488847962526 60.22780422042665,10.484904454864933 60.224767064788196)))"
22550006685000,1437,734,703,39.6,"MULTIPOLYGON(((10.57488847962526 60.22780422042665,10.568833788519152 60.27256475622956,10.658959192455281 60.27554635039531,10.664891689262133 60.23078043925844,10.57488847962526 60.22780422042665)))"
22600006685000,502,266,236,41.2,"MULTIPOLYGON(((10.664891689262133 60.23078043925844,10.658959192455281 60.27554635039531,10.749103482183651 60.27846687302082,10.754913700471874 60.23369569570462,10.664891689262133 60.23078043925844)))"
22700006685000,2,1,1,0,"MULTIPOLYGON(((10.844954129447224 60.23654996470058,10.839266272201872 60.2813262989375,10.92944717651023 60.284124603494014,10.935012591887302 60.23934322169679,10.844954129447224 60.23654996470058)))"
22750006685000,970,501,469,37.6,"MULTIPOLYGON(((10.935012591887302 60.23934322169679,10.92944717651023 60.284124603494014,11.019645808621753 60.28686176255701,11.025088703007606 60.24207544265964,10.935012591887302 60.23934322169679)))"
22800006685000,4537,2290,2247,38.4,"MULTIPOLYGON(((11.025088703007606 60.24207544265964,11.019645808621753 60.28686176255701,11.109861781572313 60.28953775251191,11.115182077550024 60.24474660407226,11.025088703007606 60.24207544265964)))"
22850006685000,12137,6064,6073,37.9,"MULTIPOLYGON(((11.115182077550024 60.24474660407226,11.109861781572313 60.28953775251191,11.200094707930745 60.292152550263786,11.205292329792895 60.247356682935184,11.115182077550024 60.24474660407226)))"
22900006685000,1579,831,748,38,"MULTIPOLYGON(((11.205292329792895 60.247356682935184,11.200094707930745 60.292152550263786,11.290344199809029 60.29470613323796,11.295419073561108 60.24990565676715,11.205292329792895 60.247356682935184)))"
22950006685000,275,144,131,42.9,"MULTIPOLYGON(((11.295419073561108 60.24990565676715,11.290344199809029 60.29470613323796,11.38060986887246 60.29719847938081,11.385561922236201 60.25239350360584,11.295419073561108 60.24990565676715)))"
23050006685000,126,65,61,46,"MULTIPOLYGON(((11.475720488766523 60.254820202008574,11.470891326349884 60.29962956716053,11.56118818304395 60.30199937556774,11.565894385677401 60.25718573105294,11.475720488766523 60.254820202008574)))"
23100006685000,260,134,126,44.9,"MULTIPOLYGON(((11.565894385677401 60.25718573105294,11.56118818304395 60.30199937556774,11.651500049341385 60.30430788411617,11.656083225081353 60.25949007033765,11.565894385677401 60.25718573105294)))"
23150006685000,472,240,232,41.7,"MULTIPOLYGON(((11.656083225081353 60.25949007033765,11.651500049341385 60.30430788411617,11.74182653522331 60.306555072843445,11.746286618688314 60.26173319998297,11.656083225081353 60.25949007033765)))"
23200006685000,394,189,205,44.6,"MULTIPOLYGON(((11.746286618688314 60.26173319998297,11.74182653522331 60.306555072843445,11.832167250275566 60.30874092231164,11.836504177815902 60.26391510063157,11.746286618688314 60.26173319998297)))"
23250006685000,2,1,1,0,"MULTIPOLYGON(((11.836504177815902 60.26391510063157,11.832167250275566 60.30874092231164,11.922521803699082 60.31086541360791,11.9267355133997 60.26603575344902,11.836504177815902 60.26391510063157)))"
23300006685000,152,77,75,48.6,"MULTIPOLYGON(((11.9267355133997 60.26603575344902,11.922521803699082 60.31086541360791,12.012889804320269 60.3129285283451,12.016980236003567 60.268095140124444,11.9267355133997 60.26603575344902)))"
23350006685000,293,158,135,42.1,"MULTIPOLYGON(((12.016980236003567 60.268095140124444,12.012889804320269 60.3129285283451,12.10327086060143 60.31493024866242,12.107237955829987 60.270093242871155,12.016980236003567 60.268095140124444)))"
23400006685000,312,159,153,45.9,"MULTIPOLYGON(((12.107237955829987 60.270093242871155,12.10327086060143 60.31493024866242,12.193664580651198 60.31687055722597,12.197508282730407 60.272030044427176,12.107237955829987 60.270093242871155)))"
23450006685000,134,63,71,46,"MULTIPOLYGON(((12.197508282730407 60.272030044427176,12.193664580651198 60.31687055722597,12.284070572234993 60.31874943722929,12.28779082621565 60.27390552805583,12.197508282730407 60.272030044427176)))"
23500006685000,68,34,34,40.5,"MULTIPOLYGON(((12.28779082621565 60.27390552805583,12.284070572234993 60.31874943722929,12.374488442785529 60.32056687239399,12.378085195466307 60.275719677546235,12.28779082621565 60.27390552805583)))"
23550006685000,1,1,0,0,"MULTIPOLYGON(((12.378085195466307 60.275719677546235,12.374488442785529 60.32056687239399,12.464917799413293 60.32232284697016,12.468390999343166 60.27747247721398,12.378085195466307 60.275719677546235)))"
23600006685000,9,5,4,51.9,"MULTIPOLYGON(((12.468390999343166 60.27747247721398,12.464917799413293 60.32232284697016,12.555358248917104 60.32401734573699,12.558707846397676 60.27916391190143,12.468390999343166 60.27747247721398)))"
19450006690000,170,92,78,44.7,"MULTIPOLYGON(((5.033581458353674 59.969823316518045,5.020140944191362 60.0140409757343,5.108483923876556 60.02075086852256,5.121810239859297 59.976521320924974,5.033581458353674 59.969823316518045)))"
19500006690000,908,463,445,39.8,"MULTIPOLYGON(((5.121810239859297 59.976521320924974,5.108483923876556 60.02075086852256,5.196868507671419 60.027402117598335,5.210080445124098 59.98316078077036,5.121810239859297 59.976521320924974)))"
19550006690000,563,291,272,43,"MULTIPOLYGON(((5.210080445124098 59.98316078077036,5.196868507671419 60.027402117598335,5.285294357459905 60.03399466769055,5.298391737379154 59.98974164100321,5.210080445124098 59.98316078077036)))"
19600006690000,54,28,26,49.5,"MULTIPOLYGON(((5.298391737379154 59.98974164100321,5.285294357459905 60.03399466769055,5.37376113408473 60.040528463968954,5.386743778821738 59.99626384701174,5.298391737379154 59.98974164100321)))"
19650006690000,83,47,36,56.5,"MULTIPOLYGON(((5.386743778821738 59.99626384701174,5.37376113408473 60.040528463968954,5.462268497354382 60.04700345204572,5.475136230622266 60.00272734462505,5.386743778821738 59.99626384701174)))"
19700006690000,1058,514,544,42.8,"MULTIPOLYGON(((5.475136230622266 60.00272734462505,5.462268497354382 60.04700345204572,5.550816106050211 60.05341957797718,5.563568752931381 60.00913208011471,5.475136230622266 60.00272734462505)))"
19750006690000,202,106,96,42.7,"MULTIPOLYGON(((5.563568752931381 60.00913208011471,5.550816106050211 60.05341957797718,5.639403617933599 60.059776788265324,5.652041004887022 60.015478000196474,5.563568752931381 60.00913208011471)))"
19800006690000,114,50,64,43.5,"MULTIPOLYGON(((5.652041004887022 60.015478000196474,5.639403617933599 60.059776788265324,5.728030689753147 60.06607502985955,5.740552644621614 60.021765052031824,5.652041004887022 60.015478000196474)))"
19850006690000,17,7,10,58.6,"MULTIPOLYGON(((5.740552644621614 60.021765052031824,5.728030689753147 60.06607502985955,5.816696977251959 60.07231425015824,5.829103329269293 60.027993183229604,5.740552644621614 60.021765052031824)))"
19900006690000,104,53,51,57,"MULTIPOLYGON(((5.829103329269293 60.027993183229604,5.816696977251959 60.07231425015824,5.905402135175 60.078494397010296,5.917692714973197 60.034162341847534,5.829103329269293 60.027993183229604)))"
19950006690000,242,124,118,42,"MULTIPOLYGON(((5.917692714973197 60.034162341847534,5.905402135175 60.078494397010296,5.994145817276467 60.08461541871682,6.006320456892828 60.040272476393966,5.917692714973197 60.034162341847534)))"
20000006690000,37,21,16,45.5,"MULTIPOLYGON(((6.006320456892828 60.040272476393966,5.994145817276467 60.08461541871682,6.082927676327258 60.09067726403267,6.094986209211451 60.04632353582921,6.006320456892828 60.040272476393966)))"
20050006690000,56,30,26,49,"MULTIPOLYGON(((6.094986209211451 60.04632353582921,6.082927676327258 60.09067726403267,6.171747364122506 60.09667988216798,6.183689625143582 60.05231546956733,6.094986209211451 60.04632353582921)))"
20250006690000,729,398,331,43.4,"MULTIPOLYGON(((6.450022372393426 60.06993601757613,6.438429903449299 60.114331872454436,6.527397404924802 60.12009708312951,6.538872955814532 60.07569095179265,6.450022372393426 60.06993601757613)))"
20300006690000,616,327,289,44,"MULTIPOLYGON(((6.538872955814532 60.07569095179265,6.527397404924802 60.12009708312951,6.616400979751268 60.125802819558544,6.627759454656148 60.08138651424053,6.538872955814532 60.07569095179265)))"
21600006690000,1,1,0,0,"MULTIPOLYGON(((8.860548160528136 60.204348103114675,8.8521635281019 60.24898491766039,8.941978241420497 60.25312885438231,8.950242222841698 60.20848459298602,8.860548160528136 60.204348103114675)))"
21650006690000,133,66,67,49.3,"MULTIPOLYGON(((8.950242222841698 60.20848459298602,8.941978241420497 60.25312885438231,9.031819173777738 60.25721218779304,9.039962387874677 60.21256058661404,8.950242222841698 60.20848459298602)))"
21700006690000,10,5,5,54.9,"MULTIPOLYGON(((9.039962387874677 60.21256058661404,9.031819173777738 60.25721218779304,9.121685949364148 60.26123488292615,9.129708281438205 60.21657604917573,9.039962387874677 60.21256058661404)))"
21800006690000,78,44,34,47.9,"MULTIPOLYGON(((9.219479528661884 60.22053094634718,9.211578191683655 60.26519690531628,9.301495523562984 60.26909822100016,9.309275754003124 60.22442524430456,9.219479528661884 60.22053094634718)))"
21850006690000,408,207,201,48.5,"MULTIPOLYGON(((9.309275754003124 60.22442524430456,9.301495523562984 60.26909822100016,9.391437567161086 60.272938796517764,9.399096581256503 60.22825890972532,9.309275754003124 60.22442524430456)))"
21900006690000,9,5,4,67.8,"MULTIPOLYGON(((9.399096581256503 60.22825890972532,9.391437567161086 60.272938796517764,9.48140394397864 60.27671859891336,9.488941633563181 60.23203190978915,9.399096581256503 60.22825890972532)))"
22000006690000,38,20,18,44.9,"MULTIPOLYGON(((9.578810533420366 60.23574421217919,9.571394274867558 60.28043759573662,9.661408180040567 60.28409575504355,9.66870290269081 60.23939578508282,9.578810533420366 60.23574421217919)))"
22050006690000,62,31,31,48.5,"MULTIPOLYGON(((9.66870290269081 60.23939578508282,9.661408180040567 60.28409575504355,9.75144527908082 60.287693045397624,9.758618362612351 60.24298659719291,9.66870290269081 60.23939578508282)))"
22100006690000,16,10,6,45.2,"MULTIPOLYGON(((9.758618362612351 60.24298659719291,9.75144527908082 60.287693045397624,9.841505190951535 60.2912294358707,9.84855653380749 60.246516617708714,9.758618362612351 60.24298659719291)))"
22150006690000,110,52,58,42.3,"MULTIPOLYGON(((9.84855653380749 60.246516617708714,9.841505190951535 60.2912294358707,9.931587534005702 60.294704896044095,9.938517036293034 60.24998581633684,9.84855653380749 60.246516617708714)))"
22200006690000,20,7,13,40.1,"MULTIPOLYGON(((9.938517036293034 60.24998581633684,9.931587534005702 60.294704896044095,10.02169192599582 60.29811939600953,10.028499489489734 60.2533941632923,9.938517036293034 60.24998581633684)))"
22300006690000,1209,607,602,41,"MULTIPOLYGON(((10.11850351223202 60.25674162929938,10.11181798408365 60.301472906370115,10.201965324850056 60.30476539824122,10.208528722777721 60.26002818559267,10.11850351223202 60.25674162929938)))"
22350006690000,5,3,2,69.2,"MULTIPOLYGON(((10.208528722777721 60.26002818559267,10.201965324850056 60.30476539824122,10.292133564304839 60.30799684325155,10.298574738817843 60.2632538039179,10.208528722777721 60.26002818559267)))"
22400006690000,64,32,32,43.9,"MULTIPOLYGON(((10.298574738817843 60.2632538039179,10.292133564304839 60.30799684325155,10.38232231789663 60.31116721354389,10.38864117748641 60.26641845653294,10.298574738817843 60.2632538039179)))"
22450006690000,370,187,183,46.6,"MULTIPOLYGON(((10.38864117748641 60.26641845653294,10.38232231789663 60.31116721354389,10.472531200522823 60.314276481776176,10.4787276553703 60.2695221162086,10.38864117748641 60.26641845653294)))"
22500006690000,1176,599,577,43.1,"MULTIPOLYGON(((10.4787276553703 60.2695221162086,10.472531200522823 60.314276481776176,10.56275982653954 60.317324621122246,10.568833788519152 60.27256475622956,10.4787276553703 60.2695221162086)))"
22550006690000,2822,1413,1409,43.1,"MULTIPOLYGON(((10.568833788519152 60.27256475622956,10.56275982653954 60.317324621122246,10.653007809771628 60.32031160527276,10.658959192455281 60.27554635039531,10.568833788519152 60.27256475622956)))"
22600006690000,443,222,221,44.5,"MULTIPOLYGON(((10.658959192455281 60.27554635039531,10.653007809771628 60.32031160527276,10.743274763522692 60.32323740843609,10.749103482183651 60.27846687302082,10.658959192455281 60.27554635039531)))"
22800006690000,66,36,30,43.1,"MULTIPOLYGON(((11.019645808621753 60.28686176255701,11.014185573319033 60.331647481869005,11.104524532110586 60.3343283135495,11.109861781572313 60.28953775251191,11.019645808621753 60.28686176255701)))"
22850006690000,1797,901,896,40.6,"MULTIPOLYGON(((11.109861781572313 60.28953775251191,11.104524532110586 60.3343283135495,11.194880520474307 60.3369478430784,11.200094707930745 60.292152550263786,11.109861781572313 60.28953775251191)))"
22900006690000,4947,2400,2547,41.8,"MULTIPOLYGON(((11.200094707930745 60.292152550263786,11.194880520474307 60.3369478430784,11.285253148799061 60.33950604778706,11.290344199809029 60.29470613323796,11.200094707930745 60.292152550263786)))"
22950006690000,1989,1022,967,41.1,"MULTIPOLYGON(((11.290344199809029 60.29470613323796,11.285253148799061 60.33950604778706,11.375642027023689 60.3420029055301,11.38060986887246 60.29719847938081,11.290344199809029 60.29470613323796)))"
23100006690000,244,130,114,43.5,"MULTIPOLYGON(((11.56118818304395 60.30199937556774,11.556466970739528 60.346812494157895,11.646902253951055 60.349125183374156,11.651500049341385 60.30430788411617,11.56118818304395 60.30199937556774)))"
23150006690000,276,142,134,44.2,"MULTIPOLYGON(((11.651500049341385 60.30430788411617,11.646902253951055 60.349125183374156,11.737352222523825 60.3513764422892,11.74182653522331 60.306555072843445,11.651500049341385 60.30430788411617)))"
23200006690000,43,21,22,43.2,"MULTIPOLYGON(((11.74182653522331 60.306555072843445,11.737352222523825 60.3513764422892,11.827816484301547 60.353566251384024,11.832167250275566 60.30874092231164,11.74182653522331 60.306555072843445)))"
23250006690000,15,7,8,39.5,"MULTIPOLYGON(((11.832167250275566 60.30874092231164,11.827816484301547 60.353566251384024,11.918294646740108 60.35569459166692,11.922521803699082 60.31086541360791,11.832167250275566 60.30874092231164)))"
23300006690000,394,214,180,44.7,"MULTIPOLYGON(((11.922521803699082 60.31086541360791,11.918294646740108 60.35569459166692,12.008786316918053 60.357761444674026,12.012889804320269 60.3129285283451,11.922521803699082 60.31086541360791)))"
23350006690000,385,187,198,45.6,"MULTIPOLYGON(((12.012889804320269 60.3129285283451,12.008786316918053 60.357761444674026,12.09929110154707 60.35976679247006,12.10327086060143 60.31493024866242,12.012889804320269 60.3129285283451)))"
23450006690000,15,7,8,46.7,"MULTIPOLYGON(((12.193664580651198 60.31687055722597,12.189808606982504 60.36171061764871,12.280338439233901 60.3635929033334,12.284070572234993 60.31874943722929,12.193664580651198 60.31687055722597)))"
23500006690000,85,46,39,55.2,"MULTIPOLYGON(((12.284070572234993 60.31874943722929,12.280338439233901 60.3635929033334,12.370880203975574 60.3654136331777,12.374488442785529 60.32056687239399,12.284070572234993 60.31874943722929)))"
23550006690000,2,2,0,0,"MULTIPOLYGON(((12.374488442785529 60.32056687239399,12.370880203975574 60.3654136331777,12.461433506557189 60.36717279136596,12.464917799413293 60.32232284697016,12.374488442785529 60.32056687239399)))"
23600006690000,3,2,1,0,"MULTIPOLYGON(((12.464917799413293 60.32232284697016,12.461433506557189 60.36717279136596,12.551997952014375 60.36887036261376,12.555358248917104 60.32401734573699,12.464917799413293 60.32232284697016)))"
19450006695000,15,9,6,51,"MULTIPOLYGON(((5.020140944191362 60.0140409757343,5.006658488675687 60.05825650952872,5.095116003609434 60.064978321980874,5.108483923876556 60.02075086852256,5.020140944191362 60.0140409757343)))"
19500006695000,30,14,16,67.7,"MULTIPOLYGON(((5.108483923876556 60.02075086852256,5.095116003609434 60.064978321980874,5.183615304051565 60.071641391334154,5.196868507671419 60.027402117598335,5.108483923876556 60.02075086852256)))"
19550006695000,520,286,234,41.7,"MULTIPOLYGON(((5.196868507671419 60.027402117598335,5.183615304051565 60.071641391334154,5.272156050531945 60.07824566209627,5.285294357459905 60.03399466769055,5.196868507671419 60.027402117598335)))"
19600006695000,74,38,36,48.1,"MULTIPOLYGON(((5.285294357459905 60.03399466769055,5.272156050531945 60.07824566209627,5.360737902531703 60.084791079217304,5.37376113408473 60.040528463968954,5.285294357459905 60.03399466769055)))"
19650006695000,22,12,10,63.8,"MULTIPOLYGON(((5.37376113408473 60.040528463968954,5.360737902531703 60.084791079217304,5.44936051849031 60.091277588091295,5.462268497354382 60.04700345204572,5.37376113408473 60.040528463968954)))"
19700006695000,70,35,35,38.3,"MULTIPOLYGON(((5.462268497354382 60.04700345204572,5.44936051849031 60.091277588091295,5.53802355581269 60.09770513455806,5.550816106050211 60.05341957797718,5.462268497354382 60.04700345204572)))"
19750006695000,57,32,25,39.3,"MULTIPOLYGON(((5.550816106050211 60.05341957797718,5.53802355581269 60.09770513455806,5.62672667087643 60.10407366490475,5.639403617933599 60.059776788265324,5.550816106050211 60.05341957797718)))"
19800006695000,134,62,72,45.5,"MULTIPOLYGON(((5.639403617933599 60.059776788265324,5.62672667087643 60.10407366490475,5.715469519039045 60.110383125867514,5.728030689753147 60.06607502985955,5.639403617933599 60.059776788265324)))"
19850006695000,97,48,49,52.7,"MULTIPOLYGON(((5.728030689753147 60.06607502985955,5.715469519039045 60.110383125867514,5.804251754645274 60.11663346463299,5.816696977251959 60.07231425015824,5.728030689753147 60.06607502985955)))"
19900006695000,7,4,3,69.7,"MULTIPOLYGON(((5.816696977251959 60.07231425015824,5.804251754645274 60.11663346463299,5.893073031034493 60.122824628840185,5.905402135175 60.078494397010296,5.816696977251959 60.07231425015824)))"
19950006695000,138,68,70,55.1,"MULTIPOLYGON(((5.905402135175 60.078494397010296,5.893073031034493 60.122824628840185,5.98193300054814 60.12895656658183,5.994145817276467 60.08461541871682,5.905402135175 60.078494397010296)))"
20000006695000,56,30,26,54,"MULTIPOLYGON(((5.994145817276467 60.08461541871682,5.98193300054814 60.12895656658183,6.070831314537236 60.13502922640603,6.082927676327258 60.09067726403267,5.994145817276467 60.08461541871682)))"
20050006695000,23,13,10,51.2,"MULTIPOLYGON(((6.082927676327258 60.09067726403267,6.070831314537236 60.13502922640603,6.159767623369941 60.141042557317995,6.171747364122506 60.09667988216798,6.082927676327258 60.09067726403267)))"
20100006695000,27,17,10,44.4,"MULTIPOLYGON(((6.171747364122506 60.09667988216798,6.159767623369941 60.141042557317995,6.248741576439192 60.14699650878139,6.260604531489144 60.10262322278977,6.171747364122506 60.09667988216798)))"
20150006695000,101,50,51,39.8,"MULTIPOLYGON(((6.260604531489144 60.10262322278977,6.248741576439192 60.14699650878139,6.337752822170393 60.15289103072001,6.349498828293562 60.108507236023456,6.260604531489144 60.10262322278977)))"
20300006695000,62,31,31,47.8,"MULTIPOLYGON(((6.527397404924802 60.12009708312951,6.515885780529212 60.16450158802793,6.605006785240044 60.170217525559195,6.616400979751268 60.125802819558544,6.527397404924802 60.12009708312951)))"
20350006695000,6,3,3,37,"MULTIPOLYGON(((6.616400979751268 60.125802819558544,6.605006785240044 60.170217525559195,6.694163666795078 60.175873837892645,6.705440274030491 60.13144903371578,6.616400979751268 60.125802819558544)))"
21400006695000,1,0,1,0,"MULTIPOLYGON(((8.493174356850439 60.23180385446287,8.484280228242355 60.27640872359874,8.574106863234134 60.28080260884519,8.582880449977834 60.23618984478386,8.493174356850439 60.23180385446287)))"
21450006695000,91,48,43,42.2,"MULTIPOLYGON(((8.582880449977834 60.23618984478386,8.574106863234134 60.28080260884519,8.663961336932775 60.28513592888296,8.672614258329537 60.24051537664721,8.582880449977834 60.23618984478386)))"
21500006695000,90,50,40,44,"MULTIPOLYGON(((8.672614258329537 60.24051537664721,8.663961336932775 60.28513592888296,8.75384327475938 60.28940864660061,8.762375408935487 60.244780413093665,8.672614258329537 60.24051537664721)))"
21550006695000,459,242,217,45,"MULTIPOLYGON(((8.762375408935487 60.244780413093665,8.75384327475938 60.28940864660061,8.843752301405944 60.29362072538522,8.8521635281019 60.24898491766039,8.762375408935487 60.244780413093665)))"
21600006695000,322,163,159,43.9,"MULTIPOLYGON(((8.8521635281019 60.24898491766039,8.843752301405944 60.29362072538522,8.933688040844647 60.297772129123416,8.941978241420497 60.25312885438231,8.8521635281019 60.24898491766039)))"
21650006695000,530,262,268,45.5,"MULTIPOLYGON(((8.941978241420497 60.25312885438231,8.933688040844647 60.297772129123416,9.023650116337189 60.30186282220263,9.031819173777738 60.25721218779304,8.941978241420497 60.25312885438231)))"
21800006695000,34,19,15,56.4,"MULTIPOLYGON(((9.211578191683655 60.26519690531628,9.203651765034312 60.309861936444506,9.29369058129435 60.313770288896,9.301495523562984 60.26909822100016,9.211578191683655 60.26519690531628)))"
22050006695000,16,9,7,67.1,"MULTIPOLYGON(((9.661408180040567 60.28409575504355,9.654090263419757 60.32879488953003,9.744249382617115 60.33239867574581,9.75144527908082 60.287693045397624,9.661408180040567 60.28409575504355)))"
22100006695000,7,4,3,59,"MULTIPOLYGON(((9.75144527908082 60.287693045397624,9.744249382617115 60.33239867574581,9.83443141681204 60.335941453506976,9.841505190951535 60.2912294358707,9.75144527908082 60.287693045397624)))"
22150006695000,29,16,13,41.1,"MULTIPOLYGON(((9.841505190951535 60.2912294358707,9.83443141681204 60.335941453506976,9.92463598268397 60.33942319226884,9.931587534005702 60.294704896044095,9.841505190951535 60.2912294358707)))"
22250006695000,19,11,8,57.7,"MULTIPOLYGON(((10.02169192599582 60.29811939600953,10.014862696307366 60.34284386199909,10.105111173161522 60.34620343317893,10.11181798408365 60.301472906370115,10.02169192599582 60.29811939600953)))"
22300006695000,249,129,120,47,"MULTIPOLYGON(((10.11181798408365 60.301472906370115,10.105111173161522 60.34620343317893,10.195381028140487 60.3495018768039,10.201965324850056 60.30476539824122,10.11181798408365 60.301472906370115)))"
22400006695000,117,63,54,45.6,"MULTIPOLYGON(((10.292133564304839 60.30799684325155,10.285671875562947 60.35273916438491,10.37598332918223 60.3559152679491,10.38232231789663 60.31116721354389,10.292133564304839 60.30799684325155)))"
22450006695000,723,378,345,43.5,"MULTIPOLYGON(((10.38232231789663 60.31116721354389,10.37598332918223 60.3559152679491,10.466315002196279 60.35903016004078,10.472531200522823 60.314276481776176,10.38232231789663 60.31116721354389)))"
22500006695000,705,384,321,44.5,"MULTIPOLYGON(((10.472531200522823 60.314276481776176,10.466315002196279 60.35903016004078,10.556666507257686 60.36208381372232,10.56275982653954 60.317324621122246,10.472531200522823 60.314276481776176)))"
22550006695000,1801,867,934,47.3,"MULTIPOLYGON(((10.56275982653954 60.317324621122246,10.556666507257686 60.36208381372232,10.6470374564838 60.365076202575004,10.653007809771628 60.32031160527276,10.56275982653954 60.317324621122246)))"
22600006695000,3,1,2,0,"MULTIPOLYGON(((10.653007809771628 60.32031160527276,10.6470374564838 60.365076202575004,10.737427461466797 60.36800730069992,10.743274763522692 60.32323740843609,10.653007809771628 60.32031160527276)))"
22750006695000,305,161,144,40.6,"MULTIPOLYGON(((10.923864033250469 60.328905371227954,10.918263082507309 60.37368552377465,11.008707919214896 60.37643259953303,11.014185573319033 60.331647481869005,10.923864033250469 60.328905371227954)))"
22800006695000,249,134,115,45.2,"MULTIPOLYGON(((11.014185573319033 60.331647481869005,11.008707919214896 60.37643259953303,11.099170252999976 60.3791182861824,11.104524532110586 60.3343283135495,11.014185573319033 60.331647481869005)))"
22850006695000,34,18,16,39,"MULTIPOLYGON(((11.104524532110586 60.3343283135495,11.099170252999976 60.3791182861824,11.18964969298182 60.38174256043505,11.194880520474307 60.3369478430784,11.104524532110586 60.3343283135495)))"
22900006695000,991,516,475,40.4,"MULTIPOLYGON(((11.194880520474307 60.3369478430784,11.18964969298182 60.38174256043505,11.280145847815932 60.38430539952789,11.285253148799061 60.33950604778706,11.194880520474307 60.3369478430784)))"
22950006695000,452,235,217,42.4,"MULTIPOLYGON(((11.285253148799061 60.33950604778706,11.280145847815932 60.38430539952789,11.370658325704383 60.38680678122316,11.375642027023689 60.3420029055301,11.285253148799061 60.33950604778706)))"
23050006695000,344,176,168,45.1,"MULTIPOLYGON(((11.466046764647283 60.344438394686016,11.461186734406189 60.38924668380916,11.55173068124771 60.391625086100994,11.556466970739528 60.346812494157895,11.466046764647283 60.344438394686016)))"
23100006695000,347,179,168,42.8,"MULTIPOLYGON(((11.556466970739528 60.346812494157895,11.55173068124771 60.391625086100994,11.642289773133102 60.39394196744118,11.646902253951055 60.349125183374156,11.556466970739528 60.346812494157895)))"
23150006695000,333,169,164,48.1,"MULTIPOLYGON(((11.646902253951055 60.349125183374156,11.642289773133102 60.39394196744118,11.732863616554752 60.396197307700454,11.737352222523825 60.3513764422892,11.646902253951055 60.349125183374156)))"
23200006695000,11,8,3,52.7,"MULTIPOLYGON(((11.737352222523825 60.3513764422892,11.732863616554752 60.396197307700454,11.82345181760379 60.39839108727827,11.827816484301547 60.353566251384024,11.737352222523825 60.3513764422892)))"
23250006695000,2,1,1,0,"MULTIPOLYGON(((11.827816484301547 60.353566251384024,11.82345181760379 60.39839108727827,11.914053981980606 60.400523287103596,11.918294646740108 60.35569459166692,11.827816484301547 60.353566251384024)))"
23300006695000,85,48,37,43.9,"MULTIPOLYGON(((11.918294646740108 60.35569459166692,11.914053981980606 60.400523287103596,12.004669715005377 60.402593888635444,12.008786316918053 60.357761444674026,11.918294646740108 60.35569459166692)))"
23350006695000,298,149,149,49.8,"MULTIPOLYGON(((12.008786316918053 60.357761444674026,12.004669715005377 60.402593888635444,12.095298621628661 60.40460287386352,12.09929110154707 60.35976679247006,12.008786316918053 60.357761444674026)))"
23400006695000,6,2,4,30,"MULTIPOLYGON(((12.09929110154707 60.35976679247006,12.095298621628661 60.40460287386352,12.185940306441976 60.406550225308756,12.189808606982504 60.36171061764871,12.09929110154707 60.35976679247006)))"
23450006695000,13,7,6,47.1,"MULTIPOLYGON(((12.189808606982504 60.36171061764871,12.185940306441976 60.406550225308756,12.276594373688422 60.408435926024005,12.280338439233901 60.3635929033334,12.189808606982504 60.36171061764871)))"
23500006695000,14,9,5,54.9,"MULTIPOLYGON(((12.280338439233901 60.3635929033334,12.276594373688422 60.408435926024005,12.367260427273335 60.41025995959447,12.370880203975574 60.3654136331777,12.280338439233901 60.3635929033334)))"
23550006695000,29,15,14,53,"MULTIPOLYGON(((12.370880203975574 60.3654136331777,12.367260427273335 60.41025995959447,12.457938070774942 60.41202231013829,12.461433506557189 60.36717279136596,12.370880203975574 60.3654136331777)))"
23600006695000,15,6,9,45.2,"MULTIPOLYGON(((12.461433506557189 60.36717279136596,12.457938070774942 60.41202231013829,12.548626907455056 60.41372296230712,12.551997952014375 60.36887036261376,12.461433506557189 60.36717279136596)))"
23650006695000,12,7,5,41.3,"MULTIPOLYGON(((12.551997952014375 60.36887036261376,12.548626907455056 60.41372296230712,12.639326540269792 60.4153619012865,12.642573145079359 60.370506332168446,12.551997952014375 60.36887036261376)))"
19450006700000,8,3,5,60.6,"MULTIPOLYGON(((5.006658488675687 60.05825650952872,4.993133909060119 60.102469910046544,5.08170629765797 60.10920367358112,5.095116003609434 60.064978321980874,5.006658488675687 60.05825650952872)))"
19500006700000,350,189,161,35.7,"MULTIPOLYGON(((5.095116003609434 60.064978321980874,5.08170629765797 60.10920367358112,5.170320654218674 60.11587859439421,5.183615304051565 60.071641391334154,5.095116003609434 60.064978321980874)))"
19550006700000,2146,1082,1064,37.5,"MULTIPOLYGON(((5.183615304051565 60.071641391334154,5.170320654218674 60.11587859439421,5.258976637910994 60.12249461677104,5.272156050531945 60.07824566209627,5.183615304051565 60.071641391334154)))"
19600006700000,37,17,20,38.7,"MULTIPOLYGON(((5.272156050531945 60.07824566209627,5.258976637910994 60.12249461677104,5.347673906847414 60.12905168544076,5.360737902531703 60.084791079217304,5.272156050531945 60.07824566209627)))"
19750006700000,2,1,1,0,"MULTIPOLYGON(((5.53802355581269 60.09770513455806,5.525190927663792 60.141988742805324,5.614009990551596 60.14836862319335,5.62672667087643 60.10407366490475,5.53802355581269 60.09770513455806)))"
19800006700000,40,21,19,43.5,"MULTIPOLYGON(((5.62672667087643 60.10407366490475,5.614009990551596 60.14836862319335,5.702868960713759 60.15468933326387,5.715469519039045 60.110383125867514,5.62672667087643 60.10407366490475)))"
19850006700000,174,95,79,53,"MULTIPOLYGON(((5.715469519039045 60.110383125867514,5.702868960713759 60.15468933326387,5.791767491089276 60.16095081999076,5.804251754645274 60.11663346463299,5.715469519039045 60.110383125867514)))"
19950006700000,119,63,56,47.5,"MULTIPOLYGON(((5.893073031034493 60.122824628840185,5.880705233604487 60.16715303080183,5.969681839180567 60.17329591358031,5.98193300054814 60.12895656658183,5.893073031034493 60.122824628840185)))"
20000006700000,4,2,2,0,"MULTIPOLYGON(((5.98193300054814 60.12895656658183,5.969681839180567 60.17329591358031,6.058696957741074 60.17937941666649,6.070831314537236 60.13502922640603,5.98193300054814 60.12895656658183)))"
20050006700000,28,13,15,44.1,"MULTIPOLYGON(((6.070831314537236 60.13502922640603,6.058696957741074 60.17937941666649,6.147750238219573 60.18540348885942,6.159767623369941 60.141042557317995,6.070831314537236 60.13502922640603)))"
20150006700000,22,14,8,57.3,"MULTIPOLYGON(((6.248741576439192 60.14699650878139,6.236841328567323 60.19136807941828,6.325969875760988 60.197273138064126,6.337752822170393 60.15289103072001,6.248741576439192 60.14699650878139)))"
20300006700000,125,65,60,47.3,"MULTIPOLYGON(((6.515885780529212 60.16450158802793,6.50433792376679 60.20890446081935,6.593576713729922 60.21463062669377,6.605006785240044 60.170217525559195,6.515885780529212 60.16450158802793)))"
20350006700000,81,44,37,38.4,"MULTIPOLYGON(((6.605006785240044 60.170217525559195,6.593576713729922 60.21463062669377,6.682851538856885 60.22029706418835,6.694163666795078 60.175873837892645,6.605006785240044 60.170217525559195)))"
21400006700000,140,73,67,43.8,"MULTIPOLYGON(((8.484280228242355 60.27640872359874,8.47535788696223 60.32101249918792,8.565305437660513 60.325414300732355,8.574106863234134 60.28080260884519,8.484280228242355 60.27640872359874)))"
21450006700000,9,4,5,51,"MULTIPOLYGON(((8.574106863234134 60.28080260884519,8.565305437660513 60.325414300732355,8.655280951286539 60.329755430039334,8.663961336932775 60.28513592888296,8.574106863234134 60.28080260884519)))"
21600006700000,32,16,16,49.3,"MULTIPOLYGON(((8.843752301405944 60.29362072538522,8.835314361799423 60.3382555233837,8.925371504098116 60.342414414394675,8.933688040844647 60.297772129123416,8.843752301405944 60.29362072538522)))"
21650006700000,76,44,32,47.4,"MULTIPOLYGON(((8.933688040844647 60.297772129123416,8.925371504098116 60.342414414394675,9.015455100166959 60.3465124871178,9.023650116337189 60.30186282220263,8.933688040844647 60.297772129123416)))"
21750006700000,20,14,6,53.6,"MULTIPOLYGON(((9.113638150444128 60.305892769512205,9.105564770927147 60.35054970629727,9.195700136602996 60.35452603718241,9.203651765034312 60.309861936444506,9.113638150444128 60.305892769512205)))"
21800006700000,2,0,2,0,"MULTIPOLYGON(((9.203651765034312 60.309861936444506,9.195700136602996 60.35452603718241,9.285860816731478 60.35844144552864,9.29369058129435 60.313770288896,9.203651765034312 60.309861936444506)))"
21950006700000,9,5,4,45.3,"MULTIPOLYGON(((9.473842300216193 60.32140441646994,9.466256595115002 60.36608936016357,9.556490929093657 60.36982180050375,9.56395444192572 60.32513012591583,9.473842300216193 60.32140441646994)))"
22000006700000,49,26,23,44.6,"MULTIPOLYGON(((9.56395444192572 60.32513012591583,9.556490929093657 60.36982180050375,9.646749048991534 60.37349318641013,9.654090263419757 60.32879488953003,9.56395444192572 60.32513012591583)))"
22050006700000,39,21,18,42.5,"MULTIPOLYGON(((9.654090263419757 60.32879488953003,9.646749048991534 60.37349318641013,9.737030571053381 60.377103486185156,9.744249382617115 60.33239867574581,9.654090263419757 60.32879488953003)))"
22100006700000,34,18,16,50.6,"MULTIPOLYGON(((9.744249382617115 60.33239867574581,9.737030571053381 60.377103486185156,9.827335110894698 60.38065266864379,9.83443141681204 60.335941453506976,9.744249382617115 60.33239867574581)))"
22150006700000,63,34,29,47.6,"MULTIPOLYGON(((9.83443141681204 60.335941453506976,9.827335110894698 60.38065266864379,9.917662283511582 60.38414070311452,9.92463598268397 60.33942319226884,9.83443141681204 60.335941453506976)))"
22250006700000,209,110,99,42.2,"MULTIPOLYGON(((10.014862696307366 60.34284386199909,10.008011703290604 60.38756755944038,10.098382984018706 60.39093320797994,10.105111173161522 60.34620343317893,10.014862696307366 60.34284386199909)))"
22300006700000,5,4,1,32.8,"MULTIPOLYGON(((10.105111173161522 60.34620343317893,10.098382984018706 60.39093320797994,10.188775738893188 60.39423761960819,10.195381028140487 60.3495018768039,10.105111173161522 60.34620343317893)))"
22400006700000,26,15,11,48.6,"MULTIPOLYGON(((10.285671875562947 60.35273916438491,10.279189580531677 60.39748076571763,10.36962412098218 60.40066261821902,10.37598332918223 60.3559152679491,10.285671875562947 60.35273916438491)))"
22450006700000,405,213,192,42.2,"MULTIPOLYGON(((10.37598332918223 60.3559152679491,10.36962412098218 60.40066261821902,10.460078971733154 60.40378314954245,10.466315002196279 60.35903016004078,10.37598332918223 60.3559152679491)))"
22500006700000,1543,786,757,44.1,"MULTIPOLYGON(((10.466315002196279 60.35903016004078,10.460078971733154 60.40378314954245,10.550553743723603 60.40684233263811,10.556666507257686 60.36208381372232,10.466315002196279 60.35903016004078)))"
22550006700000,3313,1616,1697,43.7,"MULTIPOLYGON(((10.556666507257686 60.36208381372232,10.550553743723603 60.40684233263811,10.64104804735325 60.409840140977295,10.6470374564838 60.365076202575004,10.556666507257686 60.36208381372232)))"
22700006700000,8,5,3,30.4,"MULTIPOLYGON(((10.827836133283851 60.37087708271874,10.822093688493691 60.41565152988164,10.912644244199292 60.418465060002276,10.918263082507309 60.37368552377465,10.827836133283851 60.37087708271874)))"
22750006700000,23,13,10,35,"MULTIPOLYGON(((10.918263082507309 60.37368552377465,10.912644244199292 60.418465060002276,11.003212767954253 60.421217114478985,11.008707919214896 60.37643259953303,10.918263082507309 60.37368552377465)))"
22800006700000,773,380,393,42.9,"MULTIPOLYGON(((11.008707919214896 60.37643259953303,11.003212767954253 60.421217114478985,11.093798867615302 60.42390766940087,11.099170252999976 60.3791182861824,11.008707919214896 60.37643259953303)))"
22850006700000,23,14,9,42.6,"MULTIPOLYGON(((11.099170252999976 60.3791182861824,11.093798867615302 60.42390766940087,11.184402150561494 60.42653670138308,11.18964969298182 60.38174256043505,11.099170252999976 60.3791182861824)))"
22900006700000,1378,729,649,42.7,"MULTIPOLYGON(((11.18964969298182 60.38174256043505,11.184402150561494 60.42653670138308,11.275022223704621 60.42910418756746,11.280145847815932 60.38430539952789,11.18964969298182 60.38174256043505)))"
22950006700000,36,18,18,41.9,"MULTIPOLYGON(((11.280145847815932 60.38430539952789,11.275022223704621 60.42910418756746,11.365658693499615 60.431610105623385,11.370658325704383 60.38680678122316,11.280145847815932 60.38430539952789)))"
23000006700000,19,8,11,45.5,"MULTIPOLYGON(((11.370658325704383 60.38680678122316,11.365658693499615 60.431610105623385,11.456311165955006 60.43405443374841,11.461186734406189 60.38924668380916,11.370658325704383 60.38680678122316)))"
23050006700000,1394,684,710,49.4,"MULTIPOLYGON(((11.461186734406189 60.38924668380916,11.456311165955006 60.43405443374841,11.546979246643405 60.43643715066912,11.55173068124771 60.391625086100994,11.461186734406189 60.38924668380916)))"
23100006700000,384,187,197,46.1,"MULTIPOLYGON(((11.55173068124771 60.391625086100994,11.546979246643405 60.43643715066912,11.637662540712011 60.43875823564169,11.642289773133102 60.39394196744118,11.55173068124771 60.391625086100994)))"
23150006700000,625,303,322,48,"MULTIPOLYGON(((11.642289773133102 60.39394196744118,11.637662540712011 60.43875823564169,11.728360652893164 60.441017668452616,11.732863616554752 60.396197307700454,11.642289773133102 60.39394196744118)))"
23300006700000,42,22,20,49.9,"MULTIPOLYGON(((11.914053981980606 60.400523287103596,11.909799748511539 60.445351499391286,12.00053993943435 60.447425859749565,12.004669715005377 60.402593888635444,11.914053981980606 60.400523287103596)))"
23350006700000,919,453,466,45.4,"MULTIPOLYGON(((12.004669715005377 60.402593888635444,12.00053993943435 60.447425859749565,12.091293363462153 60.44943849240856,12.095298621628661 60.40460287386352,12.004669715005377 60.402593888635444)))"
23400006700000,227,126,101,48.3,"MULTIPOLYGON(((12.095298621628661 60.40460287386352,12.091293363462153 60.44943849240856,12.182059623412016 60.451389379816064,12.185940306441976 60.406550225308756,12.095298621628661 60.40460287386352)))"
23450006700000,31,20,11,60.5,"MULTIPOLYGON(((12.185940306441976 60.406550225308756,12.182059623412016 60.451389379816064,12.27283832174996 60.453278504953886,12.276594373688422 60.408435926024005,12.185940306441976 60.406550225308756)))"
23500006700000,8,4,4,56,"MULTIPOLYGON(((12.276594373688422 60.408435926024005,12.27283832174996 60.453278504953886,12.363629060601665 60.45510585133845,12.367260427273335 60.41025995959447,12.276594373688422 60.408435926024005)))"
23550006700000,201,96,105,57.9,"MULTIPOLYGON(((12.367260427273335 60.41025995959447,12.363629060601665 60.45510585133845,12.454431441763237 60.45687140302137,12.457938070774942 60.41202231013829,12.367260427273335 60.41025995959447)))"
23600006700000,11,6,5,63.4,"MULTIPOLYGON(((12.457938070774942 60.41202231013829,12.454431441763237 60.45687140302137,12.545245066711956 60.45857514458993,12.548626907455056 60.41372296230712,12.457938070774942 60.41202231013829)))"
23650006700000,27,13,14,49.1,"MULTIPOLYGON(((12.548626907455056 60.41372296230712,12.545245066711956 60.45857514458993,12.636069536617097 60.46021706116761,12.639326540269792 60.4153619012865,12.548626907455056 60.41372296230712)))"
19450006705000,34,19,15,55.5,"MULTIPOLYGON(((4.993133909060119 60.102469910046544,4.979567021535411 60.14668116938608,5.068254623566435 60.153426915558434,5.08170629765797 60.10920367358112,4.993133909060119 60.102469910046544)))"
19500006705000,391,197,194,38.2,"MULTIPOLYGON(((5.08170629765797 60.10920367358112,5.068254623566435 60.153426915558434,5.156984377078111 60.16011371914952,5.170320654218674 60.11587859439421,5.08170629765797 60.10920367358112)))"
19550006705000,18,9,9,40.6,"MULTIPOLYGON(((5.170320654218674 60.11587859439421,5.156984377078111 60.16011371914952,5.245755939871077 60.16674152422084,5.258976637910994 60.12249461677104,5.170320654218674 60.11587859439421)))"
19600006705000,120,61,59,45.9,"MULTIPOLYGON(((5.258976637910994 60.12249461677104,5.245755939871077 60.16674152422084,5.334568968682049 60.173310275279455,5.347673906847414 60.12905168544076,5.258976637910994 60.12249461677104)))"
19650006705000,4404,2253,2151,36.1,"MULTIPOLYGON(((5.347673906847414 60.12905168544076,5.334568968682049 60.173310275279455,5.423423119190997 60.17981991727962,5.436412118091242 60.135549745578146,5.347673906847414 60.12905168544076)))"
19700006705000,5090,2576,2514,38.4,"MULTIPOLYGON(((5.436412118091242 60.135549745578146,5.423423119190997 60.17981991727962,5.51231804602838 60.18627039562453,5.525190927663792 60.141988742805324,5.436412118091242 60.135549745578146)))"
19750006705000,334,165,169,42.4,"MULTIPOLYGON(((5.525190927663792 60.141988742805324,5.51231804602838 60.18627039562453,5.60125340278239 60.19266165616793,5.614009990551596 60.14836862319335,5.525190927663792 60.141988742805324)))"
19800006705000,541,265,276,42.5,"MULTIPOLYGON(((5.614009990551596 60.14836862319335,5.60125340278239 60.19266165616793,5.69022884200634 60.19899364521587,5.702868960713759 60.15468933326387,5.614009990551596 60.14836862319335)))"
19850006705000,215,119,96,47.4,"MULTIPOLYGON(((5.702868960713759 60.15468933326387,5.69022884200634 60.19899364521587,5.77924401522605 60.20526630952823,5.791767491089276 60.16095081999076,5.702868960713759 60.15468933326387)))"
19900006705000,43,22,21,43.4,"MULTIPOLYGON(((5.791767491089276 60.16095081999076,5.77924401522605 60.20526630952823,5.868298572947341 60.21147959632041,5.880705233604487 60.16715303080183,5.791767491089276 60.16095081999076)))"
19950006705000,44,24,20,51,"MULTIPOLYGON(((5.880705233604487 60.16715303080183,5.868298572947341 60.21147959632041,5.95739216466356 60.21763345326501,5.969681839180567 60.17329591358031,5.880705233604487 60.16715303080183)))"
20000006705000,151,85,66,43.8,"MULTIPOLYGON(((5.969681839180567 60.17329591358031,5.95739216466356 60.21763345326501,6.046524438863194 60.223727828493324,6.058696957741074 60.17937941666649,5.969681839180567 60.17329591358031)))"
20050006705000,113,59,54,46.2,"MULTIPOLYGON(((6.058696957741074 60.17937941666649,6.046524438863194 60.223727828493324,6.135695043037531 60.22976267059705,6.147750238219573 60.18540348885942,6.058696957741074 60.17937941666649)))"
20100006705000,19,11,8,42.6,"MULTIPOLYGON(((6.147750238219573 60.18540348885942,6.135695043037531 60.22976267059705,6.2249036236884 60.2357379286298,6.236841328567323 60.19136807941828,6.147750238219573 60.18540348885942)))"
20300006705000,186,97,89,43.7,"MULTIPOLYGON(((6.50433792376679 60.20890446081935,6.49275367484037 60.25330569580077,6.582110606900146 60.25904211737979,6.593576713729922 60.21463062669377,6.50433792376679 60.20890446081935)))"
20350006705000,302,151,151,39.3,"MULTIPOLYGON(((6.593576713729922 60.21463062669377,6.582110606900146 60.25904211737979,6.67150373337834 60.264718707139906,6.682851538856885 60.22029706418835,6.593576713729922 60.21463062669377)))"
21400006705000,9,4,5,45.8,"MULTIPOLYGON(((8.47535788696223 60.32101249918792,8.466407207175676 60.36561517792922,8.55647604903517 60.370024917240286,8.565305437660513 60.325414300732355,8.47535788696223 60.32101249918792)))"
21600006705000,16,8,8,48.8,"MULTIPOLYGON(((8.835314361799423 60.3382555233837,8.826849589930994 60.382889308732025,8.917028513463698 60.3870557073637,8.925371504098116 60.342414414394675,8.835314361799423 60.3382555233837)))"
21750006705000,2,1,1,0,"MULTIPOLYGON(((9.105564770927147 60.35054970629727,9.097465696379945 60.39520569062797,9.187723193606084 60.3991892049643,9.195700136602996 60.35452603718241,9.105564770927147 60.35054970629727)))"
21950006705000,51,30,21,45.4,"MULTIPOLYGON(((9.466256595115002 60.36608936016357,9.458646720870235 60.410773427684276,9.549003630235859 60.41451261727311,9.556490929093657 60.36982180050375,9.466256595115002 60.36608936016357)))"
22000006705000,212,120,92,45.3,"MULTIPOLYGON(((9.556490929093657 60.36982180050375,9.549003630235859 60.41451261727311,9.639384432294467 60.41819064353813,9.646749048991534 60.37349318641013,9.556490929093657 60.36982180050375)))"
22100006705000,6,4,2,53.8,"MULTIPOLYGON(((9.737030571053381 60.377103486185156,9.729788741606939 60.42180747465013,9.820216172100203 60.425363079294506,9.827335110894698 60.38065266864379,9.737030571053381 60.377103486185156)))"
22250006705000,120,70,50,43.5,"MULTIPOLYGON(((10.008011703290604 60.38756755944038,10.001138849226479 60.432290486500904,10.091633320632898 60.43566222901577,10.098382984018706 60.39093320797994,10.008011703290604 60.38756755944038)))"
22300006705000,28,16,12,50.6,"MULTIPOLYGON(((10.098382984018706 60.39093320797994,10.091633320632898 60.43566222901577,10.18214936278694 60.438972624970624,10.188775738893188 60.39423761960819,10.098382984018706 60.39093320797994)))"
22450006705000,87,50,37,43.7,"MULTIPOLYGON(((10.36962412098218 60.40066261821902,10.363244602390086 60.44540926281401,10.453823019940664 60.44853544881144,10.460078971733154 60.40378314954245,10.36962412098218 60.40066261821902)))"
22500006705000,3191,1610,1581,43.6,"MULTIPOLYGON(((10.460078971733154 60.40378314954245,10.453823019940664 60.44853544881144,10.544421448462135 60.45160017646853,10.550553743723603 60.40684233263811,10.460078971733154 60.40378314954245)))"
22550006705000,881,449,432,42.4,"MULTIPOLYGON(((10.550553743723603 60.40684233263811,10.544421448462135 60.45160017646853,10.635039496626412 60.45460341914589,10.64104804735325 60.409840140977295,10.550553743723603 60.40684233263811)))"
22600006705000,2,1,1,0,"MULTIPOLYGON(((10.64104804735325 60.409840140977295,10.635039496626412 60.45460341914589,10.725676772572315 60.45754515072816,10.731561492492705 60.41277654855316,10.64104804735325 60.409840140977295)))"
22650006705000,19,12,7,44.7,"MULTIPOLYGON(((10.731561492492705 60.41277654855316,10.725676772572315 60.45754515072816,10.816332883915853 60.46042534562486,10.822093688493691 60.41565152988164,10.731561492492705 60.41277654855316)))"
22700006705000,107,62,45,44.3,"MULTIPOLYGON(((10.822093688493691 60.41565152988164,10.816332883915853 60.46042534562486,10.907007437760573 60.463243978771345,10.912644244199292 60.418465060002276,10.822093688493691 60.41565152988164)))"
22750006705000,72,39,33,44.6,"MULTIPOLYGON(((10.912644244199292 60.418465060002276,10.907007437760573 60.463243978771345,10.997700040707912 60.46600102562939,11.003212767954253 60.421217114478985,10.912644244199292 60.418465060002276)))"
22800006705000,1145,556,589,43.8,"MULTIPOLYGON(((11.003212767954253 60.421217114478985,10.997700040707912 60.46600102562939,11.088410298867597 60.4686964621882,11.093798867615302 60.42390766940087,11.003212767954253 60.421217114478985)))"
22850006705000,8,4,4,37.5,"MULTIPOLYGON(((11.093798867615302 60.42390766940087,11.088410298867597 60.4686964621882,11.17913781786809 60.47133026496514,11.184402150561494 60.42653670138308,11.093798867615302 60.42390766940087)))"
22900006705000,136,64,72,44.4,"MULTIPOLYGON(((11.184402150561494 60.42653670138308,11.17913781786809 60.47133026496514,11.269882202867043 60.47390241100647,11.275022223704621 60.42910418756746,11.184402150561494 60.42653670138308)))"
22950006705000,23,12,11,50.7,"MULTIPOLYGON(((11.275022223704621 60.42910418756746,11.269882202867043 60.47390241100647,11.360643058561795 60.476412877888144,11.365658693499615 60.431610105623385,11.275022223704621 60.42910418756746)))"
23000006705000,10,4,6,59.7,"MULTIPOLYGON(((11.365658693499615 60.431610105623385,11.360643058561795 60.476412877888144,11.451419989199913 60.4788616437165,11.456311165955006 60.43405443374841,11.365658693499615 60.431610105623385)))"
23050006705000,439,229,210,43.9,"MULTIPOLYGON(((11.456311165955006 60.43405443374841,11.451419989199913 60.4788616437165,11.542212598589739 60.48124868712902,11.546979246643405 60.43643715066912,11.456311165955006 60.43405443374841)))"
23100006705000,705,381,324,45.3,"MULTIPOLYGON(((11.546979246643405 60.43643715066912,11.542212598589739 60.48124868712902,11.633020490110992 60.48357398729506,11.637662540712011 60.43875823564169,11.546979246643405 60.43643715066912)))"
23150006705000,221,115,106,45.4,"MULTIPOLYGON(((11.637662540712011 60.43875823564169,11.633020490110992 60.48357398729506,11.723843266725378 60.48583752391643,11.728360652893164 60.441017668452616,11.637662540712011 60.43875823564169)))"
23300006705000,221,116,105,48.7,"MULTIPOLYGON(((11.909799748511539 60.445351499391286,11.905531885054232 60.49017922799917,11.996396930698035 60.492257357532765,12.00053993943435 60.447425859749565,11.909799748511539 60.445351499391286)))"
23350006705000,1412,668,744,50,"MULTIPOLYGON(((12.00053993943435 60.447425859749565,11.996396930698035 60.492257357532765,12.08727526931507 60.494273647667406,12.091293363462153 60.44943849240856,12.00053993943435 60.447425859749565)))"
23400006705000,242,114,128,44.5,"MULTIPOLYGON(((12.091293363462153 60.44943849240856,12.08727526931507 60.494273647667406,12.178166501937259 60.49622808077726,12.182059623412016 60.451389379816064,12.091293363462153 60.44943849240856)))"
23500006705000,3,2,1,0,"MULTIPOLYGON(((12.27283832174996 60.453278504953886,12.269070229242802 60.49812063977272,12.359986051566993 60.49995130810103,12.363629060601665 60.45510585133845,12.27283832174996 60.453278504953886)))"
23550006705000,13,5,8,39.6,"MULTIPOLYGON(((12.363629060601665 60.45510585133845,12.359986051566993 60.49995130810103,12.45091356891304 60.501720069746874,12.454431441763237 60.45687140302137,12.363629060601665 60.45510585133845)))"
23650006705000,9,4,5,36.3,"MULTIPOLYGON(((12.545245066711956 60.45857514458993,12.541852380962906 60.50342690923283,12.6328020870882 60.505071811619835,12.636069536617097 60.46021706116761,12.545245066711956 60.45857514458993)))"
19450006710000,268,141,127,39.1,"MULTIPOLYGON(((4.979567021535411 60.14668116938608,4.965957641221998 60.190890279598314,5.054760797815744 60.19764804010134,5.068254623566435 60.153426915558434,4.979567021535411 60.14668116938608)))"
19500006710000,1530,772,758,36,"MULTIPOLYGON(((5.068254623566435 60.153426915558434,5.054760797815744 60.19764804010134,5.143606290478955 60.20434675792529,5.156984377078111 60.16011371914952,5.068254623566435 60.153426915558434)))"
19550006710000,176,90,86,40.9,"MULTIPOLYGON(((5.156984377078111 60.16011371914952,5.143606290478955 60.20434675792529,5.232493775637029 60.21098637690671,5.245755939871077 60.16674152422084,5.156984377078111 60.16011371914952)))"
19600006710000,1,1,0,0,"MULTIPOLYGON(((5.245755939871077 60.16674152422084,5.232493775637029 60.21098637690671,5.321422908643774 60.21756684132928,5.334568968682049 60.173310275279455,5.245755939871077 60.16674152422084)))"
19650006710000,2163,1108,1055,39.2,"MULTIPOLYGON(((5.334568968682049 60.173310275279455,5.321422908643774 60.21756684132928,5.41039334378862 60.224088095925495,5.423423119190997 60.17981991727962,5.334568968682049 60.173310275279455)))"
19700006710000,6851,3446,3405,41.6,"MULTIPOLYGON(((5.423423119190997 60.17981991727962,5.41039334378862 60.224088095925495,5.499404734303854 60.230550085878484,5.51231804602838 60.18627039562453,5.423423119190997 60.17981991727962)))"
19750006710000,681,338,343,36,"MULTIPOLYGON(((5.51231804602838 60.18627039562453,5.499404734303854 60.230550085878484,5.588456732372 60.23695275682342,5.60125340278239 60.19266165616793,5.51231804602838 60.18627039562453)))"
19800006710000,439,217,222,42.2,"MULTIPOLYGON(((5.60125340278239 60.19266165616793,5.588456732372 60.23695275682342,5.677548989133161 60.24329605484958,5.69022884200634 60.19899364521587,5.60125340278239 60.19266165616793)))"
19850006710000,647,318,329,44.6,"MULTIPOLYGON(((5.69022884200634 60.19899364521587,5.677548989133161 60.24329605484958,5.766681154692506 60.24957992650155,5.77924401522605 60.20526630952823,5.69022884200634 60.19899364521587)))"
19900006710000,277,133,144,38.6,"MULTIPOLYGON(((5.77924401522605 60.20526630952823,5.766681154692506 60.24957992650155,5.855852878127789 60.25580431878132,5.868298572947341 60.21147959632041,5.77924401522605 60.20526630952823)))"
19950006710000,74,40,34,47.1,"MULTIPOLYGON(((5.868298572947341 60.21147959632041,5.855852878127789 60.25580431878132,5.945063807496937 60.26196917914953,5.95739216466356 60.21763345326501,5.868298572947341 60.21147959632041)))"
20000006710000,474,249,225,48.2,"MULTIPOLYGON(((5.95739216466356 60.21763345326501,5.945063807496937 60.26196917914953,6.034313589845696 60.26807445552736,6.046524438863194 60.223727828493324,5.95739216466356 60.21763345326501)))"
20050006710000,99,58,41,44.4,"MULTIPOLYGON(((6.046524438863194 60.223727828493324,6.034313589845696 60.26807445552736,6.123601871215347 60.27412009629805,6.135695043037531 60.22976267059705,6.046524438863194 60.223727828493324)))"
20100006710000,175,91,84,46.3,"MULTIPOLYGON(((6.135695043037531 60.22976267059705,6.123601871215347 60.27412009629805,6.2129282966505 60.28010605030839,6.2249036236884 60.2357379286298,6.135695043037531 60.22976267059705)))"
20150006710000,399,198,201,43.5,"MULTIPOLYGON(((6.2249036236884 60.2357379286298,6.2129282966505 60.28010605030839,6.302292510206905 60.286032266870556,6.314149826335934 60.24165355210875,6.2249036236884 60.2357379286298)))"
20200006710000,82,44,38,40.1,"MULTIPOLYGON(((6.314149826335934 60.24165355210875,6.302292510206905 60.286032266870556,6.391694154959385 60.291898695763464,6.403433295526454 60.24750949101613,6.314149826335934 60.24165355210875)))"
20300006710000,96,52,44,47.4,"MULTIPOLYGON(((6.49275367484037 60.25330569580077,6.481132873009774 60.297705287234415,6.570608305494974 60.30345199200065,6.582110606900146 60.25904211737979,6.49275367484037 60.25330569580077)))"
20350006710000,370,193,177,44,"MULTIPOLYGON(((6.582110606900146 60.25904211737979,6.570608305494974 60.30345199200065,6.660120092595003 60.30913876125091,6.67150373337834 60.264718707139906,6.582110606900146 60.25904211737979)))"
21350006710000,13,6,7,56.2,"MULTIPOLYGON(((8.376366830283617 60.36114469699253,8.367266144510614 60.40573820880096,8.45742806229525 60.41021675650062,8.466407207175676 60.36561517792922,8.376366830283617 60.36114469699253)))"
21400006710000,5,2,3,57.6,"MULTIPOLYGON(((8.466407207175676 60.36561517792922,8.45742806229525 60.41021675650062,8.547618572392494 60.414634455143656,8.55647604903517 60.370024917240286,8.466407207175676 60.36561517792922)))"
21600006710000,5,2,3,21,"MULTIPOLYGON(((8.826849589930994 60.382889308732025,8.818357865733498 60.42752207848786,8.908658950517841 60.43169600517997,8.917028513463698 60.3870557073637,8.826849589930994 60.382889308732025)))"
21750006710000,1,1,0,0,"MULTIPOLYGON(((9.097465696379945 60.39520569062797,9.089340811681915 60.43986071983392,9.179720822582164 60.443851437208075,9.187723193606084 60.3991892049643,9.097465696379945 60.39520569062797)))"
21850006710000,85,46,39,50.4,"MULTIPOLYGON(((9.278006118745413 60.40311168841883,9.270126375539023 60.447781015071435,9.36055708607346 60.451649419406245,9.368314088992866 60.40697310711441,9.278006118745413 60.40311168841883)))"
21900006710000,172,94,78,45.1,"MULTIPOLYGON(((9.368314088992866 60.40697310711441,9.36055708607346 60.451649419406245,9.451012569028258 60.455456616707124,9.458646720870235 60.410773427684276,9.368314088992866 60.40697310711441)))"
21950006710000,473,246,227,43.6,"MULTIPOLYGON(((9.458646720870235 60.410773427684276,9.451012569028258 60.455456616707124,9.541492438577782 60.45920257398225,9.549003630235859 60.41451261727311,9.458646720870235 60.410773427684276)))"
22250006710000,78,46,32,51,"MULTIPOLYGON(((10.001138849226479 60.432290486500904,9.994244035806274 60.47701264133611,10.084862086402135 60.48039049451751,10.091633320632898 60.43566222901577,10.001138849226479 60.432290486500904)))"
22300006710000,1,0,1,0,"MULTIPOLYGON(((10.091633320632898 60.43566222901577,10.084862086402135 60.48039049451751,10.175501804930889 60.48370689119654,10.18214936278694 60.438972624970624,10.091633320632898 60.43566222901577)))"
22350006710000,20,11,9,46,"MULTIPOLYGON(((10.18214936278694 60.438972624970624,10.175501804930889 60.48370689119654,10.26616280057785 60.4869618025267,10.272686586595126 60.442221645638796,10.18214936278694 60.438972624970624)))"
22400006710000,3,0,3,0,"MULTIPOLYGON(((10.272686586595126 60.442221645638796,10.26616280057785 60.4869618025267,10.356844681950108 60.490155200184056,10.363244602390086 60.44540926281401,10.272686586595126 60.442221645638796)))"
22450006710000,86,41,45,50.5,"MULTIPOLYGON(((10.363244602390086 60.44540926281401,10.356844681950108 60.490155200184056,10.447547057086725 60.49328705636817,10.453823019940664 60.44853544881144,10.363244602390086 60.44540926281401)))"
22500006710000,598,308,290,44.6,"MULTIPOLYGON(((10.453823019940664 60.44853544881144,10.447547057086725 60.49328705636817,10.538269533469013 60.49635734380306,10.544421448462135 60.45160017646853,10.453823019940664 60.44853544881144)))"
22550006710000,10,6,4,58.4,"MULTIPOLYGON(((10.544421448462135 60.45160017646853,10.538269533469013 60.49635734380306,10.629011718030819 60.49936603573803,10.635039496626412 60.45460341914589,10.544421448462135 60.45160017646853)))"
22600006710000,2,1,1,0,"MULTIPOLYGON(((10.635039496626412 60.45460341914589,10.629011718030819 60.49936603573803,10.719773217168873 60.50231310594855,10.725676772572315 60.45754515072816,10.635039496626412 60.45460341914589)))"
22650006710000,10,7,3,45.5,"MULTIPOLYGON(((10.725676772572315 60.45754515072816,10.719773217168873 60.50231310594855,10.810553636753154 60.50519852873715,10.816332883915853 60.46042534562486,10.725676772572315 60.45754515072816)))"
22750006710000,53,27,26,36.9,"MULTIPOLYGON(((10.907007437760573 60.463243978771345,10.90135258213729 60.50802227893429,10.99216965816901 60.51078433189914,10.997700040707912 60.46600102562939,10.907007437760573 60.463243978771345)))"
22800006710000,343,177,166,46,"MULTIPOLYGON(((10.997700040707912 60.46600102562939,10.99216965816901 60.51078433189914,11.083004469200622 60.51348466352037,11.088410298867597 60.4686964621882,10.997700040707912 60.46600102562939)))"
22850006710000,658,344,314,44,"MULTIPOLYGON(((11.088410298867597 60.4686964621882,11.083004469200622 60.51348466352037,11.173856619099514 60.51612325021697,11.17913781786809 60.47133026496514,11.088410298867597 60.4686964621882)))"
22900006710000,166,91,75,47.8,"MULTIPOLYGON(((11.17913781786809 60.47133026496514,11.173856619099514 60.51612325021697,11.2647257112587 60.5187000689391,11.269882202867043 60.47390241100647,11.17913781786809 60.47133026496514)))"
22950006710000,46,27,19,38.1,"MULTIPOLYGON(((11.269882202867043 60.47390241100647,11.2647257112587 60.5187000689391,11.355611348607406 60.52121509716869,11.360643058561795 60.476412877888144,11.269882202867043 60.47390241100647)))"
23000006710000,34,16,18,42.8,"MULTIPOLYGON(((11.360643058561795 60.476412877888144,11.355611348607406 60.52121509716869,11.44651313362167 60.523668312920364,11.451419989199913 60.4788616437165,11.360643058561795 60.476412877888144)))"
23100006710000,56,30,26,47.2,"MULTIPOLYGON(((11.542212598589739 60.48124868712902,11.53743066833498 60.526059694741996,11.62836355434895 60.52838922171556,11.633020490110992 60.48357398729506,11.542212598589739 60.48124868712902)))"
23150006710000,4,2,2,0,"MULTIPOLYGON(((11.633020490110992 60.48357398729506,11.62836355434895 60.52838922171556,11.719311392844002 60.530656873457694,11.723843266725378 60.48583752391643,11.633020490110992 60.48357398729506)))"
23250006710000,2,2,0,0,"MULTIPOLYGON(((11.81468053098724 60.48803927722819,11.810273784590118 60.53286263012052,11.901250329957575 60.53500647239215,11.905531885054232 60.49017922799917,11.81468053098724 60.48803927722819)))"
23300006710000,233,126,107,46.6,"MULTIPOLYGON(((11.905531885054232 60.49017922799917,11.901250329957575 60.53500647239215,11.992240628927743 60.537088381497455,11.996396930698035 60.492257357532765,11.905531885054232 60.49017922799917)))"
23350006710000,500,247,253,48.3,"MULTIPOLYGON(((11.996396930698035 60.492257357532765,11.992240628927743 60.537088381497455,12.083244281103882 60.539108339198556,12.08727526931507 60.494273647667406,11.996396930698035 60.492257357532765)))"
23400006710000,216,108,108,45.7,"MULTIPOLYGON(((12.08727526931507 60.494273647667406,12.083244281103882 60.539108339198556,12.174260885721989 60.541066327795555,12.178166501937259 60.49622808077726,12.08727526931507 60.494273647667406)))"
23550006710000,2,1,1,0,"MULTIPOLYGON(((12.359986051566993 60.49995130810103,12.356331347456933 60.5447963295707,12.447384401307296 60.54656831004382,12.45091356891304 60.501720069746874,12.359986051566993 60.49995130810103)))"
23600006710000,3,1,2,0,"MULTIPOLYGON(((12.45091356891304 60.501720069746874,12.447384401307296 60.54656831004382,12.538448801088515 60.5482782560039,12.541852380962906 60.50342690923283,12.45091356891304 60.501720069746874)))"
23650006710000,1,0,1,0,"MULTIPOLYGON(((12.541852380962906 60.50342690923283,12.538448801088515 60.5482782560039,12.629524144363645 60.549926152449075,12.6328020870882 60.505071811619835,12.541852380962906 60.50342690923283)))"
19450006715000,568,292,276,42.6,"MULTIPOLYGON(((4.965957641221998 60.190890279598314,4.952305582162257 60.23509723268659,5.041224635815795 60.241867039351575,5.054760797815744 60.19764804010134,4.965957641221998 60.190890279598314)))"
19500006715000,1121,567,554,40.2,"MULTIPOLYGON(((5.054760797815744 60.19764804010134,5.041224635815795 60.241867039351575,5.13018621120633 60.24857770300071,5.143606290478955 60.20434675792529,5.054760797815744 60.19764804010134)))"
19550006715000,929,494,435,43.5,"MULTIPOLYGON(((5.143606290478955 60.20434675792529,5.13018621120633 60.24857770300071,5.219189963376905 60.25522916724434,5.232493775637029 60.21098637690671,5.143606290478955 60.20434675792529)))"
19600006715000,1742,896,846,43.3,"MULTIPOLYGON(((5.232493775637029 60.21098637690671,5.219189963376905 60.25522916724434,5.308235546291211 60.261821376141526,5.321422908643774 60.21756684132928,5.232493775637029 60.21098637690671)))"
19650006715000,2427,1235,1192,42.1,"MULTIPOLYGON(((5.321422908643774 60.21756684132928,5.308235546291211 60.261821376141526,5.397322612840868 60.26835427420181,5.41039334378862 60.224088095925495,5.321422908643774 60.21756684132928)))"
19700006715000,2413,1245,1168,38.1,"MULTIPOLYGON(((5.41039334378862 60.224088095925495,5.397322612840868 60.26835427420181,5.486450814852691 60.27482780638694,5.499404734303854 60.230550085878484,5.41039334378862 60.224088095925495)))"
19750006715000,142,75,67,39.5,"MULTIPOLYGON(((5.499404734303854 60.230550085878484,5.486450814852691 60.27482780638694,5.575619803096099 60.281241918112464,5.588456732372 60.23695275682342,5.499404734303854 60.230550085878484)))"
19800006715000,318,173,145,40.4,"MULTIPOLYGON(((5.588456732372 60.23695275682342,5.575619803096099 60.281241918112464,5.664829227290554 60.28759655524943,5.677548989133161 60.24329605484958,5.588456732372 60.23695275682342)))"
19850006715000,339,180,159,40,"MULTIPOLYGON(((5.677548989133161 60.24329605484958,5.664829227290554 60.28759655524943,5.754078736113043 60.29389166412621,5.766681154692506 60.24957992650155,5.677548989133161 60.24329605484958)))"
19900006715000,58,28,30,38.1,"MULTIPOLYGON(((5.766681154692506 60.24957992650155,5.754078736113043 60.29389166412621,5.843367977205674 60.30012719152992,5.855852878127789 60.25580431878132,5.766681154692506 60.24957992650155)))"
19950006715000,49,26,23,51.4,"MULTIPOLYGON(((5.855852878127789 60.25580431878132,5.843367977205674 60.30012719152992,5.932696597183289 60.30630308470823,5.945063807496937 60.26196917914953,5.855852878127789 60.25580431878132)))"
20000006715000,145,71,74,43.6,"MULTIPOLYGON(((5.945063807496937 60.26196917914953,5.932696597183289 60.30630308470823,6.022064241641183 60.31241929137096,6.034313589845696 60.26807445552736,5.945063807496937 60.26196917914953)))"
20050006715000,85,42,43,48.6,"MULTIPOLYGON(((6.034313589845696 60.26807445552736,6.022064241641183 60.31241929137096,6.111470555162855 60.318475759691694,6.123601871215347 60.27412009629805,6.034313589845696 60.26807445552736)))"
20100006715000,480,247,233,45.2,"MULTIPOLYGON(((6.123601871215347 60.27412009629805,6.111470555162855 60.318475759691694,6.200915181327853 60.32447243830935,6.2129282966505 60.28010605030839,6.123601871215347 60.27412009629805)))"
20150006715000,118,63,55,47.6,"MULTIPOLYGON(((6.2129282966505 60.28010605030839,6.200915181327853 60.32447243830935,6.290397762719637 60.330409276329874,6.302292510206905 60.286032266870556,6.2129282966505 60.28010605030839)))"
20200006715000,40,21,19,49.2,"MULTIPOLYGON(((6.302292510206905 60.286032266870556,6.290397762719637 60.330409276329874,6.379917940933572 60.33628622332772,6.391694154959385 60.291898695763464,6.302292510206905 60.286032266870556)))"
20350006715000,247,119,128,44.5,"MULTIPOLYGON(((6.570608305494974 60.30345199200065,6.559069649316842 60.34786024490553,6.64870045780876 60.35355722099134,6.660120092595003 60.30913876125091,6.570608305494974 60.30345199200065)))"
20400006715000,564,279,285,41.1,"MULTIPOLYGON(((6.660120092595003 60.30913876125091,6.64870045780876 60.35355722099134,6.738367419784319 60.35919410906928,6.749667873541196 60.314765546646846,6.660120092595003 60.30913876125091)))"
21350006715000,77,42,35,47.9,"MULTIPOLYGON(((8.367266144510614 60.40573820880096,8.35813648835425 60.45033059515364,8.448420324974817 60.45481723155926,8.45742806229525 60.41021675650062,8.367266144510614 60.40573820880096)))"
21400006715000,32,18,14,53.9,"MULTIPOLYGON(((8.45742806229525 60.41021675650062,8.448420324974817 60.45481723155926,8.538732882017497 60.4592429111969,8.547618572392494 60.414634455143656,8.45742806229525 60.41021675650062)))"
21500006715000,20,11,9,42.1,"MULTIPOLYGON(((8.637837296096242 60.41899126665384,8.629073779135672 60.46360759583268,8.719442635222146 60.46791124773788,8.72808385394543 60.423287153458126,8.637837296096242 60.41899126665384)))"
21550006715000,95,55,40,54.3,"MULTIPOLYGON(((8.72808385394543 60.423287153458126,8.719442635222146 60.46791124773788,8.809839068418643 60.47215382969023,8.818357865733498 60.42752207848786,8.72808385394543 60.423287153458126)))"
21600006715000,12,4,8,34.8,"MULTIPOLYGON(((8.818357865733498 60.42752207848786,8.809839068418643 60.47215382969023,8.90026269612534 60.476335304974945,8.908658950517841 60.43169600517997,8.818357865733498 60.42752207848786)))"
21800006715000,194,99,95,48.8,"MULTIPOLYGON(((9.179720822582164 60.443851437208075,9.171692909386982 60.488512731315076,9.262221474642017 60.492449422975334,9.270126375539023 60.447781015071435,9.179720822582164 60.443851437208075)))"
21950006715000,1,1,0,0,"MULTIPOLYGON(((9.451012569028258 60.455456616707124,9.443354030481784 60.50013892489225,9.533957246701032 60.50389166837498,9.541492438577782 60.45920257398225,9.451012569028258 60.455456616707124)))"
22000006715000,1,1,0,0,"MULTIPOLYGON(((9.541492438577782 60.45920257398225,9.533957246701032 60.50389166837498,9.624584571097092 60.50758302988498,9.631996308237875 60.462887258754314,9.541492438577782 60.45920257398225)))"
22250006715000,45,22,23,52.1,"MULTIPOLYGON(((9.994244035806274 60.47701264133611,9.987327164127155 60.52173402208936,10.078069184140409 60.52511800270449,10.084862086402135 60.48039049451751,9.994244035806274 60.47701264133611)))"
22300006715000,20,11,9,61.9,"MULTIPOLYGON(((10.084862086402135 60.48039049451751,10.078069184140409 60.52511800270449,10.16883296986025 60.52844041658,10.175501804930889 60.48370689119654,10.084862086402135 60.48039049451751)))"
22350006715000,53,21,32,51.8,"MULTIPOLYGON(((10.175501804930889 60.48370689119654,10.16883296986025 60.52844041658,10.259618128740609 60.53170123474889,10.26616280057785 60.4869618025267,10.175501804930889 60.48370689119654)))"
22400006715000,197,100,97,44.5,"MULTIPOLYGON(((10.26616280057785 60.4869618025267,10.259618128740609 60.53170123474889,10.350424267652809 60.53490042876882,10.356844681950108 60.490155200184056,10.26616280057785 60.4869618025267)))"
22450006715000,120,71,49,41.5,"MULTIPOLYGON(((10.356844681950108 60.490155200184056,10.350424267652809 60.53490042876882,10.44125099289587 60.53803797072311,10.447547057086725 60.49328705636817,10.356844681950108 60.490155200184056)))"
22500006715000,92,43,49,41.6,"MULTIPOLYGON(((10.447547057086725 60.49328705636817,10.44125099289587 60.53803797072311,10.532097910206843 60.541113833221665,10.538269533469013 60.49635734380306,10.447547057086725 60.49328705636817)))"
22550006715000,9,5,4,35.2,"MULTIPOLYGON(((10.538269533469013 60.49635734380306,10.532097910206843 60.541113833221665,10.622964624771178 60.54412798940181,10.629011718030819 60.49936603573803,10.538269533469013 60.49635734380306)))"
22600006715000,146,72,74,46.9,"MULTIPOLYGON(((10.629011718030819 60.49936603573803,10.622964624771178 60.54412798940181,10.713850741233147 60.54708041292927,10.719773217168873 60.50231310594855,10.629011718030819 60.49936603573803)))"
22700006715000,5,3,2,63,"MULTIPOLYGON(((10.810553636753154 60.50519852873715,10.804755863706276 60.54997107799892,10.895679595783845 60.552799959335786,10.90135258213729 60.50802227893429,10.810553636753154 60.50519852873715)))"
22750006715000,1,1,0,0,"MULTIPOLYGON(((10.90135258213729 60.50802227893429,10.895679595783845 60.552799959335786,10.9866215405494 60.555567032195704,10.99216965816901 60.51078433189914,10.90135258213729 60.50802227893429)))"
22800006715000,1,1,0,0,"MULTIPOLYGON(((10.99216965816901 60.51078433189914,10.9866215405494 60.555567032195704,11.077581300587305 60.55827227236625,11.083004469200622 60.51348466352037,10.99216965816901 60.51078433189914)))"
22850006715000,20,12,8,33.9,"MULTIPOLYGON(((11.083004469200622 60.51348466352037,11.077581300587305 60.55827227236625,11.168558477993333 60.560915656167595,11.173856619099514 60.51612325021697,11.083004469200622 60.51348466352037)))"
22900006715000,277,143,134,43,"MULTIPOLYGON(((11.173856619099514 60.51612325021697,11.168558477993333 60.560915656167595,11.2595526743853 60.56349716045307,11.2647257112587 60.5187000689391,11.173856619099514 60.51612325021697)))"
22950006715000,81,41,40,45.8,"MULTIPOLYGON(((11.2647257112587 60.5187000689391,11.2595526743853 60.56349716045307,11.3505634909137 60.56601676261018,11.355611348607406 60.52121509716869,11.2647257112587 60.5187000689391)))"
23050006715000,2,1,1,0,"MULTIPOLYGON(((11.44651313362167 60.523668312920364,11.441590528272402 60.568474440561154,11.532633386709369 60.570870172763826,11.53743066833498 60.526059694741996,11.44651313362167 60.523668312920364)))"
23250006715000,56,30,26,53.1,"MULTIPOLYGON(((11.810273784590118 60.53286263012052,11.805852884506832 60.577685487508035,11.89695502119519 60.579833232030964,11.901250329957575 60.53500647239215,11.810273784590118 60.53286263012052)))"
23300006715000,449,225,224,42.5,"MULTIPOLYGON(((11.901250329957575 60.53500647239215,11.89695502119519 60.579833232030964,11.988070973890265 60.581918931152074,11.992240628927743 60.537088381497455,11.901250329957575 60.53500647239215)))"
23350006715000,814,416,398,46.2,"MULTIPOLYGON(((11.992240628927743 60.537088381497455,11.988070973890265 60.581918931152074,12.079200340391324 60.58394256655682,12.083244281103882 60.539108339198556,11.992240628927743 60.537088381497455)))"
23400006715000,73,42,31,46.5,"MULTIPOLYGON(((12.083244281103882 60.539108339198556,12.079200340391324 60.58394256655682,12.170342718127577 60.58590412047077,12.174260885721989 60.541066327795555,12.083244281103882 60.539108339198556)))"
23450006715000,43,21,22,44,"MULTIPOLYGON(((12.174260885721989 60.541066327795555,12.170342718127577 60.58590412047077,12.261497704169104 60.58780357566027,12.26529004166165 60.54296233012703,12.174260885721989 60.541066327795555)))"
23500006715000,23,14,9,53.1,"MULTIPOLYGON(((12.26529004166165 60.54296233012703,12.261497704169104 60.58780357566027,12.352664895237845 60.58964091543301,12.356331347456933 60.5447963295707,12.26529004166165 60.54296233012703)))"
23550006715000,2,2,0,0,"MULTIPOLYGON(((12.356331347456933 60.5447963295707,12.352664895237845 60.58964091543301,12.443843887718575 60.59141612363858,12.447384401307296 60.54656831004382,12.356331347456933 60.5447963295707)))"
23650006715000,2,1,1,0,"MULTIPOLYGON(((12.538448801088515 60.5482782560039,12.53503427766992 60.593129184668925,12.626235660835414 60.59478008345902,12.629524144363645 60.549926152449075,12.538448801088515 60.5482782560039)))"
19450006720000,739,372,367,39.7,"MULTIPOLYGON(((4.952305582162257 60.23509723268659,4.938610657312782 60.27930202060622,5.027645951897754 60.28608390540355,5.041224635815795 60.241867039351575,4.952305582162257 60.23509723268659)))"
19500006720000,2698,1377,1321,38.3,"MULTIPOLYGON(((5.041224635815795 60.241867039351575,5.027645951897754 60.28608390540355,5.116723954973785 60.292806546608425,5.13018621120633 60.24857770300071,5.041224635815795 60.241867039351575)))"
19550006720000,167,92,75,39.9,"MULTIPOLYGON(((5.13018621120633 60.24857770300071,5.116723954973785 60.292806546608425,5.205844320194367 60.29946988760369,5.219189963376905 60.25522916724434,5.13018621120633 60.24857770300071)))"
19600006720000,10015,5103,4912,39.6,"MULTIPOLYGON(((5.219189963376905 60.25522916724434,5.205844320194367 60.29946988760369,5.295006700125845 60.30607387222259,5.308235546291211 60.261821376141526,5.219189963376905 60.25522916724434)))"
19650006720000,26086,12947,13139,38.4,"MULTIPOLYGON(((5.308235546291211 60.261821376141526,5.295006700125845 60.30607387222259,5.384210746254711 60.312618444750434,5.397322612840868 60.26835427420181,5.308235546291211 60.261821376141526)))"
19700006720000,1288,667,621,44.6,"MULTIPOLYGON(((5.397322612840868 60.26835427420181,5.384210746254711 60.312618444750434,5.473456108994934 60.31910354992637,5.486450814852691 60.27482780638694,5.397322612840868 60.26835427420181)))"
19750006720000,159,88,71,45.5,"MULTIPOLYGON(((5.486450814852691 60.27482780638694,5.473456108994934 60.31910354992637,5.562742437695412 60.32552913294498,5.575619803096099 60.281241918112464,5.486450814852691 60.27482780638694)))"
19800006720000,131,68,63,46.6,"MULTIPOLYGON(((5.575619803096099 60.281241918112464,5.562742437695412 60.32552913294498,5.65206938064743 60.3318951394581,5.664829227290554 60.28759655524943,5.575619803096099 60.281241918112464)))"
19850006720000,109,56,53,39.3,"MULTIPOLYGON(((5.664829227290554 60.28759655524943,5.65206938064743 60.3318951394581,5.741436585092236 60.33820151557642,5.754078736113043 60.29389166412621,5.664829227290554 60.28759655524943)))"
20050006720000,58,29,29,42.5,"MULTIPOLYGON(((6.022064241641183 60.31241929137096,6.00977622420556 60.35676232958753,6.09930092630103 60.362829654469174,6.111470555162855 60.318475759691694,6.022064241641183 60.31241929137096)))"
20100006720000,711,362,349,40.5,"MULTIPOLYGON(((6.111470555162855 60.318475759691694,6.09930092630103 60.362829654469174,6.188864110613728 60.36883708645056,6.200915181327853 60.32447243830935,6.111470555162855 60.318475759691694)))"
20150006720000,126,55,71,44.2,"MULTIPOLYGON(((6.200915181327853 60.32447243830935,6.188864110613728 60.36883708645056,6.278465418246881 60.374784574430244,6.290397762719637 60.330409276329874,6.200915181327853 60.32447243830935)))"
20200006720000,60,32,28,50.6,"MULTIPOLYGON(((6.290397762719637 60.330409276329874,6.278465418246881 60.374784574430244,6.368104489308355 60.380672067777134,6.379917940933572 60.33628622332772,6.290397762719637 60.330409276329874)))"
20250006720000,168,85,83,51.1,"MULTIPOLYGON(((6.379917940933572 60.33628622332772,6.368104489308355 60.380672067777134,6.457780962918738 60.38649951633195,6.469475356584894 60.3421032293475,6.379917940933572 60.33628622332772)))"
20300006720000,23,12,11,53.3,"MULTIPOLYGON(((6.469475356584894 60.3421032293475,6.457780962918738 60.38649951633195,6.547494477219454 60.39226687040894,6.559069649316842 60.34786024490553,6.469475356584894 60.3421032293475)))"
20350006720000,113,60,53,48.6,"MULTIPOLYGON(((6.559069649316842 60.34786024490553,6.547494477219454 60.39226687040894,6.637244669380963 60.39797408079736,6.64870045780876 60.35355722099134,6.559069649316842 60.34786024490553)))"
20400006720000,1010,479,531,40.9,"MULTIPOLYGON(((6.64870045780876 60.35355722099134,6.637244669380963 60.39797408079736,6.727031175611028 60.40362109876302,6.738367419784319 60.35919410906928,6.64870045780876 60.35355722099134)))"
20450006720000,38,18,20,37.4,"MULTIPOLYGON(((6.738367419784319 60.35919410906928,6.727031175611028 60.40362109876302,6.816853631163019 60.409207876049834,6.828070172019782 60.36477086107993,6.738367419784319 60.35919410906928)))"
20650006720000,174,91,83,47.4,"MULTIPOLYGON(((7.097389524012117 60.38113982729077,7.086533032144846 60.425606288480026,7.17649561872506 60.430951630105845,7.187231786394034 60.386475564017296,7.097389524012117 60.38113982729077)))"
20700006720000,11,7,4,62.1,"MULTIPOLYGON(((7.187231786394034 60.386475564017296,7.17649561872506 60.430951630105845,7.266492316873639 60.43623649699684,7.277108008999341 60.39175093157665,7.187231786394034 60.386475564017296)))"
20750006720000,28,15,13,57.6,"MULTIPOLYGON(((7.277108008999341 60.39175093157665,7.266492316873639 60.43623649699684,7.356522756295705 60.44146084379705,7.367017823096703 60.39696588479856,7.277108008999341 60.39175093157665)))"
21250006720000,20,10,10,39.8,"MULTIPOLYGON(((8.17765649390646 60.441174607492385,8.168253534002746 60.485749320095486,8.25860082755701 60.49036607957123,8.267881751732395 60.44578304071784,8.17765649390646 60.441174607492385)))"
21300006720000,144,79,65,45.2,"MULTIPOLYGON(((8.267881751732395 60.44578304071784,8.25860082755701 60.49036607957123,8.348977732069264 60.49492185258746,8.35813648835425 60.45033059515364,8.267881751732395 60.44578304071784)))"
21350006720000,26,13,13,59.4,"MULTIPOLYGON(((8.35813648835425 60.45033059515364,8.348977732069264 60.49492185258746,8.439383867103937 60.49941659974114,8.448420324974817 60.45481723155926,8.35813648835425 60.45033059515364)))"
21400006720000,5,3,2,72,"MULTIPOLYGON(((8.448420324974817 60.45481723155926,8.439383867103937 60.49941659974114,8.529818851440242 60.50385028213389,8.538732882017497 60.4592429111969,8.448420324974817 60.45481723155926)))"
21450006720000,4,3,1,0,"MULTIPOLYGON(((8.538732882017497 60.4592429111969,8.529818851440242 60.50385028213389,8.620282303081616 60.50822286137325,8.629073779135672 60.46360759583268,8.538732882017497 60.4592429111969)))"
21500006720000,2,2,0,0,"MULTIPOLYGON(((8.629073779135672 60.46360759583268,8.620282303081616 60.50822286137325,8.710773839265245 60.512534299573986,8.719442635222146 60.46791124773788,8.629073779135672 60.46360759583268)))"
21600006720000,5,3,2,73,"MULTIPOLYGON(((8.809839068418643 60.47215382969023,8.801293076471588 60.51678455935927,8.89183963043403 60.5209736038618,8.90026269612534 60.476335304974945,8.809839068418643 60.47215382969023)))"
21650006720000,11,5,6,48.5,"MULTIPOLYGON(((8.90026269612534 60.476335304974945,8.89183963043403 60.5209736038618,8.98241311614849 60.52510139672521,8.990713135010465 60.48045563738616,8.90026269612534 60.476335304974945)))"
21700006720000,2,2,0,0,"MULTIPOLYGON(((8.990713135010465 60.48045563738616,8.98241311614849 60.52510139672521,9.07301314788317 60.52916790210505,9.081190001019918 60.484514791227824,8.990713135010465 60.48045563738616)))"
21750006720000,44,27,17,42.6,"MULTIPOLYGON(((9.081190001019918 60.484514791227824,9.07301314788317 60.52916790210505,9.163639339188292 60.53317308467006,9.171692909386982 60.488512731315076,9.081190001019918 60.484514791227824)))"
21800006720000,136,67,69,43.2,"MULTIPOLYGON(((9.171692909386982 60.488512731315076,9.163639339188292 60.53317308467006,9.25429130290589 60.53711690960323,9.262221474642017 60.492449422975334,9.171692909386982 60.488512731315076)))"
22100006720000,82,42,40,40.3,"MULTIPOLYGON(((9.71523561483348 60.511212977327446,9.707924108825374 60.555914487341035,9.798722538289958 60.55948946426904,9.805909988430182 60.51478147912634,9.71523561483348 60.511212977327446)))"
22150006720000,39,17,22,60.1,"MULTIPOLYGON(((9.805909988430182 60.51478147912634,9.798722538289958 60.55948946426904,9.889544011065697 60.56300285434028,9.896607301773699 60.51828850422546,9.805909988430182 60.51478147912634)))"
22200006720000,66,34,32,44.5,"MULTIPOLYGON(((9.896607301773699 60.51828850422546,9.889544011065697 60.56300285434028,9.980388134687722 60.56645462689174,9.987327164127155 60.52173402208936,9.896607301773699 60.51828850422546)))"
22250006720000,182,90,92,50,"MULTIPOLYGON(((9.987327164127155 60.52173402208936,9.980388134687722 60.56645462689174,10.071254516073282 60.569844751784295,10.078069184140409 60.52511800270449,9.987327164127155 60.52173402208936)))"
22300006720000,5,3,2,51.2,"MULTIPOLYGON(((10.078069184140409 60.52511800270449,10.071254516073282 60.569844751784295,10.162142761531996 60.573173199403804,10.16883296986025 60.52844041658,10.078069184140409 60.52511800270449)))"
22350006720000,11,7,4,35.3,"MULTIPOLYGON(((10.16883296986025 60.52844041658,10.162142761531996 60.573173199403804,10.25305247677614 60.576439940662,10.259618128740609 60.53170123474889,10.16883296986025 60.52844041658)))"
22400006720000,208,117,91,50.9,"MULTIPOLYGON(((10.259618128740609 60.53170123474889,10.25305247677614 60.576439940662,10.343983266930985 60.5796449469975,10.350424267652809 60.53490042876882,10.259618128740609 60.53170123474889)))"
22550006720000,98,54,44,44.3,"MULTIPOLYGON(((10.532097910206843 60.541113833221665,10.525906489601113 60.58586964329462,10.61689812952545 60.58888927877612,10.622964624771178 60.54412798940181,10.532097910206843 60.541113833221665)))"
22600006720000,226,125,101,42.3,"MULTIPOLYGON(((10.622964624771178 60.54412798940181,10.61689812952545 60.58888927877612,10.70790925919955 60.59184707037641,10.713850741233147 60.54708041292927,10.622964624771178 60.54412798940181)))"
22650006720000,328,167,161,42.8,"MULTIPOLYGON(((10.713850741233147 60.54708041292927,10.70790925919955 60.59184707037641,10.798939480970004 60.594742992182184,10.804755863706276 60.54997107799892,10.713850741233147 60.54708041292927)))"
22750006720000,2,1,1,0,"MULTIPOLYGON(((10.895679595783845 60.552799959335786,10.88998839665922 60.59757701881229,10.981055607576007 60.60034912541874,10.9866215405494 60.555567032195704,10.895679595783845 60.552799959335786)))"
22850006720000,5,3,2,74.6,"MULTIPOLYGON(((11.077581300587305 60.55827227236625,11.072140714526196 60.60305928768745,11.163243317823335 60.60570748183901,11.168558477993333 60.560915656167595,11.077581300587305 60.55827227236625)))"
22900006720000,58,31,27,46.3,"MULTIPOLYGON(((11.168558477993333 60.560915656167595,11.163243317823335 60.60570748183901,11.254363017299365 60.60829368462955,11.2595526743853 60.56349716045307,11.168558477993333 60.560915656167595)))"
22950006720000,377,203,174,46,"MULTIPOLYGON(((11.2595526743853 60.56349716045307,11.254363017299365 60.60829368462955,11.345499412315371 60.61081787335144,11.3505634909137 60.56601676261018,11.2595526743853 60.56349716045307)))"
23050006720000,8,4,4,49.5,"MULTIPOLYGON(((11.441590528272402 60.568474440561154,11.436652101772337 60.61328002583413,11.527820684121954 60.61568012044476,11.532633386709369 60.570870172763826,11.441590528272402 60.568474440561154)))"
23250006720000,50,26,24,48.7,"MULTIPOLYGON(((11.805852884506832 60.577685487508035,11.801417766531767 60.622507848797625,11.89264589636259 60.624659506371934,11.89695502119519 60.579833232030964,11.805852884506832 60.577685487508035)))"
23300006720000,435,218,217,44.8,"MULTIPOLYGON(((11.89695502119519 60.579833232030964,11.89264589636259 60.624659506371934,11.983887904985123 60.626749006001084,11.988070973890265 60.581918931152074,11.89695502119519 60.579833232030964)))"
23350006720000,2383,1149,1234,48.4,"MULTIPOLYGON(((11.988070973890265 60.581918931152074,11.983887904985123 60.626749006001084,12.075143388383722 60.62877632929329,12.079200340391324 60.58394256655682,11.988070973890265 60.581918931152074)))"
23400006720000,120,60,60,47,"MULTIPOLYGON(((12.079200340391324 60.58394256655682,12.075143388383722 60.62877632929329,12.166411942169859 60.630741458399235,12.170342718127577 60.58590412047077,12.079200340391324 60.58394256655682)))"
23450006720000,3,2,1,0,"MULTIPOLYGON(((12.170342718127577 60.58590412047077,12.166411942169859 60.630741458399235,12.257693161593153 60.632644376012585,12.261497704169104 60.58780357566027,12.170342718127577 60.58590412047077)))"
23500006720000,46,23,23,50,"MULTIPOLYGON(((12.261497704169104 60.58780357566027,12.257693161593153 60.632644376012585,12.34898664155241 60.634485065370605,12.352664895237845 60.58964091543301,12.261497704169104 60.58780357566027)))"
23550006720000,5,2,3,58,"MULTIPOLYGON(((12.352664895237845 60.58964091543301,12.34898664155241 60.634485065370605,12.440291976606716 60.63626351025475,12.443843887718575 60.59141612363858,12.352664895237845 60.58964091543301)))"
23600006720000,8,6,2,66,"MULTIPOLYGON(((12.443843887718575 60.59141612363858,12.440291976606716 60.63626351025475,12.53160876098651 60.63797969499117,12.53503427766992 60.593129184668925,12.443843887718575 60.59141612363858)))"
19450006725000,720,367,353,40.7,"MULTIPOLYGON(((4.938610657312782 60.27930202060622,4.924872678536516 60.323504635264186,5.014024559306258 60.330298630304206,5.027645951897754 60.28608390540355,4.938610657312782 60.27930202060622)))"
19500006725000,2032,1028,1004,37.6,"MULTIPOLYGON(((5.027645951897754 60.28608390540355,5.014024559306258 60.330298630304206,5.103219336415489 60.337033280934364,5.116723954973785 60.292806546608425,5.027645951897754 60.28608390540355)))"
19550006725000,2388,1234,1154,38.6,"MULTIPOLYGON(((5.116723954973785 60.292806546608425,5.103219336415489 60.337033280934364,5.19245666212095 60.343708530308795,5.205844320194367 60.29946988760369,5.116723954973785 60.292806546608425)))"
19600006725000,20739,10354,10385,38.1,"MULTIPOLYGON(((5.205844320194367 60.29946988760369,5.19245666212095 60.343708530308795,5.281736187584346 60.35032432203365,5.295006700125845 60.30607387222259,5.205844320194367 60.29946988760369)))"
19650006725000,43984,21390,22594,40.7,"MULTIPOLYGON(((5.295006700125845 60.30607387222259,5.281736187584346 60.35032432203365,5.371057562879675 60.356880600168765,5.384210746254711 60.312618444750434,5.295006700125845 60.30607387222259)))"
19700006725000,5860,2961,2899,35.6,"MULTIPOLYGON(((5.384210746254711 60.312618444750434,5.371057562879675 60.356880600168765,5.460420437000662 60.36337730922942,5.473456108994934 60.31910354992637,5.384210746254711 60.312618444750434)))"
19750006725000,205,109,96,44.2,"MULTIPOLYGON(((5.473456108994934 60.31910354992637,5.460420437000662 60.36337730922942,5.549824457868169 60.36981439418805,5.562742437695412 60.32552913294498,5.473456108994934 60.31910354992637)))"
19800006725000,64,35,29,49.2,"MULTIPOLYGON(((5.562742437695412 60.32552913294498,5.549824457868169 60.36981439418805,5.639269272337776 60.37619180047599,5.65206938064743 60.3318951394581,5.562742437695412 60.32552913294498)))"
19850006725000,192,99,93,45.2,"MULTIPOLYGON(((5.65206938064743 60.3318951394581,5.639269272337776 60.37619180047599,5.728754526207365 60.38250947398508,5.741436585092236 60.33820151557642,5.65206938064743 60.3318951394581)))"
19900006725000,521,270,251,41.9,"MULTIPOLYGON(((5.741436585092236 60.33820151557642,5.728754526207365 60.38250947398508,5.818279864224771 60.388767361069426,5.830843697228647 60.344448207871174,5.741436585092236 60.33820151557642)))"
19950006725000,26,16,10,52.5,"MULTIPOLYGON(((5.830843697228647 60.344448207871174,5.818279864224771 60.388767361069426,5.907844930095555 60.394965408546966,5.920290362220726 60.350635163375784,5.830843697228647 60.344448207871174)))"
20000006725000,1,1,0,0,"MULTIPOLYGON(((5.920290362220726 60.350635163375784,5.907844930095555 60.394965408546966,5.997449366490741 60.401103563701305,6.00977622420556 60.35676232958753,5.920290362220726 60.350635163375784)))"
20050006725000,245,128,117,42.3,"MULTIPOLYGON(((6.00977622420556 60.35676232958753,5.997449366490741 60.401103563701305,6.087092815054746 60.40718177428317,6.09930092630103 60.362829654469174,6.00977622420556 60.35676232958753)))"
20100006725000,2335,1150,1185,42.4,"MULTIPOLYGON(((6.09930092630103 60.362829654469174,6.087092815054746 60.40718177428317,6.176774916413253 60.413199988512154,6.188864110613728 60.36883708645056,6.09930092630103 60.362829654469174)))"
20150006725000,2634,1335,1299,41.6,"MULTIPOLYGON(((6.188864110613728 60.36883708645056,6.176774916413253 60.413199988512154,6.266495310181245 60.419158155078286,6.278465418246881 60.374784574430244,6.188864110613728 60.36883708645056)))"
20200006725000,70,35,35,44.2,"MULTIPOLYGON(((6.278465418246881 60.374784574430244,6.266495310181245 60.419158155078286,6.356253634971044 60.4250562231437,6.368104489308355 60.380672067777134,6.278465418246881 60.374784574430244)))"
20250006725000,92,45,47,46,"MULTIPOLYGON(((6.368104489308355 60.380672067777134,6.356253634971044 60.4250562231437,6.446049528400425 60.430894142344115,6.457780962918738 60.38649951633195,6.368104489308355 60.380672067777134)))"
20300006725000,61,26,35,49.6,"MULTIPOLYGON(((6.457780962918738 60.38649951633195,6.446049528400425 60.430894142344115,6.535882627100823 60.43667186279058,6.547494477219454 60.39226687040894,6.457780962918738 60.38649951633195)))"
20350006725000,181,75,106,48.1,"MULTIPOLYGON(((6.547494477219454 60.39226687040894,6.535882627100823 60.43667186279058,6.625752566725547 60.4423893350709,6.637244669380963 60.39797408079736,6.547494477219454 60.39226687040894)))"
20400006725000,39,21,18,50,"MULTIPOLYGON(((6.637244669380963 60.39797408079736,6.625752566725547 60.4423893350709,6.715658981958141 60.448046510251274,6.727031175611028 60.40362109876302,6.637244669380963 60.39797408079736)))"
20450006725000,74,37,37,42.8,"MULTIPOLYGON(((6.727031175611028 60.40362109876302,6.715658981958141 60.448046510251274,6.805601506520704 60.4536433398778,6.816853631163019 60.409207876049834,6.727031175611028 60.40362109876302)))"
20600006725000,347,160,187,43.4,"MULTIPOLYGON(((6.996604926524671 60.420200517962336,6.985593413767754 60.464655771062525,7.075642059165563 60.47007127812627,7.086533032144846 60.425606288480026,6.996604926524671 60.420200517962336)))"
20650006725000,202,94,108,39.3,"MULTIPOLYGON(((7.086533032144846 60.425606288480026,7.075642059165563 60.47007127812627,7.165725339337185 60.47542625065019,7.17649561872506 60.430951630105845,7.086533032144846 60.425606288480026)))"
21050006725000,9,4,5,33.1,"MULTIPOLYGON(((7.807168050068917 60.466673223250844,7.797246800262079 60.51121228633413,7.887593728847351 60.516081366652,7.897393111468065 60.471533524485196,7.807168050068917 60.466673223250844)))"
21150006725000,28,14,14,57,"MULTIPOLYGON(((7.98764929752795 60.476333001893465,7.977971921581081 60.520889515866685,8.068380999638478 60.525636692397924,8.077936231047406 60.48107161406669,7.98764929752795 60.476333001893465)))"
21200006725000,62,32,30,47.4,"MULTIPOLYGON(((8.077936231047406 60.48107161406669,8.068380999638478 60.525636692397924,8.158820583366113 60.53032285516682,8.168253534002746 60.485749320095486,8.077936231047406 60.48107161406669)))"
21250006725000,1207,569,638,43.6,"MULTIPOLYGON(((8.168253534002746 60.485749320095486,8.158820583366113 60.53032285516682,8.249290292291203 60.53494796359737,8.25860082755701 60.49036607957123,8.168253534002746 60.485749320095486)))"
21400006725000,2,1,1,0,"MULTIPOLYGON(((8.439383867103937 60.49941659974114,8.430318559802128 60.54401485766107,8.520876353430204 60.54845656466783,8.529818851440242 60.50385028213389,8.439383867103937 60.49941659974114)))"
21600006725000,15,9,6,58.6,"MULTIPOLYGON(((8.801293076471588 60.51678455935927,8.792719767645535 60.56141426449621,8.883389632869399 60.565610898935276,8.89183963043403 60.5209736038618,8.801293076471588 60.51678455935927)))"
21650006725000,63,34,29,53.3,"MULTIPOLYGON(((8.89183963043403 60.5209736038618,8.883389632869399 60.565610898935276,8.974086551146629 60.569746172682365,8.98241311614849 60.52510139672521,8.89183963043403 60.5209736038618)))"
21700006725000,261,152,109,47.9,"MULTIPOLYGON(((8.98241311614849 60.52510139672521,8.974086551146629 60.569746172682365,9.064810135057954 60.57382004974374,9.07301314788317 60.52916790210505,8.98241311614849 60.52510139672521)))"
21750006725000,1810,913,897,46.8,"MULTIPOLYGON(((9.07301314788317 60.52916790210505,9.064810135057954 60.57382004974374,9.155559996460733 60.577832494640845,9.163639339188292 60.53317308467006,9.07301314788317 60.52916790210505)))"
21800006725000,20,11,9,44.5,"MULTIPOLYGON(((9.163639339188292 60.53317308467006,9.155559996460733 60.577832494640845,9.246335746498827 60.58178347241155,9.25429130290589 60.53711690960323,9.163639339188292 60.53317308467006)))"
22100006725000,203,107,96,42.2,"MULTIPOLYGON(((9.707924108825374 60.555914487341035,9.70058916756295 60.60061516698262,9.791512044733889 60.60419663684859,9.798722538289958 60.55948946426904,9.707924108825374 60.555914487341035)))"
22200006725000,19,9,10,42.5,"MULTIPOLYGON(((9.889544011065697 60.56300285434028,9.882458069408422 60.60771640940551,9.97342684738348 60.61117445386196,9.980388134687722 60.56645462689174,9.889544011065697 60.56300285434028)))"
22250006725000,131,72,59,52.3,"MULTIPOLYGON(((9.980388134687722 60.56645462689174,9.97342684738348 60.61117445386196,10.064417983833447 60.614570739952626,10.071254516073282 60.569844751784295,9.980388134687722 60.56645462689174)))"
22400006725000,81,49,32,46.7,"MULTIPOLYGON(((10.25305247677614 60.576439940662,10.24646574980486 60.6211779186117,10.337521586655452 60.624388753288734,10.343983266930985 60.5796449469975,10.25305247677614 60.576439940662)))"
22450006725000,121,62,59,50,"MULTIPOLYGON(((10.343983266930985 60.5796449469975,10.337521586655452 60.624388753288734,10.428598196660086 60.62753771381914,10.434934736545172 60.58278819037666,10.343983266930985 60.5796449469975)))"
22500006725000,56,32,24,41.9,"MULTIPOLYGON(((10.434934736545172 60.58278819037666,10.428598196660086 60.62753771381914,10.519695182036102 60.63062477258259,10.525906489601113 60.58586964329462,10.434934736545172 60.58278819037666)))"
22550006725000,767,402,365,46.4,"MULTIPOLYGON(((10.525906489601113 60.58586964329462,10.519695182036102 60.63062477258259,10.610812144440839 60.63364990249058,10.61689812952545 60.58888927877612,10.525906489601113 60.58586964329462)))"
22600006725000,231,112,119,45.7,"MULTIPOLYGON(((10.61689812952545 60.58888927877612,10.610812144440839 60.63364990249058,10.701948684982225 60.63661307698728,10.70790925919955 60.59184707037641,10.61689812952545 60.58888927877612)))"
22650006725000,1062,562,500,43.3,"MULTIPOLYGON(((10.70790925919955 60.59184707037641,10.701948684982225 60.63661307698728,10.793104404229368 60.63951427005045,10.798939480970004 60.594742992182184,10.70790925919955 60.59184707037641)))"
22700006725000,681,343,338,44.6,"MULTIPOLYGON(((10.798939480970004 60.594742992182184,10.793104404229368 60.63951427005045,10.8842789022232 60.64235345619231,10.88998839665922 60.59757701881229,10.798939480970004 60.594742992182184)))"
22750006725000,920,474,446,42.9,"MULTIPOLYGON(((10.88998839665922 60.59757701881229,10.8842789022232 60.64235345619231,10.975471778487153 60.645130610460335,10.981055607576007 60.60034912541874,10.88998839665922 60.59757701881229)))"
22800006725000,666,347,319,42.1,"MULTIPOLYGON(((10.981055607576007 60.60034912541874,10.975471778487153 60.645130610460335,11.066682632037873 60.64784570843817,11.072140714526196 60.60305928768745,10.981055607576007 60.60034912541874)))"
22850006725000,85,43,42,44.9,"MULTIPOLYGON(((11.072140714526196 60.60305928768745,11.066682632037873 60.64784570843817,11.157911061395966 60.65049872624632,11.163243317823335 60.60570748183901,11.072140714526196 60.60305928768745)))"
22900006725000,334,169,165,44.8,"MULTIPOLYGON(((11.163243317823335 60.60570748183901,11.157911061395966 60.65049872624632,11.249156664596773 60.65308964054306,11.254363017299365 60.60829368462955,11.163243317823335 60.60570748183901)))"
22950006725000,711,365,346,45.5,"MULTIPOLYGON(((11.254363017299365 60.60829368462955,11.249156664596773 60.65308964054306,11.3404190392012 60.655618428525145,11.345499412315371 60.61081787335144,11.254363017299365 60.60829368462955)))"
23000006725000,171,88,83,44.4,"MULTIPOLYGON(((11.345499412315371 60.61081787335144,11.3404190392012 60.655618428525145,11.431697782306546 60.65808506792861,11.436652101772337 60.61328002583413,11.345499412315371 60.61081787335144)))"
23050006725000,11,6,5,51.4,"MULTIPOLYGON(((11.436652101772337 60.61328002583413,11.431697782306546 60.65808506792861,11.5229924905574 60.66048953702948,11.527820684121954 60.61568012044476,11.436652101772337 60.61328002583413)))"
23200006725000,8,4,4,33.3,"MULTIPOLYGON(((11.710203919124416 60.62029405221175,11.70562818687587 60.665111880131754,11.796968366067418 60.66732971339161,11.801417766531767 60.622507848797625,11.710203919124416 60.62029405221175)))"
23250006725000,666,316,350,50.5,"MULTIPOLYGON(((11.801417766531767 60.622507848797625,11.796968366067418 60.66732971339161,11.8883228926743 60.66948529486713,11.89264589636259 60.624659506371934,11.801417766531767 60.622507848797625)))"
23300006725000,69,35,34,50.7,"MULTIPOLYGON(((11.89264589636259 60.624659506371934,11.8883228926743 60.66948529486713,11.97969136124177 60.67157860554482,11.983887904985123 60.626749006001084,11.89264589636259 60.624659506371934)))"
23350006725000,1104,548,556,46.1,"MULTIPOLYGON(((11.983887904985123 60.626749006001084,11.97969136124177 60.67157860554482,12.071073365928271 60.67360962695529,12.075143388383722 60.62877632929329,11.983887904985123 60.626749006001084)))"
23400006725000,374,191,183,45.4,"MULTIPOLYGON(((12.075143388383722 60.62877632929329,12.071073365928271 60.67360962695529,12.162468500516521 60.67557834117379,12.166411942169859 60.630741458399235,12.075143388383722 60.62877632929329)))"
23450006725000,286,153,133,50.9,"MULTIPOLYGON(((12.166411942169859 60.630741458399235,12.162468500516521 60.67557834117379,12.253876358424614 60.677484730820915,12.257693161593153 60.632644376012585,12.166411942169859 60.630741458399235)))"
23500006725000,109,56,53,47.9,"MULTIPOLYGON(((12.257693161593153 60.632644376012585,12.253876358424614 60.677484730820915,12.345296532717159 60.67932877906312,12.34898664155241 60.634485065370605,12.257693161593153 60.632644376012585)))"
23550006725000,28,16,12,55.4,"MULTIPOLYGON(((12.34898664155241 60.634485065370605,12.345296532717159 60.67932877906312,12.436728616116445 60.681110469613316,12.440291976606716 60.63626351025475,12.34898664155241 60.634485065370605)))"
23600006725000,2,2,0,0,"MULTIPOLYGON(((12.440291976606716 60.63626351025475,12.436728616116445 60.681110469613316,12.528172201013609 60.68282978673139,12.53160876098651 60.63797969499117,12.440291976606716 60.63626351025475)))"
19450006730000,1445,758,687,37,"MULTIPOLYGON(((4.924872678536516 60.323504635264186,4.911091456594868 60.36770506851871,5.000360270191548 60.374511206052446,5.014024559306258 60.330298630304206,4.924872678536516 60.323504635264186)))"
19500006730000,2330,1170,1160,35.8,"MULTIPOLYGON(((5.014024559306258 60.330298630304206,5.000360270191548 60.374511206052446,5.089672169078456 60.38125789811726,5.103219336415489 60.337033280934364,5.014024559306258 60.330298630304206)))"
19550006730000,12671,6409,6262,39.9,"MULTIPOLYGON(((5.103219336415489 60.337033280934364,5.089672169078456 60.38125789811726,5.179026804108314 60.3879450876373,5.19245666212095 60.343708530308795,5.103219336415489 60.337033280934364)))"
19600006730000,23794,11852,11942,40.6,"MULTIPOLYGON(((5.19245666212095 60.343708530308795,5.179026804108314 60.3879450876373,5.268423825030845 60.394572717990314,5.281736187584346 60.35032432203365,5.19245666212095 60.343708530308795)))"
19650006730000,71576,36985,34591,37.7,"MULTIPOLYGON(((5.281736187584346 60.35032432203365,5.268423825030845 60.394572717990314,5.357862880500186 60.40114073300941,5.371057562879675 60.356880600168765,5.281736187584346 60.35032432203365)))"
19700006730000,4527,2182,2345,39,"MULTIPOLYGON(((5.371057562879675 60.356880600168765,5.357862880500186 60.40114073300941,5.447343618082308 60.407649076984804,5.460420437000662 60.36337730922942,5.371057562879675 60.356880600168765)))"
19750006730000,3202,1627,1575,37.6,"MULTIPOLYGON(((5.460420437000662 60.36337730922942,5.447343618082308 60.407649076984804,5.536865684262542 60.41409769466551,5.549824457868169 60.36981439418805,5.460420437000662 60.36337730922942)))"
19850006730000,263,136,127,45.6,"MULTIPOLYGON(((5.639269272337776 60.37619180047599,5.626428724453138 60.4204865312611,5.716032383000953 60.42681553244332,5.728754526207365 60.38250947398508,5.639269272337776 60.37619180047599)))"
19900006730000,1305,659,646,42.3,"MULTIPOLYGON(((5.728754526207365 60.38250947398508,5.716032383000953 60.42681553244332,5.805676303195116 60.433084644347964,5.818279864224771 60.388767361069426,5.728754526207365 60.38250947398508)))"
19950006730000,29,16,13,46.8,"MULTIPOLYGON(((5.818279864224771 60.388767361069426,5.805676303195116 60.433084644347964,5.895360127274861 60.43929381357632,5.907844930095555 60.394965408546966,5.818279864224771 60.388767361069426)))"
20150006730000,34,16,18,35.6,"MULTIPOLYGON(((6.176774916413253 60.413199988512154,6.164647429636182 60.4575611382363,6.254487270928053 60.4635300121433,6.266495310181245 60.419158155078286,6.176774916413253 60.413199988512154)))"
20250006730000,400,194,206,43.8,"MULTIPOLYGON(((6.356253634971044 60.4250562231437,6.344365211829753 60.46943868342285,6.434280888448079 60.47528710150456,6.446049528400425 60.430894142344115,6.356253634971044 60.4250562231437)))"
20300006730000,138,72,66,48.4,"MULTIPOLYGON(((6.446049528400425 60.430894142344115,6.434280888448079 60.47528710150456,6.524233935896216 60.481075216295025,6.535882627100823 60.43667186279058,6.446049528400425 60.430894142344115)))"
20350006730000,30,19,11,57.3,"MULTIPOLYGON(((6.535882627100823 60.43667186279058,6.524233935896216 60.481075216295025,6.614223988302031 60.48680297817956,6.625752566725547 60.4423893350709,6.535882627100823 60.43667186279058)))"
20400006730000,54,29,25,47,"MULTIPOLYGON(((6.625752566725547 60.4423893350709,6.614223988302031 60.48680297817956,6.704250678816448 60.49247033802352,6.715658981958141 60.448046510251274,6.625752566725547 60.4423893350709)))"
20450006730000,52,29,23,48.9,"MULTIPOLYGON(((6.715658981958141 60.448046510251274,6.704250678816448 60.49247033802352,6.794313639621881 60.498077247174145,6.805601506520704 60.4536433398778,6.715658981958141 60.448046510251274)))"
20500006730000,80,44,36,45.2,"MULTIPOLYGON(((6.805601506520704 60.4536433398778,6.794313639621881 60.498077247174145,6.884412501940712 60.50362365746185,6.895579773182366 60.45917977597803,6.805601506520704 60.4536433398778)))"
20550006730000,6,3,3,65.8,"MULTIPOLYGON(((6.895579773182366 60.45917977597803,6.884412501940712 60.50362365746185,6.974546896043854 60.5091095212019,6.985593413767754 60.464655771062525,6.895579773182366 60.45917977597803)))"
20600006730000,9,5,4,55.6,"MULTIPOLYGON(((6.985593413767754 60.464655771062525,6.974546896043854 60.5091095212019,7.06471645125936 60.51453479119588,7.075642059165563 60.47007127812627,6.985593413767754 60.464655771062525)))"
20650006730000,127,65,62,42.7,"MULTIPOLYGON(((7.075642059165563 60.47007127812627,7.06471645125936 60.51453479119588,7.154920795981099 60.51989942073318,7.165725339337185 60.47542625065019,7.075642059165563 60.47007127812627)))"
20700006730000,4,3,1,0,"MULTIPOLYGON(((7.165725339337185 60.47542625065019,7.154920795981099 60.51989942073318,7.245159557677501 60.52520336359257,7.255842883325362 60.48072064260274,7.165725339337185 60.47542625065019)))"
21200006730000,20,9,11,40.3,"MULTIPOLYGON(((8.068380999638478 60.525636692397924,8.058795262422755 60.57020056639813,8.149357507397026 60.57489520899547,8.158820583366113 60.53032285516682,8.068380999638478 60.525636692397924)))"
21250006730000,1471,743,728,42.9,"MULTIPOLYGON(((8.158820583366113 60.53032285516682,8.149357507397026 60.57489520899547,8.239950012977278 60.579528689187974,8.249290292291203 60.53494796359737,8.158820583366113 60.53032285516682)))"
21300006730000,204,115,89,42.8,"MULTIPOLYGON(((8.249290292291203 60.53494796359737,8.239950012977278 60.579528689187974,8.330572396229499 60.58410096673727,8.339789745130986 60.53951197761763,8.249290292291203 60.53494796359737)))"
21350006730000,85,52,33,44.6,"MULTIPOLYGON(((8.339789745130986 60.53951197761763,8.330572396229499 60.58410096673727,8.421224273413126 60.58861200191241,8.430318559802128 60.54401485766107,8.339789745130986 60.53951197761763)))"
21400006730000,27,15,12,47.6,"MULTIPOLYGON(((8.430318559802128 60.54401485766107,8.421224273413126 60.58861200191241,8.511905259990572 60.593061755491135,8.520876353430204 60.54845656466783,8.430318559802128 60.54401485766107)))"
21700006730000,16,8,8,36.9,"MULTIPOLYGON(((8.974086551146629 60.569746172682365,8.965733320390104 60.61438996242667,9.056580844622363 60.618471231404506,9.064810135057954 60.57382004974374,8.974086551146629 60.569746172682365)))"
21750006730000,586,293,293,41.6,"MULTIPOLYGON(((9.064810135057954 60.57382004974374,9.056580844622363 60.618471231404506,9.147454764980601 60.622490958578474,9.155559996460733 60.577832494640845,9.064810135057954 60.57382004974374)))"
22000006730000,10,4,6,68,"MULTIPOLYGON(((9.518814429369705 60.59326726111329,9.511206585815426 60.6379537548729,9.60220661431308 60.64166525681385,9.609689831465834 60.59697203112401,9.518814429369705 60.59326726111329)))"
22050006730000,145,81,64,48.3,"MULTIPOLYGON(((9.609689831465834 60.59697203112401,9.60220661431308 60.64166525681385,9.693230685119522 60.645315014118346,9.70058916756295 60.60061516698262,9.609689831465834 60.59697203112401)))"
22100006730000,226,114,112,48.3,"MULTIPOLYGON(((9.70058916756295 60.60061516698262,9.693230685119522 60.645315014118346,9.784278403568756 60.648902994812545,9.791512044733889 60.60419663684859,9.70058916756295 60.60061516698262)))"
22150006730000,159,85,74,50.2,"MULTIPOLYGON(((9.791512044733889 60.60419663684859,9.784278403568756 60.648902994812545,9.875349374346861 60.652429167448744,9.882458069408422 60.60771640940551,9.791512044733889 60.60419663684859)))"
22200006730000,80,46,34,50.6,"MULTIPOLYGON(((9.882458069408422 60.60771640940551,9.875349374346861 60.652429167448744,9.966443201502296 60.65589350110639,9.97342684738348 60.61117445386196,9.882458069408422 60.60771640940551)))"
22400006730000,84,50,34,47.6,"MULTIPOLYGON(((10.24646574980486 60.6211779186117,10.239857852370545 60.66591516693258,10.331039133130782 60.669131846050554,10.337521586655452 60.624388753288734,10.24646574980486 60.6211779186117)))"
22450006730000,455,240,215,47.9,"MULTIPOLYGON(((10.337521586655452 60.624388753288734,10.331039133130782 60.669131846050554,10.422241281310292 60.67228653953063,10.428598196660086 60.62753771381914,10.337521586655452 60.624388753288734)))"
22500006730000,146,81,65,44.8,"MULTIPOLYGON(((10.428598196660086 60.62753771381914,10.422241281310292 60.67228653953063,10.513463897350796 60.6753792196364,10.519695182036102 60.63062477258259,10.428598196660086 60.62753771381914)))"
22550006730000,362,181,181,45.4,"MULTIPOLYGON(((10.519695182036102 60.63062477258259,10.513463897350796 60.6753792196364,10.604706581129776 60.67840985916541,10.610812144440839 60.63364990249058,10.519695182036102 60.63062477258259)))"
22600006730000,1423,734,689,44.9,"MULTIPOLYGON(((10.610812144440839 60.63364990249058,10.604706581129776 60.67840985916541,10.695968931971114 60.68137843145011,10.701948684982225 60.63661307698728,10.610812144440839 60.63364990249058)))"
22650006730000,1520,776,744,43.5,"MULTIPOLYGON(((10.701948684982225 60.63661307698728,10.695968931971114 60.68137843145011,10.787250548655793 60.68428491035873,10.793104404229368 60.63951427005045,10.701948684982225 60.63661307698728)))"
22700006730000,2496,1209,1287,45.4,"MULTIPOLYGON(((10.793104404229368 60.63951427005045,10.787250548655793 60.68428491035873,10.878551029432591 60.68712927029615,10.8842789022232 60.64235345619231,10.793104404229368 60.63951427005045)))"
22750006730000,2022,990,1032,45.9,"MULTIPOLYGON(((10.8842789022232 60.64235345619231,10.878551029432591 60.68712927029615,10.96986997202886 60.68991148620472,10.975471778487153 60.645130610460335,10.8842789022232 60.64235345619231)))"
22800006730000,195,91,104,44.1,"MULTIPOLYGON(((10.975471778487153 60.645130610460335,10.96986997202886 60.68991148620472,11.061206973661303 60.69263153356525,11.066682632037873 60.64784570843817,10.975471778487153 60.645130610460335)))"
22850006730000,81,39,42,49.7,"MULTIPOLYGON(((11.066682632037873 60.64784570843817,11.061206973661303 60.69263153356525,11.152561631046805 60.69528938839755,11.157911061395966 60.65049872624632,11.066682632037873 60.64784570843817)))"
22900006730000,315,171,144,43.8,"MULTIPOLYGON(((11.157911061395966 60.65049872624632,11.152561631046805 60.69528938839755,11.243933540413297 60.697885027261485,11.249156664596773 60.65308964054306,11.157911061395966 60.65049872624632)))"
22950006730000,185,96,89,45.5,"MULTIPOLYGON(((11.249156664596773 60.65308964054306,11.243933540413297 60.697885027261485,11.335322297510652 60.7004184272576,11.3404190392012 60.655618428525145,11.249156664596773 60.65308964054306)))"
23000006730000,1190,576,614,43.8,"MULTIPOLYGON(((11.3404190392012 60.655618428525145,11.335322297510652 60.7004184272576,11.426727497621611 60.70288956602801,11.431697782306546 60.65808506792861,11.3404190392012 60.655618428525145)))"
23200006730000,177,92,85,48.1,"MULTIPOLYGON(((11.70562818687587 60.665111880131754,11.701037702086964 60.7099291995436,11.792504618121423 60.712151080687576,11.796968366067418 60.66732971339161,11.70562818687587 60.665111880131754)))"
23250006730000,1127,547,580,47.4,"MULTIPOLYGON(((11.796968366067418 60.66732971339161,11.792504618121423 60.712151080687576,11.883985946960951 60.71431059696421,11.8883228926743 60.66948529486713,11.796968366067418 60.66732971339161)))"
23300006730000,435,222,213,43.4,"MULTIPOLYGON(((11.8883228926743 60.66948529486713,11.883985946960951 60.71431059696421,11.975481281316759 60.7164077292796,11.97969136124177 60.67157860554482,11.8883228926743 60.66948529486713)))"
23350006730000,142,69,73,45.9,"MULTIPOLYGON(((11.97969136124177 60.67157860554482,11.975481281316759 60.7164077292796,12.066990213510302 60.71844245908629,12.071073365928271 60.67360962695529,11.97969136124177 60.67157860554482)))"
23400006730000,161,81,80,43,"MULTIPOLYGON(((12.071073365928271 60.67360962695529,12.066990213510302 60.71844245908629,12.158512335484422 60.72041476838374,12.162468500516521 60.67557834117379,12.071073365928271 60.67360962695529)))"
23450006730000,3,1,2,0,"MULTIPOLYGON(((12.162468500516521 60.67557834117379,12.158512335484422 60.72041476838374,12.250047238814561 60.72232463971898,12.253876358424614 60.677484730820915,12.162468500516521 60.67557834117379)))"
23500006730000,23,14,9,56.3,"MULTIPOLYGON(((12.253876358424614 60.677484730820915,12.250047238814561 60.72232463971898,12.341594514719977 60.72417205618724,12.345296532717159 60.67932877906312,12.253876358424614 60.677484730820915)))"
23550006730000,85,46,39,49.9,"MULTIPOLYGON(((12.345296532717159 60.67932877906312,12.341594514719977 60.72417205618724,12.43315375407497 60.72595700143248,12.436728616116445 60.681110469613316,12.345296532717159 60.67932877906312)))"
23600006730000,13,6,7,55.5,"MULTIPOLYGON(((12.436728616116445 60.681110469613316,12.43315375407497 60.72595700143248,12.524724547420174 60.727679459647916,12.528172201013609 60.68282978673139,12.436728616116445 60.681110469613316)))"
19450006735000,1710,869,841,34.8,"MULTIPOLYGON(((4.911091456594868 60.36770506851871,4.897266801139737 60.411903312178914,4.986652895601564 60.41872162459893,5.000360270191548 60.374511206052446,4.911091456594868 60.36770506851871)))"
19500006735000,2945,1505,1440,37.3,"MULTIPOLYGON(((5.000360270191548 60.374511206052446,4.986652895601564 60.41872162459893,5.076082265414659 60.42548039024837,5.089672169078456 60.38125789811726,5.000360270191548 60.374511206052446)))"
19550006735000,4115,2105,2010,37.5,"MULTIPOLYGON(((5.089672169078456 60.38125789811726,5.076082265414659 60.42548039024837,5.165554560020403 60.432179551820106,5.179026804108314 60.3879450876373,5.089672169078456 60.38125789811726)))"
19600006735000,12602,6312,6290,38.7,"MULTIPOLYGON(((5.179026804108314 60.3879450876373,5.165554560020403 60.432179551820106,5.255069427749188 60.438819052462236,5.268423825030845 60.394572717990314,5.179026804108314 60.3879450876373)))"
19650006735000,20942,10483,10459,40.4,"MULTIPOLYGON(((5.268423825030845 60.394572717990314,5.255069427749188 60.438819052462236,5.344626515827813 60.44539883577986,5.357862880500186 60.40114073300941,5.268423825030845 60.394572717990314)))"
19700006735000,255,132,123,44,"MULTIPOLYGON(((5.357862880500186 60.40114073300941,5.344626515827813 60.44539883577986,5.43422547038701 60.45191884583684,5.447343618082308 60.407649076984804,5.357862880500186 60.40114073300941)))"
19750006735000,6946,3503,3443,42.5,"MULTIPOLYGON(((5.447343618082308 60.407649076984804,5.43422547038701 60.45191884583684,5.523865936468972 60.45837902715754,5.536865684262542 60.41409769466551,5.447343618082308 60.407649076984804)))"
19800006735000,404,209,195,41.4,"MULTIPOLYGON(((5.536865684262542 60.41409769466551,5.523865936468972 60.45837902715754,5.613547558035007 60.4647793247285,5.626428724453138 60.4204865312611,5.536865684262542 60.41409769466551)))"
19850006735000,292,153,139,44,"MULTIPOLYGON(((5.626428724453138 60.4204865312611,5.613547558035007 60.4647793247285,5.703269977973198 60.47111968400022,5.716032383000953 60.42681553244332,5.626428724453138 60.4204865312611)))"
19900006735000,151,79,72,42.9,"MULTIPOLYGON(((5.716032383000953 60.42681553244332,5.703269977973198 60.47111968400022,5.79303283810621 60.47740005088885,5.805676303195116 60.433084644347964,5.716032383000953 60.42681553244332)))"
19950006735000,3,3,0,0,"MULTIPOLYGON(((5.805676303195116 60.433084644347964,5.79303283810621 60.47740005088885,5.882835779199091 60.48362037177785,5.895360127274861 60.43929381357632,5.805676303195116 60.433084644347964)))"
20300006735000,10,7,3,40.3,"MULTIPOLYGON(((6.434280888448079 60.47528710150456,6.422474877501712 60.51967838789769,6.512548239571113 60.52547692513149,6.524233935896216 60.481075216295025,6.434280888448079 60.47528710150456)))"
20400006735000,44,23,21,47.5,"MULTIPOLYGON(((6.614223988302031 60.48680297817956,6.602658771608487 60.53121500445621,6.692806105223738 60.53689257653533,6.704250678816448 60.49247033802352,6.614223988302031 60.48680297817956)))"
20450006735000,565,279,286,43.2,"MULTIPOLYGON(((6.704250678816448 60.49247033802352,6.692806105223738 60.53689257653533,6.78298987105108 60.542509592516,6.794313639621881 60.498077247174145,6.704250678816448 60.49247033802352)))"
20550006735000,30,14,16,49,"MULTIPOLYGON(((6.884412501940712 60.50362365746185,6.873209698757609 60.54806600403038,6.9634652170519 60.5535617631974,6.974546896043854 60.5091095212019,6.884412501940712 60.50362365746185)))"
21200006735000,1,1,0,0,"MULTIPOLYGON(((8.058795262422755 60.57020056639813,8.049178882345513 60.61476323222857,8.139864170685955 60.619466377847104,8.149357507397026 60.57489520899547,8.058795262422755 60.57020056639813)))"
21250006735000,72,37,35,43.6,"MULTIPOLYGON(((8.149357507397026 60.57489520899547,8.139864170685955 60.619466377847104,8.23057985585695 60.624108252711956,8.239950012977278 60.579528689187974,8.149357507397026 60.57489520899547)))"
21300006735000,480,240,240,47,"MULTIPOLYGON(((8.239950012977278 60.579528689187974,8.23057985585695 60.624108252711956,8.321325553263767 60.628688816417345,8.330572396229499 60.58410096673727,8.239950012977278 60.579528689187974)))"
21350006735000,155,82,73,42.3,"MULTIPOLYGON(((8.330572396229499 60.58410096673727,8.321325553263767 60.628688816417345,8.412100877499071 60.63320802906696,8.421224273413126 60.58861200191241,8.330572396229499 60.58410096673727)))"
21400006735000,98,54,44,52.9,"MULTIPOLYGON(((8.421224273413126 60.58861200191241,8.412100877499071 60.63320802906696,8.50290544235252 60.6376658512752,8.511905259990572 60.593061755491135,8.421224273413126 60.58861200191241)))"
21450006735000,2673,1278,1395,44.1,"MULTIPOLYGON(((8.511905259990572 60.593061755491135,8.50290544235252 60.6376658512752,8.593738860820423 60.6420622441684,8.602614970636797 60.59745018876114,8.511905259990572 60.593061755491135)))"
21500006735000,8,6,2,51.4,"MULTIPOLYGON(((8.602614970636797 60.59745018876114,8.593738860820423 60.6420622441684,8.684600745115445 60.64639716938625,8.693353019248988 60.601777263521335,8.602614970636797 60.59745018876114)))"
21700006735000,84,41,43,54.8,"MULTIPOLYGON(((8.965733320390104 60.61438996242667,8.957353303540756 60.659032763108954,9.04832515794098 60.66312144433038,9.056580844622363 60.618471231404506,8.965733320390104 60.61438996242667)))"
21750006735000,125,63,62,43.3,"MULTIPOLYGON(((9.056580844622363 60.618471231404506,9.04832515794098 60.66312144433038,9.139323527820592 60.667148473816795,9.147454764980601 60.622490958578474,9.056580844622363 60.618471231404506)))"
22050006735000,1,0,1,0,"MULTIPOLYGON(((9.60220661431308 60.64166525681385,9.594699354741843 60.6863576295808,9.685848554925306 60.69001402660047,9.693230685119522 60.645315014118346,9.60220661431308 60.64166525681385)))"
22100006735000,89,45,44,48.7,"MULTIPOLYGON(((9.693230685119522 60.645315014118346,9.685848554925306 60.69001402660047,9.777021509968478 60.69360853609494,9.784278403568756 60.648902994812545,9.693230685119522 60.645315014118346)))"
22150006735000,61,34,27,47.5,"MULTIPOLYGON(((9.784278403568756 60.648902994812545,9.777021509968478 60.69360853609494,9.868217822803436 60.697141126484496,9.875349374346861 60.652429167448744,9.784278403568756 60.648902994812545)))"
22400006735000,146,75,71,50.6,"MULTIPOLYGON(((10.239857852370545 60.66591516693258,10.233228688435949 60.710651683948036,10.32453581209103 60.71387422368021,10.331039133130782 60.669131846050554,10.239857852370545 60.66591516693258)))"
22450006735000,1955,947,1008,44.9,"MULTIPOLYGON(((10.331039133130782 60.669131846050554,10.32453581209103 60.71387422368021,10.415863898005467 60.717034665980954,10.422241281310292 60.67228653953063,10.331039133130782 60.669131846050554)))"
22500006735000,126,67,59,45.3,"MULTIPOLYGON(((10.422241281310292 60.67228653953063,10.415863898005467 60.717034665980954,10.507212544834752 60.72013298299705,10.513463897350796 60.6753792196364,10.422241281310292 60.67228653953063)))"
22550006735000,977,503,474,44.8,"MULTIPOLYGON(((10.513463897350796 60.6753792196364,10.507212544834752 60.72013298299705,10.598581350665865 60.72316914741145,10.604706581129776 60.67840985916541,10.513463897350796 60.6753792196364)))"
22600006735000,5546,2726,2820,42.2,"MULTIPOLYGON(((10.604706581129776 60.67840985916541,10.598581350665865 60.72316914741145,10.68996991302797 60.72614313244418,10.695968931971114 60.68137843145011,10.604706581129776 60.67840985916541)))"
22650006735000,669,348,321,43.6,"MULTIPOLYGON(((10.695968931971114 60.68137843145011,10.68996991302797 60.72614313244418,10.78137782890319 60.72905491185334,10.787250548655793 60.68428491035873,10.695968931971114 60.68137843145011)))"
22700006735000,2715,1342,1373,44.1,"MULTIPOLYGON(((10.787250548655793 60.68428491035873,10.78137782890319 60.72905491185334,10.872804694737408 60.73190445993581,10.878551029432591 60.68712927029615,10.787250548655793 60.68428491035873)))"
22750006735000,796,385,411,44.5,"MULTIPOLYGON(((10.878551029432591 60.68712927029615,10.872804694737408 60.73190445993581,10.964250106451093 60.7346917515283,10.96986997202886 60.68991148620472,10.878551029432591 60.68712927029615)))"
22800006735000,70,34,36,46.2,"MULTIPOLYGON(((10.96986997202886 60.68991148620472,10.964250106451093 60.7346917515283,11.055713659450179 60.73741676200804,11.061206973661303 60.69263153356525,10.96986997202886 60.68991148620472)))"
22850006735000,596,291,305,38.5,"MULTIPOLYGON(((11.061206973661303 60.69263153356525,11.055713659450179 60.73741676200804,11.147194948636976 60.74007946729364,11.152561631046805 60.69528938839755,11.061206973661303 60.69263153356525)))"
22900006735000,4123,2025,2098,42.3,"MULTIPOLYGON(((11.152561631046805 60.69528938839755,11.147194948636976 60.74007946729364,11.2386935684211 60.74267984384592,11.243933540413297 60.697885027261485,11.152561631046805 60.69528938839755)))"
22950006735000,1566,786,780,42.7,"MULTIPOLYGON(((11.243933540413297 60.697885027261485,11.2386935684211 60.74267984384592,11.33020911273047 60.74521786866874,11.335322297510652 60.7004184272576,11.243933540413297 60.697885027261485)))"
23000006735000,879,466,413,44.7,"MULTIPOLYGON(((11.335322297510652 60.7004184272576,11.33020911273047 60.74521786866874,11.421741175022307 60.74769351930959,11.426727497621611 60.70288956602801,11.335322297510652 60.7004184272576)))"
23050006735000,116,62,54,48,"MULTIPOLYGON(((11.426727497621611 60.70288956602801,11.421741175022307 60.74769351930959,11.513289348294167 60.75010677386063,11.518148735572746 60.70529842175701,11.426727497621611 60.70288956602801)))"
23100006735000,24,14,10,42.5,"MULTIPOLYGON(((11.518148735572746 60.70529842175701,11.513289348294167 60.75010677386063,11.60485322509504 60.75245761095914,11.609585605745451 60.707644973171874,11.518148735572746 60.70529842175701)))"
23200006735000,245,128,117,47.7,"MULTIPOLYGON(((11.701037702086964 60.7099291995436,11.69643239753644 60.75474600978843,11.788026457303543 60.75697195007838,11.792504618121423 60.712151080687576,11.701037702086964 60.7099291995436)))"
23250006735000,853,449,404,46.7,"MULTIPOLYGON(((11.792504618121423 60.712151080687576,11.788026457303543 60.75697195007838,11.879634995666358 60.75913541210634,11.883985946960951 60.71431059696421,11.792504618121423 60.712151080687576)))"
23300006735000,165,94,71,43.4,"MULTIPOLYGON(((11.883985946960951 60.71431059696421,11.879634995666358 60.75913541210634,11.971257603490919 60.76123637669758,11.975481281316759 60.7164077292796,11.883985946960951 60.71431059696421)))"
23500006735000,13,6,7,46.9,"MULTIPOLYGON(((12.250047238814561 60.72232463971898,12.246205746571752 60.767164102337205,12.337880533217604 60.76901489641657,12.341594514719977 60.72417205618724,12.250047238814561 60.72232463971898)))"
23550006735000,4,2,2,0,"MULTIPOLYGON(((12.341594514719977 60.72417205618724,12.337880533217604 60.76901489641657,12.429567337989557 60.77080310542761,12.43315375407497 60.72595700143248,12.341594514719977 60.72417205618724)))"
19450006740000,1248,631,617,39.3,"MULTIPOLYGON(((4.897266801139737 60.411903312178914,4.883398520705453 60.45609935800454,4.972902245473913 60.46292987784568,4.986652895601564 60.41872162459893,4.897266801139737 60.411903312178914)))"
19500006740000,851,440,411,37.7,"MULTIPOLYGON(((4.986652895601564 60.41872162459893,4.972902245473913 60.46292987784568,5.062449436773037 60.469700749371114,5.076082265414659 60.42548039024837,4.986652895601564 60.41872162459893)))"
19550006740000,4956,2503,2453,36.8,"MULTIPOLYGON(((5.076082265414659 60.42548039024837,5.062449436773037 60.469700749371114,5.152039742625521 60.476411915041126,5.165554560020403 60.432179551820106,5.076082265414659 60.42548039024837)))"
19600006740000,5492,2834,2658,38.2,"MULTIPOLYGON(((5.165554560020403 60.432179551820106,5.152039742625521 60.476411915041126,5.241672809934991 60.483063317772874,5.255069427749188 60.438819052462236,5.165554560020403 60.432179551820106)))"
19650006740000,22840,11184,11656,42.3,"MULTIPOLYGON(((5.255069427749188 60.438819052462236,5.241672809934991 60.483063317772874,5.331348284493441 60.489654900942135,5.344626515827813 60.44539883577986,5.255069427749188 60.438819052462236)))"
19700006740000,11165,5650,5515,39.4,"MULTIPOLYGON(((5.344626515827813 60.44539883577986,5.331348284493441 60.489654900942135,5.421065810988788 60.4961866083852,5.43422547038701 60.45191884583684,5.344626515827813 60.44539883577986)))"
19750006740000,1940,1044,896,40,"MULTIPOLYGON(((5.43422547038701 60.45191884583684,5.421065810988788 60.4961866083852,5.510825033012468 60.50265838440048,5.523865936468972 60.45837902715754,5.43422547038701 60.45191884583684)))"
19800006740000,433,219,214,41.1,"MULTIPOLYGON(((5.523865936468972 60.45837902715754,5.510825033012468 60.50265838440048,5.600625593067129 60.50907017375028,5.613547558035007 60.4647793247285,5.523865936468972 60.45837902715754)))"
19850006740000,239,130,109,47.7,"MULTIPOLYGON(((5.613547558035007 60.4647793247285,5.600625593067129 60.50907017375028,5.690467132574352 60.515421921662536,5.703269977973198 60.47111968400022,5.613547558035007 60.4647793247285)))"
19900006740000,1030,532,498,41.4,"MULTIPOLYGON(((5.703269977973198 60.47111968400022,5.690467132574352 60.515421921662536,5.780349291882475 60.52171357383259,5.79303283810621 60.47740005088885,5.703269977973198 60.47111968400022)))"
20100006740000,1,0,1,0,"MULTIPOLYGON(((6.062560462084047 60.49588066343752,6.05023587616299 60.54022741988844,6.140276896970493 60.54627815544905,6.152481480189587 60.501920529326824,6.062560462084047 60.49588066343752)))"
20300006740000,41,19,22,50.9,"MULTIPOLYGON(((6.422474877501712 60.51967838789769,6.410631329015985 60.56406799557161,6.500825373113997 60.56987698347356,6.512548239571113 60.52547692513149,6.422474877501712 60.51967838789769)))"
20400006740000,23,15,8,52,"MULTIPOLYGON(((6.602658771608487 60.53121500445621,6.591056753174455 60.57562540819889,6.681325099257743 60.58131322020805,6.692806105223738 60.53689257653533,6.602658771608487 60.53121500445621)))"
20450006740000,229,120,109,42,"MULTIPOLYGON(((6.692806105223738 60.53689257653533,6.681325099257743 60.58131322020805,6.771630040441339 60.586940370446946,6.78298987105108 60.542509592516,6.692806105223738 60.53689257653533)))"
20500006740000,6,5,1,25.7,"MULTIPOLYGON(((6.78298987105108 60.542509592516,6.771630040441339 60.586940370446946,6.861971204828433 60.59250681034843,6.873209698757609 60.54806600403038,6.78298987105108 60.542509592516)))"
20550006740000,911,445,466,44.6,"MULTIPOLYGON(((6.873209698757609 60.54806600403038,6.861971204828433 60.59250681034843,6.952348219556595 60.59801249183385,6.9634652170519 60.5535617631974,6.873209698757609 60.54806600403038)))"
20600006740000,77,46,31,43.4,"MULTIPOLYGON(((6.9634652170519 60.5535617631974,6.952348219556595 60.59801249183385,7.042760710806505 60.60345736731467,7.053756053692682 60.55899682262407,6.9634652170519 60.5535617631974)))"
20850006740000,5,4,1,53.8,"MULTIPOLYGON(((7.415265106141639 60.58012913223982,7.404757931639953 60.624627874657556,7.495342165336418 60.62976802354483,7.505726918266116 60.58525999926259,7.415265106141639 60.58012913223982)))"
20900006740000,5,3,2,31.6,"MULTIPOLYGON(((7.505726918266116 60.58525999926259,7.495342165336418 60.62976802354483,7.58595961304065 60.63484709127173,7.59622179583612 60.59032989252317,7.505726918266116 60.58525999926259)))"
21150006740000,32,13,19,45.4,"MULTIPOLYGON(((7.958524374608203 60.60999885677015,7.948753925359736 60.654551675786806,8.039531721526531 60.65932468602632,8.049178882345513 60.61476323222857,7.958524374608203 60.60999885677015)))"
21200006740000,58,26,32,53.6,"MULTIPOLYGON(((8.049178882345513 60.61476323222857,8.039531721526531 60.65932468602632,8.1303404370073 60.664036357963894,8.139864170685955 60.619466377847104,8.049178882345513 60.61476323222857)))"
21250006740000,295,160,135,45.4,"MULTIPOLYGON(((8.139864170685955 60.619466377847104,8.1303404370073 60.664036357963894,8.22117968636536 60.668686650515326,8.23057985585695 60.624108252711956,8.139864170685955 60.619466377847104)))"
21400006740000,41,19,22,47.5,"MULTIPOLYGON(((8.412100877499071 60.63320802906696,8.402948240834647 60.67780293567481,8.493876770969408 60.68226884867028,8.50290544235252 60.6376658512752,8.412100877499071 60.63320802906696)))"
21450006740000,255,134,121,42.8,"MULTIPOLYGON(((8.50290544235252 60.6376658512752,8.493876770969408 60.68226884867028,8.584834285047936 60.686673223057085,8.593738860820423 60.6420622441684,8.50290544235252 60.6376658512752)))"
21500006740000,476,245,231,41.2,"MULTIPOLYGON(((8.593738860820423 60.6420622441684,8.584834285047936 60.686673223057085,8.675820393588635 60.6910160203146,8.684600745115445 60.64639716938625,8.593738860820423 60.6420622441684)))"
21550006740000,593,300,293,45.1,"MULTIPOLYGON(((8.684600745115445 60.64639716938625,8.675820393588635 60.6910160203146,8.766834706330199 60.695297202438866,8.775490706676385 60.65067058908287,8.684600745115445 60.64639716938625)))"
21600006740000,175,99,76,46.6,"MULTIPOLYGON(((8.775490706676385 60.65067058908287,8.766834706330199 60.695297202438866,8.85787683224151 60.69951673194367,8.866408356177976 60.65488246592814,8.775490706676385 60.65067058908287)))"
21650006740000,1530,777,753,42,"MULTIPOLYGON(((8.866408356177976 60.65488246592814,8.85787683224151 60.69951673194367,8.948946379531572 60.70367457186191,8.957353303540756 60.659032763108954,8.866408356177976 60.65488246592814)))"
21700006740000,1209,592,617,45.6,"MULTIPOLYGON(((8.957353303540756 60.659032763108954,8.948946379531572 60.70367457186191,9.040042955659487 60.707770685746674,9.04832515794098 60.66312144433038,8.957353303540756 60.659032763108954)))"
21750006740000,12,7,5,42.5,"MULTIPOLYGON(((9.04832515794098 60.66312144433038,9.040042955659487 60.707770685746674,9.131166167344507 60.711805037672576,9.139323527820592 60.667148473816795,9.04832515794098 60.66312144433038)))"
21800006740000,2,2,0,0,"MULTIPOLYGON(((9.139323527820592 60.667148473816795,9.131166167344507 60.711805037672576,9.22231562057611 60.71577759223683,9.230348020897248 60.67111381631317,9.139323527820592 60.667148473816795)))"
22100006740000,88,48,40,41.7,"MULTIPOLYGON(((9.685848554925306 60.69001402660047,9.678442669762566 60.734712202267104,9.769741258469342 60.738313258616266,9.777021509968478 60.69360853609494,9.685848554925306 60.69001402660047)))"
22350006740000,3,3,0,0,"MULTIPOLYGON(((10.141942927805502 60.70736707517294,10.135166254297838 60.75209687035587,10.226578161378402 60.755387467970266,10.233228688435949 60.710651683948036,10.141942927805502 60.70736707517294)))"
22400006740000,273,144,129,46.7,"MULTIPOLYGON(((10.233228688435949 60.710651683948036,10.226578161378402 60.755387467970266,10.318011528695392 60.75861588456424,10.32453581209103 60.71387422368021,10.233228688435949 60.710651683948036)))"
22450006740000,242,121,121,46.8,"MULTIPOLYGON(((10.32453581209103 60.71387422368021,10.318011528695392 60.75861588456424,10.409465953691031 60.76178209162961,10.415863898005467 60.717034665980954,10.32453581209103 60.71387422368021)))"
22550006740000,272,145,127,46.1,"MULTIPOLYGON(((10.507212544834752 60.72013298299705,10.500941033223913 60.76488606119563,10.592436363579782 60.767927765829995,10.598581350665865 60.72316914741145,10.507212544834752 60.72013298299705)))"
22600006740000,4903,2559,2344,40.7,"MULTIPOLYGON(((10.598581350665865 60.72316914741145,10.592436363579782 60.767927765829995,10.68395154048233 60.77090717863968,10.68996991302797 60.72614313244418,10.598581350665865 60.72316914741145)))"
22650006740000,2416,1216,1200,40.8,"MULTIPOLYGON(((10.68996991302797 60.72614313244418,10.68395154048233 60.77090717863968,10.775486159104023 60.773824273271956,10.78137782890319 60.72905491185334,10.68996991302797 60.72614313244418)))"
22700006740000,202,105,97,44.3,"MULTIPOLYGON(((10.78137782890319 60.72905491185334,10.775486159104023 60.773824273271956,10.867039814076998 60.77667902391517,10.872804694737408 60.73190445993581,10.78137782890319 60.72905491185334)))"
22750006740000,822,427,395,44.9,"MULTIPOLYGON(((10.872804694737408 60.73190445993581,10.867039814076998 60.77667902391517,10.958612099503984 60.77947140529964,10.964250106451093 60.7346917515283,10.872804694737408 60.73190445993581)))"
22800006740000,156,88,68,46.1,"MULTIPOLYGON(((10.964250106451093 60.7346917515283,10.958612099503984 60.77947140529964,11.050202608969231 60.78220139269847,11.055713659450179 60.73741676200804,10.964250106451093 60.7346917515283)))"
22850006740000,6918,3405,3513,41.1,"MULTIPOLYGON(((11.055713659450179 60.73741676200804,11.050202608969231 60.78220139269847,11.141810935549527 60.78486896192843,11.147194948636976 60.74007946729364,11.055713659450179 60.73741676200804)))"
22900006740000,1934,1026,908,39.7,"MULTIPOLYGON(((11.147194948636976 60.74007946729364,11.141810935549527 60.78486896192843,11.233436671825206 60.787474089350795,11.2386935684211 60.74267984384592,11.147194948636976 60.74007946729364)))"
22950006740000,1265,637,628,42.4,"MULTIPOLYGON(((11.2386935684211 60.74267984384592,11.233436671825206 60.787474089350795,11.325079409891217 60.790016751872045,11.33020911273047 60.74521786866874,11.2386935684211 60.74267984384592)))"
23000006740000,520,267,253,41.2,"MULTIPOLYGON(((11.33020911273047 60.74521786866874,11.325079409891217 60.790016751872045,11.416738741368208 60.79249692694468,11.421741175022307 60.74769351930959,11.33020911273047 60.74521786866874)))"
23050006740000,89,44,45,44.3,"MULTIPOLYGON(((11.421741175022307 60.74769351930959,11.416738741368208 60.79249692694468,11.508414257413662 60.794914592567984,11.513289348294167 60.75010677386063,11.421741175022307 60.74769351930959)))"
23100006740000,50,26,24,38.2,"MULTIPOLYGON(((11.513289348294167 60.75010677386063,11.508414257413662 60.794914592567984,11.600105548733048 60.797269727288814,11.60485322509504 60.75245761095914,11.513289348294167 60.75010677386063)))"
23150006740000,21,11,10,32,"MULTIPOLYGON(((11.60485322509504 60.75245761095914,11.600105548733048 60.797269727288814,11.691812205591017 60.799562310202205,11.69643239753644 60.75474600978843,11.60485322509504 60.75245761095914)))"
23200006740000,135,76,59,40.4,"MULTIPOLYGON(((11.69643239753644 60.75474600978843,11.691812205591017 60.799562310202205,11.783533817822619 60.801792320952174,11.788026457303543 60.75697195007838,11.69643239753644 60.75474600978843)))"
23250006740000,1,0,1,0,"MULTIPOLYGON(((11.788026457303543 60.75697195007838,11.783533817822619 60.801792320952174,11.875269974844556 60.80395973973238,11.879634995666358 60.75913541210634,11.788026457303543 60.75697195007838)))"
19450006745000,1834,924,910,37.4,"MULTIPOLYGON(((4.883398520705453 60.45609935800454,4.869486422700731 60.50029319770537,4.959108128627857 60.50713595764567,4.972902245473913 60.46292987784568,4.883398520705453 60.45609935800454)))"
19500006745000,124,58,66,41.6,"MULTIPOLYGON(((4.972902245473913 60.46292987784568,4.959108128627857 60.50713595764567,5.048773493391533 60.513918967480684,5.062449436773037 60.469700749371114,4.972902245473913 60.46292987784568)))"
19550006745000,1349,688,661,38.5,"MULTIPOLYGON(((5.062449436773037 60.469700749371114,5.048773493391533 60.513918967480684,5.138482163588393 60.520642169436805,5.152039742625521 60.476411915041126,5.062449436773037 60.469700749371114)))"
19600006745000,3025,1535,1490,35.3,"MULTIPOLYGON(((5.152039742625521 60.476411915041126,5.138482163588393 60.520642169436805,5.228233784687807 60.52730550619897,5.241672809934991 60.483063317772874,5.152039742625521 60.476411915041126)))"
19650006745000,6821,3478,3343,40.2,"MULTIPOLYGON(((5.241672809934991 60.483063317772874,5.228233784687807 60.52730550619897,5.318028001039429 60.53390892091242,5.331348284493441 60.489654900942135,5.241672809934991 60.483063317772874)))"
19700006745000,2306,1212,1094,38.3,"MULTIPOLYGON(((5.331348284493441 60.489654900942135,5.318028001039429 60.53390892091242,5.407864455880759 60.540452357184506,5.421065810988788 60.4961866083852,5.331348284493441 60.489654900942135)))"
19750006745000,2808,1402,1406,38.9,"MULTIPOLYGON(((5.421065810988788 60.4961866083852,5.407864455880759 60.540452357184506,5.497742791344809 60.5469357590864,5.510825033012468 60.50265838440048,5.421065810988788 60.4961866083852)))"
19800006745000,1019,518,501,40.4,"MULTIPOLYGON(((5.510825033012468 60.50265838440048,5.497742791344809 60.5469357590864,5.58766264846782 60.55335907115495,5.600625593067129 60.50907017375028,5.510825033012468 60.50265838440048)))"
19850006745000,19,12,7,44.4,"MULTIPOLYGON(((5.600625593067129 60.50907017375028,5.58766264846782 60.55335907115495,5.677623667197045 60.55972223839429,5.690467132574352 60.515421921662536,5.600625593067129 60.50907017375028)))"
19900006745000,811,407,404,41.3,"MULTIPOLYGON(((5.690467132574352 60.515421921662536,5.677623667197045 60.55972223839429,5.76762548639863 60.566025206277665,5.780349291882475 60.52171357383259,5.690467132574352 60.515421921662536)))"
20000006745000,16,10,6,59,"MULTIPOLYGON(((5.870271710274489 60.52794507642478,5.85766774386554 60.57226792074911,5.947750076325544 60.57845032822509,5.960234025975936 60.53411637607421,5.870271710274489 60.52794507642478)))"
20050006745000,23,12,11,62,"MULTIPOLYGON(((5.960234025975936 60.53411637607421,5.947750076325544 60.57845032822509,6.037872119449292 60.5845723755963,6.05023587616299 60.54022741988844,5.960234025975936 60.53411637607421)))"
20100006745000,7,2,5,38.7,"MULTIPOLYGON(((6.05023587616299 60.54022741988844,6.037872119449292 60.5845723755963,6.128033507858446 60.59063401022936,6.140276896970493 60.54627815544905,6.05023587616299 60.54022741988844)))"
20250006745000,32,16,16,48.5,"MULTIPOLYGON(((6.320474989828602 60.55819849451638,6.308472853824009 60.6025758331364,6.398750075452971 60.60845591853775,6.410631329015985 60.56406799557161,6.320474989828602 60.55819849451638)))"
20300006745000,371,196,175,37.1,"MULTIPOLYGON(((6.410631329015985 60.56406799557161,6.398750075452971 60.60845591853775,6.489065170529201 60.61427538545887,6.500825373113997 60.56987698347356,6.410631329015985 60.56406799557161)))"
20350006745000,877,452,425,36.5,"MULTIPOLYGON(((6.500825373113997 60.56987698347356,6.489065170529201 60.61427538545887,6.579417768553784 60.62003418367037,6.591056753174455 60.57562540819889,6.500825373113997 60.56987698347356)))"
20400006745000,107,57,50,40.6,"MULTIPOLYGON(((6.591056753174455 60.57562540819889,6.579417768553784 60.62003418367037,6.669807498029058 60.625732263428525,6.681325099257743 60.58131322020805,6.591056753174455 60.57562540819889)))"
20450006745000,2,1,1,0,"MULTIPOLYGON(((6.681325099257743 60.58131322020805,6.669807498029058 60.625732263428525,6.760233986467156 60.63136957547685,6.771630040441339 60.586940370446946,6.681325099257743 60.58131322020805)))"
20500006745000,1,0,1,0,"MULTIPOLYGON(((6.771630040441339 60.586940370446946,6.760233986467156 60.63136957547685,6.850696860398706 60.63694607104768,6.861971204828433 60.59250681034843,6.771630040441339 60.586940370446946)))"
21150006745000,10,3,7,46,"MULTIPOLYGON(((7.948753925359736 60.654551675786806,7.938952172057276 60.6991032551961,8.02985364125393 60.703884923904056,8.039531721526531 60.65932468602632,7.948753925359736 60.654551675786806)))"
21300006745000,188,84,104,37.7,"MULTIPOLYGON(((8.22117968636536 60.668686650515326,8.211749369125027 60.713263878920934,8.302742852744238 60.71786108323086,8.312049083335713 60.67327552310652,8.22117968636536 60.668686650515326)))"
21350006745000,119,59,60,47.7,"MULTIPOLYGON(((8.312049083335713 60.67327552310652,8.302742852744238 60.71786108323086,8.393766231401173 60.72239671826405,8.402948240834647 60.67780293567481,8.312049083335713 60.67327552310652)))"
21400006745000,208,102,106,41.8,"MULTIPOLYGON(((8.402948240834647 60.67780293567481,8.393766231401173 60.72239671826405,8.484819115510943 60.72687074430533,8.493876770969408 60.68226884867028,8.402948240834647 60.67780293567481)))"
21450006745000,124,68,56,41,"MULTIPOLYGON(((8.493876770969408 60.68226884867028,8.484819115510943 60.72687074430533,8.575901114683337 60.73128312215561,8.584834285047936 60.686673223057085,8.493876770969408 60.68226884867028)))"
21600006745000,1,0,1,0,"MULTIPOLYGON(((8.766834706330199 60.695297202438866,8.758150892687617 60.73992277907493,8.849317886801318 60.74414998233778,8.85787683224151 60.69951673194367,8.766834706330199 60.695297202438866)))"
21650006745000,1020,505,515,42.6,"MULTIPOLYGON(((8.85787683224151 60.69951673194367,8.849317886801318 60.74414998233778,8.940512426561225 60.74831538579962,8.948946379531572 60.70367457186191,8.85787683224151 60.69951673194367)))"
21700006745000,440,217,223,44.2,"MULTIPOLYGON(((8.948946379531572 60.70367457186191,8.940512426561225 60.74831538579962,9.031734117699266 60.75241895286078,9.040042955659487 60.707770685746674,8.948946379531572 60.70367457186191)))"
21900006745000,2,2,0,0,"MULTIPOLYGON(((9.313490920624153 60.71968831456047,9.305558145580568 60.76435827750402,9.396884484793997 60.76821414345474,9.404691672049044 60.72353717028954,9.313490920624153 60.71968831456047)))"
21950006745000,4,3,1,0,"MULTIPOLYGON(((9.404691672049044 60.72353717028954,9.396884484793997 60.76821414345474,9.488235993067367 60.77200799788343,9.495917478711991 60.72732412559606,9.404691672049044 60.72353717028954)))"
22050006745000,115,62,53,42.7,"MULTIPOLYGON(((9.587167943785268 60.731049147179384,9.579612271813307 60.775739807349346,9.671012921760708 60.7794095389422,9.678442669762566 60.734712202267104,9.587167943785268 60.731049147179384)))"
22100006745000,25,14,11,47.8,"MULTIPOLYGON(((9.678442669762566 60.734712202267104,9.671012921760708 60.7794095389422,9.762437542965163 60.78301716028327,9.769741258469342 60.738313258616266,9.678442669762566 60.734712202267104)))"
22300006745000,42,22,20,36.7,"MULTIPOLYGON(((10.04377620941713 60.74874412076581,10.036851224798259 60.793467047004455,10.128367718489475 60.79682591421972,10.135166254297838 60.75209687035587,10.04377620941713 60.74874412076581)))"
22350006745000,253,131,122,45.8,"MULTIPOLYGON(((10.135166254297838 60.75209687035587,10.128367718489475 60.79682591421972,10.219906173985374 60.8001225173001,10.226578161378402 60.755387467970266,10.135166254297838 60.75209687035587)))"
22400006745000,561,276,285,43.6,"MULTIPOLYGON(((10.226578161378402 60.755387467970266,10.219906173985374 60.8001225173001,10.31146618752384 60.80335682707824,10.318011528695392 60.75861588456424,10.226578161378402 60.755387467970266)))"
22450006745000,101,57,44,40.3,"MULTIPOLYGON(((10.318011528695392 60.75861588456424,10.31146618752384 60.80335682707824,10.40304735474387 60.80652881492556,10.409465953691031 60.76178209162961,10.318011528695392 60.75861588456424)))"
22500006745000,48,25,23,39.9,"MULTIPOLYGON(((10.409465953691031 60.76178209162961,10.40304735474387 60.80652881492556,10.494649270696408 60.80963845275314,10.500941033223913 60.76488606119563,10.409465953691031 60.76178209162961)))"
22550006745000,978,510,468,39.9,"MULTIPOLYGON(((10.500941033223913 60.76488606119563,10.494649270696408 60.80963845275314,10.58627152985516 60.812685713012705,10.592436363579782 60.767927765829995,10.500941033223913 60.76488606119563)))"
22600006745000,10324,5190,5134,40.9,"MULTIPOLYGON(((10.592436363579782 60.767927765829995,10.58627152985516 60.812685713012705,10.677913726127487 60.81567056869758,10.68395154048233 60.77090717863968,10.592436363579782 60.767927765829995)))"
22650006745000,8576,4198,4378,44.6,"MULTIPOLYGON(((10.68395154048233 60.77090717863968,10.677913726127487 60.81567056869758,10.76957545286533 60.8185929933435,10.775486159104023 60.773824273271956,10.68395154048233 60.77090717863968)))"
22700006745000,950,495,455,42,"MULTIPOLYGON(((10.775486159104023 60.773824273271956,10.76957545286533 60.8185929933435,10.861256302876175 60.82145296102957,10.867039814076998 60.77667902391517,10.775486159104023 60.773824273271956)))"
22750006745000,929,491,438,40.7,"MULTIPOLYGON(((10.867039814076998 60.77667902391517,10.861256302876175 60.82145296102957,10.95295586843403 60.82425044637919,10.958612099503984 60.77947140529964,10.867039814076998 60.77667902391517)))"
22800006745000,6949,3227,3722,46.8,"MULTIPOLYGON(((10.958612099503984 60.77947140529964,10.95295586843403 60.82425044637919,11.044673741290495 60.82698542456071,11.050202608969231 60.78220139269847,10.958612099503984 60.77947140529964)))"
22850006745000,21085,10434,10651,42.6,"MULTIPOLYGON(((11.050202608969231 60.78220139269847,11.044673741290495 60.82698542456071,11.1364095126858 60.82965787128849,11.141810935549527 60.78486896192843,11.050202608969231 60.78220139269847)))"
22900006745000,3275,1657,1618,39.3,"MULTIPOLYGON(((11.141810935549527 60.78486896192843,11.1364095126858 60.82965787128849,11.228162773359935 60.83226776282359,11.233436671825206 60.787474089350795,11.141810935549527 60.78486896192843)))"
22950006745000,1658,841,817,41.5,"MULTIPOLYGON(((11.233436671825206 60.787474089350795,11.228162773359935 60.83226776282359,11.319933113563788 60.834815075974575,11.325079409891217 60.790016751872045,11.233436671825206 60.787474089350795)))"
23000006745000,3703,1825,1878,43.9,"MULTIPOLYGON(((11.325079409891217 60.790016751872045,11.319933113563788 60.834815075974575,11.411720123070314 60.83729978809835,11.416738741368208 60.79249692694468,11.325079409891217 60.790016751872045)))"
23050006745000,85,48,37,49.6,"MULTIPOLYGON(((11.416738741368208 60.79249692694468,11.411720123070314 60.83729978809835,11.503523391185754 60.839721877100885,11.508414257413662 60.794914592567984,11.416738741368208 60.79249692694468)))"
23100006745000,82,43,39,43.8,"MULTIPOLYGON(((11.508414257413662 60.794914592567984,11.503523391185754 60.839721877100885,11.595342506760874 60.84208132143794,11.600105548733048 60.797269727288814,11.508414257413662 60.794914592567984)))"
23150006745000,1205,625,580,42.1,"MULTIPOLYGON(((11.600105548733048 60.797269727288814,11.595342506760874 60.84208132143794,11.687177058202236 60.84437810011586,11.691812205591017 60.799562310202205,11.600105548733048 60.797269727288814)))"
23200006745000,480,252,228,41.1,"MULTIPOLYGON(((11.691812205591017 60.799562310202205,11.687177058202236 60.84437810011586,11.779026633483518 60.84661219269222,11.783533817822619 60.801792320952174,11.691812205591017 60.799562310202205)))"
23350006745000,3,2,1,0,"MULTIPOLYGON(((11.96702026566646 60.80606454728677,11.96276920536409 60.85089224053096,12.05466137584843 60.852938157670906,12.058784278902209 60.80810672491024,11.96702026566646 60.80606454728677)))"
23400006745000,18,10,8,61.1,"MULTIPOLYGON(((12.058784278902209 60.80810672491024,12.05466137584843 60.852938157670906,12.146566917965593 60.85492131246567,12.150561602781247 60.81008625444932,12.058784278902209 60.80810672491024)))"
23500006745000,5,3,2,64.2,"MULTIPOLYGON(((12.242351825159965 60.81200311830264,12.238485417695403 60.85684168723908,12.330416460653232 60.85869926487015,12.334154533533084 60.81385729942172,12.242351825159965 60.81200311830264)))"
19450006750000,1380,694,686,41.8,"MULTIPOLYGON(((4.869486422700731 60.50029319770537,4.855530313400405 60.544484822941115,4.945270352756119 60.551339855802524,4.959108128627857 60.50713595764567,4.869486422700731 60.50029319770537)))"
19500006750000,803,422,381,41,"MULTIPOLYGON(((4.959108128627857 60.50713595764567,4.945270352756119 60.551339855802524,5.035054244388974 60.55813503652372,5.048773493391533 60.513918967480684,4.959108128627857 60.50713595764567)))"
19550006750000,944,469,475,39.8,"MULTIPOLYGON(((5.048773493391533 60.513918967480684,5.035054244388974 60.55813503652372,5.124881633462072 60.56487030709591,5.138482163588393 60.520642169436805,5.048773493391533 60.513918967480684)))"
19600006750000,2202,1138,1064,36.1,"MULTIPOLYGON(((5.138482163588393 60.520642169436805,5.124881633462072 60.56487030709591,5.214752164003046 60.57154560997046,5.228233784687807 60.52730550619897,5.138482163588393 60.520642169436805)))"
19650006750000,6551,3188,3363,41.5,"MULTIPOLYGON(((5.228233784687807 60.52730550619897,5.214752164003046 60.57154560997046,5.304665478911612 60.578160888060765,5.318028001039429 60.53390892091242,5.228233784687807 60.52730550619897)))"
19700006750000,1322,669,653,37.6,"MULTIPOLYGON(((5.318028001039429 60.53390892091242,5.304665478911612 60.578160888060765,5.394621219967209 60.58471608474398,5.407864455880759 60.540452357184506,5.318028001039429 60.53390892091242)))"
19750006750000,818,432,386,41,"MULTIPOLYGON(((5.407864455880759 60.540452357184506,5.394621219967209 60.58471608474398,5.484619027836687 60.59121114386283,5.497742791344809 60.5469357590864,5.407864455880759 60.540452357184506)))"
19800006750000,312,162,150,43.4,"MULTIPOLYGON(((5.497742791344809 60.5469357590864,5.484619027836687 60.59121114386283,5.574658542082093 60.59764600972732,5.58766264846782 60.55335907115495,5.497742791344809 60.5469357590864)))"
19900006750000,8,4,4,47.6,"MULTIPOLYGON(((5.677623667197045 60.55972223839429,5.664739401168499 60.60402062711657,5.754861242471926 60.61033494128047,5.76762548639863 60.566025206277665,5.677623667197045 60.55972223839429)))"
19950006750000,1165,561,604,43.2,"MULTIPOLYGON(((5.76762548639863 60.566025206277665,5.754861242471926 60.61033494128047,5.845023702287309 60.61658889794144,5.85766774386554 60.57226792074911,5.76762548639863 60.566025206277665)))"
20000006750000,7,4,3,60.3,"MULTIPOLYGON(((5.85766774386554 60.57226792074911,5.845023702287309 60.61658889794144,5.935226415836566 60.62278244329616,5.947750076325544 60.57845032822509,5.85766774386554 60.57226792074911)))"
20050006750000,1,1,0,0,"MULTIPOLYGON(((5.947750076325544 60.57845032822509,5.935226415836566 60.62278244329616,6.025469017276707 60.62891552401728,6.037872119449292 60.5845723755963,5.947750076325544 60.57845032822509)))"
20150006750000,101,53,48,42.4,"MULTIPOLYGON(((6.128033507858446 60.59063401022936,6.115751139708013 60.63498808725503,6.206072415182308 60.641000080639024,6.218233875133899 60.5966351799683,6.128033507858446 60.59063401022936)))"
20200006750000,444,221,223,37.5,"MULTIPOLYGON(((6.218233875133899 60.5966351799683,6.206072415182308 60.641000080639024,6.296432474711264 60.64695145227981,6.308472853824009 60.6025758331364,6.218233875133899 60.5966351799683)))"
20250006750000,908,459,449,41.5,"MULTIPOLYGON(((6.308472853824009 60.6025758331364,6.296432474711264 60.64695145227981,6.386830948274806 60.65284215077063,6.398750075452971 60.60845591853775,6.308472853824009 60.6025758331364)))"
20300006750000,7287,3462,3825,43.9,"MULTIPOLYGON(((6.398750075452971 60.60845591853775,6.386830948274806 60.65284215077063,6.477267464829567 60.65867212518889,6.489065170529201 60.61427538545887,6.398750075452971 60.60845591853775)))"
20350006750000,878,461,417,39.4,"MULTIPOLYGON(((6.489065170529201 60.61427538545887,6.477267464829567 60.65867212518889,6.567741652317388 60.664441325098025,6.579417768553784 60.62003418367037,6.489065170529201 60.61427538545887)))"
20500006750000,5,4,1,59,"MULTIPOLYGON(((6.760233986467156 60.63136957547685,6.748801546837387 60.67579720208154,6.839386504757027 60.68138378072661,6.850696860398706 60.63694607104768,6.760233986467156 60.63136957547685)))"
21100006750000,1,0,1,0,"MULTIPOLYGON(((7.848082147989505 60.69426018120662,7.838125032188122 60.738801725869365,7.929118973483641 60.74365359097867,7.938952172057276 60.6991032551961,7.848082147989505 60.69426018120662)))"
21550006750000,4,2,2,0,"MULTIPOLYGON(((8.667011837732653 60.73563381313316,8.658174949841754 60.780250544648446,8.74943913975869 60.78454731589526,8.758150892687617 60.73992277907493,8.667011837732653 60.73563381313316)))"
21600006750000,111,60,51,46,"MULTIPOLYGON(((8.758150892687617 60.73992277907493,8.74943913975869 60.78454731589526,8.840731395588975 60.78878221411099,8.849317886801318 60.74414998233778,8.758150892687617 60.73992277907493)))"
21650006750000,143,81,62,44.3,"MULTIPOLYGON(((8.849317886801318 60.74414998233778,8.840731395588975 60.78878221411099,8.932051322088506 60.79295520201773,8.940512426561225 60.74831538579962,8.849317886801318 60.74414998233778)))"
21700006750000,10,5,5,52.1,"MULTIPOLYGON(((8.940512426561225 60.74831538579962,8.932051322088506 60.79295520201773,9.023398523251895 60.79706624286213,9.031734117699266 60.75241895286078,8.940512426561225 60.74831538579962)))"
21750006750000,17,10,7,49.6,"MULTIPOLYGON(((9.031734117699266 60.75241895286078,9.023398523251895 60.79706624286213,9.114772602322658 60.801115300416484,9.122982565201895 60.75646064744516,9.031734117699266 60.75241895286078)))"
21800006750000,7,3,4,49.7,"MULTIPOLYGON(((9.122982565201895 60.75646064744516,9.114772602322658 60.801115300416484,9.206173161803465 60.805102338979985,9.214257373320295 60.76044043400139,9.122982565201895 60.75646064744516)))"
22000006750000,345,179,166,42.9,"MULTIPOLYGON(((9.488235993067367 60.77200799788343,9.480529736836209 60.8166909916451,9.572032228527668 60.820429607815676,9.579612271813307 60.775739807349346,9.488235993067367 60.77200799788343)))"
22050006750000,205,105,100,45.5,"MULTIPOLYGON(((9.579612271813307 60.775739807349346,9.572032228527668 60.820429607815676,9.663559202391326 60.82410603443535,9.671012921760708 60.7794095389422,9.579612271813307 60.775739807349346)))"
22100006750000,85,50,35,48.1,"MULTIPOLYGON(((9.671012921760708 60.7794095389422,9.663559202391326 60.82410603443535,9.755110256702412 60.82772023898889,9.762437542965163 60.78301716028327,9.671012921760708 60.7794095389422)))"
22150006750000,32,18,14,59.6,"MULTIPOLYGON(((9.762437542965163 60.78301716028327,9.755110256702412 60.82772023898889,9.846684989068327 60.831272189495834,9.853885734819483 60.78656263952646,9.762437542965163 60.78301716028327)))"
22200006750000,52,34,18,32.2,"MULTIPOLYGON(((9.853885734819483 60.78656263952646,9.846684989068327 60.831272189495834,9.938282996439252 60.83476185451164,9.945357096064216 60.79004594535942,9.853885734819483 60.78656263952646)))"
22250006750000,101,48,53,48.2,"MULTIPOLYGON(((9.945357096064216 60.79004594535942,9.938282996439252 60.83476185451164,10.02990387511881 60.83818920312871,10.036851224798259 60.793467047004455,9.945357096064216 60.79004594535942)))"
22300006750000,2571,1265,1306,44.1,"MULTIPOLYGON(((10.036851224798259 60.793467047004455,10.02990387511881 60.83818920312871,10.121547220774811 60.84155420497736,10.128367718489475 60.79682591421972,10.036851224798259 60.793467047004455)))"
22350006750000,534,279,255,40.9,"MULTIPOLYGON(((10.128367718489475 60.79682591421972,10.121547220774811 60.84155420497736,10.213212628449964 60.844856830226966,10.219906173985374 60.8001225173001,10.128367718489475 60.79682591421972)))"
22400006750000,292,142,150,41.9,"MULTIPOLYGON(((10.219906173985374 60.8001225173001,10.213212628449964 60.844856830226966,10.304899692572697 60.84809704958687,10.31146618752384 60.80335682707824,10.219906173985374 60.8001225173001)))"
22450006750000,107,61,46,44.4,"MULTIPOLYGON(((10.31146618752384 60.80335682707824,10.304899692572697 60.84809704958687,10.396608006968 60.85127483430731,10.40304735474387 60.80652881492556,10.31146618752384 60.80335682707824)))"
22500006750000,205,112,93,45.5,"MULTIPOLYGON(((10.40304735474387 60.80652881492556,10.396608006968 60.85127483430731,10.4883371648683 60.854390156180564,10.494649270696408 60.80963845275314,10.40304735474387 60.80652881492556)))"
22550006750000,414,213,201,43.8,"MULTIPOLYGON(((10.494649270696408 60.80963845275314,10.4883371648683 60.854390156180564,10.580086758924386 60.857442987541674,10.58627152985516 60.812685713012705,10.494649270696408 60.80963845275314)))"
22600006750000,899,462,437,37.4,"MULTIPOLYGON(((10.58627152985516 60.812685713012705,10.580086758924386 60.857442987541674,10.671856381216381 60.86043330126963,10.677913726127487 60.81567056869758,10.58627152985516 60.812685713012705)))"
22650006750000,302,166,136,36.2,"MULTIPOLYGON(((10.677913726127487 60.81567056869758,10.671856381216381 60.86043330126963,10.763645623264729 60.863361070788,10.76957545286533 60.8185929933435,10.677913726127487 60.81567056869758)))"
22700006750000,499,260,239,43.8,"MULTIPOLYGON(((10.76957545286533 60.8185929933435,10.763645623264729 60.863361070788,10.855454076041257 60.86622627006606,10.861256302876175 60.82145296102957,10.76957545286533 60.8185929933435)))"
22750006750000,433,225,208,43.1,"MULTIPOLYGON(((10.861256302876175 60.82145296102957,10.855454076041257 60.86622627006606,10.947281329980244 60.86902887361951,10.95295586843403 60.82425044637919,10.861256302876175 60.82145296102957)))"
22800006750000,2164,1117,1047,40.9,"MULTIPOLYGON(((10.95295586843403 60.82425044637919,10.947281329980244 60.86902887361951,11.039126974989538 60.871768856511466,11.044673741290495 60.82698542456071,10.95295586843403 60.82425044637919)))"
22850006750000,1830,938,892,38.3,"MULTIPOLYGON(((11.044673741290495 60.82698542456071,11.039126974989538 60.871768856511466,11.130990600461718 60.874446194353176,11.1364095126858 60.82965787128849,11.044673741290495 60.82698542456071)))"
22900006750000,1456,724,732,41,"MULTIPOLYGON(((11.1364095126858 60.82965787128849,11.130990600461718 60.874446194353176,11.22287179528529 60.87706086330493,11.228162773359935 60.83226776282359,11.1364095126858 60.82965787128849)))"
22950006750000,705,363,342,39.9,"MULTIPOLYGON(((11.228162773359935 60.83226776282359,11.22287179528529 60.87706086330493,11.314770147855896 60.87961284007687,11.319933113563788 60.834815075974575,11.228162773359935 60.83226776282359)))"
23000006750000,921,486,435,42.9,"MULTIPOLYGON(((11.319933113563788 60.834815075974575,11.314770147855896 60.87961284007687,11.40668524608759 60.88210210192961,11.411720123070314 60.83729978809835,11.319933113563788 60.834815075974575)))"
23050006750000,59,34,25,43.7,"MULTIPOLYGON(((11.411720123070314 60.83729978809835,11.40668524608759 60.88210210192961,11.49861667742413 60.8845286266753,11.503523391185754 60.839721877100885,11.411720123070314 60.83729978809835)))"
23100006750000,8094,3795,4299,43.7,"MULTIPOLYGON(((11.503523391185754 60.839721877100885,11.49861667742413 60.8845286266753,11.590564028850299 60.88689239267814,11.595342506760874 60.84208132143794,11.503523391185754 60.839721877100885)))"
23150006750000,46,27,19,47.9,"MULTIPOLYGON(((11.595342506760874 60.84208132143794,11.590564028850299 60.88689239267814,11.682526886903277 60.88919337885515,11.687177058202236 60.84437810011586,11.595342506760874 60.84208132143794)))"
23200006750000,8,4,4,54.9,"MULTIPOLYGON(((11.687177058202236 60.84437810011586,11.682526886903277 60.88919337885515,11.774504837684015 60.89143156467703,11.779026633483518 60.84661219269222,11.687177058202236 60.84437810011586)))"
23250006750000,14,8,6,28.4,"MULTIPOLYGON(((11.779026633483518 60.84661219269222,11.774504837684015 60.89143156467703,11.86649746686868 60.893606930168595,11.870890820156829 60.84878357927654,11.779026633483518 60.84661219269222)))"
23350006750000,25,12,13,51.9,"MULTIPOLYGON(((11.96276920536409 60.85089224053096,11.958504359720079 60.89571945590976,12.050525101099169 60.89776912303593,12.05466137584843 60.852938157670906,11.96276920536409 60.85089224053096)))"
23400006750000,7,5,2,59.9,"MULTIPOLYGON(((12.05466137584843 60.852938157670906,12.050525101099169 60.89776912303593,12.142559275476547 60.899755913238785,12.146566917965593 60.85492131246567,12.05466137584843 60.852938157670906)))"
23450006750000,17,9,8,59.3,"MULTIPOLYGON(((12.146566917965593 60.85492131246567,12.142559275476547 60.899755913238785,12.234606466943992 60.9016798087669,12.238485417695403 60.85684168723908,12.146566917965593 60.85492131246567)))"
23500006750000,23,13,10,60.9,"MULTIPOLYGON(((12.238485417695403 60.85684168723908,12.234606466943992 60.9016798087669,12.32666625922603 60.90354079242628,12.330416460653232 60.85869926487015,12.238485417695403 60.85684168723908)))"
19400006755000,224,129,95,42.7,"MULTIPOLYGON(((4.765834480015769 60.53756999640668,4.751715673445103 60.581746990855486,4.841529997937278 60.58867422532081,4.855530313400405 60.544484822941115,4.765834480015769 60.53756999640668)))"
19450006755000,417,201,216,39.1,"MULTIPOLYGON(((4.855530313400405 60.544484822941115,4.841529997937278 60.58867422532081,4.931388724416755 60.59554156407005,4.945270352756119 60.551339855802524,4.855530313400405 60.544484822941115)))"
19500006755000,559,295,264,45.5,"MULTIPOLYGON(((4.945270352756119 60.551339855802524,4.931388724416755 60.59554156407005,5.021291497756932 60.602348948397854,5.035054244388974 60.55813503652372,4.945270352756119 60.551339855802524)))"
19550006755000,443,228,215,42.7,"MULTIPOLYGON(((5.035054244388974 60.55813503652372,5.021291497756932 60.602348948397854,5.1112379616799 60.609096320058924,5.124881633462072 60.56487030709591,5.035054244388974 60.55813503652372)))"
19600006755000,622,331,291,43.4,"MULTIPOLYGON(((5.124881633462072 60.56487030709591,5.1112379616799 60.609096320058924,5.201227758763987 60.615783621269784,5.214752164003046 60.57154560997046,5.124881633462072 60.56487030709591)))"
19650006755000,1802,931,871,38.9,"MULTIPOLYGON(((5.214752164003046 60.57154560997046,5.201227758763987 60.615783621269784,5.291260530451344 60.62241079471064,5.304665478911612 60.578160888060765,5.214752164003046 60.57154560997046)))"
19700006755000,714,368,346,36,"MULTIPOLYGON(((5.304665478911612 60.578160888060765,5.291260530451344 60.62241079471064,5.381335917055649 60.62897778352716,5.394621219967209 60.58471608474398,5.304665478911612 60.578160888060765)))"
19750006755000,837,436,401,42.3,"MULTIPOLYGON(((5.394621219967209 60.58471608474398,5.381335917055649 60.62897778352716,5.471453557769819 60.635484531332295,5.484619027836687 60.59121114386283,5.394621219967209 60.58471608474398)))"
19800006755000,661,343,318,43.8,"MULTIPOLYGON(((5.484619027836687 60.59121114386283,5.471453557769819 60.635484531332295,5.561613090673864 60.641930982207995,5.574658542082093 60.59764600972732,5.484619027836687 60.59121114386283)))"
19850006755000,119,59,60,49.6,"MULTIPOLYGON(((5.574658542082093 60.59764600972732,5.561613090673864 60.641930982207995,5.651814152742763 60.648317080707024,5.664739401168499 60.60402062711657,5.574658542082093 60.59764600972732)))"
19900006755000,3,2,1,0,"MULTIPOLYGON(((5.664739401168499 60.60402062711657,5.651814152742763 60.648317080707024,5.742056379854424 60.65464277185468,5.754861242471926 60.61033494128047,5.664739401168499 60.60402062711657)))"
19950006755000,64,37,27,47.9,"MULTIPOLYGON(((5.754861242471926 60.61033494128047,5.742056379854424 60.65464277185468,5.832339406797722 60.66090800115055,5.845023702287309 60.61658889794144,5.754861242471926 60.61033494128047)))"
20000006755000,4,2,2,0,"MULTIPOLYGON(((5.845023702287309 60.61658889794144,5.832339406797722 60.66090800115055,5.922662867280597 60.667112714570244,5.935226415836566 60.62278244329616,5.845023702287309 60.61658889794144)))"
20050006755000,221,121,100,37.8,"MULTIPOLYGON(((5.935226415836566 60.62278244329616,5.922662867280597 60.667112714570244,6.013026393938218 60.673256858567065,6.025469017276707 60.62891552401728,5.935226415836566 60.62278244329616)))"
20100006755000,144,79,65,45.4,"MULTIPOLYGON(((6.025469017276707 60.62891552401728,6.013026393938218 60.673256858567065,6.103429618341242 60.67934038007377,6.115751139708013 60.63498808725503,6.025469017276707 60.62891552401728)))"
20150006755000,173,87,86,40.2,"MULTIPOLYGON(((6.115751139708013 60.63498808725503,6.103429618341242 60.67934038007377,6.193872171004099 60.68536322650421,6.206072415182308 60.641000080639024,6.115751139708013 60.63498808725503)))"
20200006755000,22,13,9,35.2,"MULTIPOLYGON(((6.206072415182308 60.641000080639024,6.193872171004099 60.68536322650421,6.284353681393385 60.691325345755075,6.296432474711264 60.64695145227981,6.206072415182308 60.641000080639024)))"
20300006755000,1220,611,609,41.2,"MULTIPOLYGON(((6.386830948274806 60.65284215077063,6.3748737779363 60.69722668620744,6.465432088029173 60.70306719672857,6.477267464829567 60.65867212518889,6.386830948274806 60.65284215077063)))"
20350006755000,597,310,287,38.4,"MULTIPOLYGON(((6.477267464829567 60.65867212518889,6.465432088029173 60.70306719672857,6.556028238046006 60.70884682667341,6.567741652317388 60.664441325098025,6.477267464829567 60.65867212518889)))"
20400006755000,145,83,62,44,"MULTIPOLYGON(((6.567741652317388 60.664441325098025,6.556028238046006 60.70884682667341,6.646661853347173 60.71456552588628,6.658253137673952 60.670149700548905,6.567741652317388 60.664441325098025)))"
20450006755000,44,25,19,39.9,"MULTIPOLYGON(((6.658253137673952 60.670149700548905,6.646661853347173 60.71456552588628,6.737332558288083 60.72022324470253,6.748801546837387 60.67579720208154,6.658253137673952 60.670149700548905)))"
20500006755000,7,5,2,35.6,"MULTIPOLYGON(((6.748801546837387 60.67579720208154,6.737332558288083 60.72022324470253,6.828039976227981 60.72581993395004,6.839386504757027 60.68138378072661,6.748801546837387 60.67579720208154)))"
20550006755000,5,3,2,69,"MULTIPOLYGON(((6.839386504757027 60.68138378072661,6.828039976227981 60.72581993395004,6.918783729538799 60.73135554495086,6.930007635402168 60.68690938800711,6.839386504757027 60.68138378072661)))"
20600006755000,1,1,0,0,"MULTIPOLYGON(((6.930007635402168 60.68690938800711,6.918783729538799 60.73135554495086,7.009563439614042 60.7368300295228,7.020664561770936 60.692373975939844,6.930007635402168 60.68690938800711)))"
20700006755000,10,7,3,45.2,"MULTIPOLYGON(((7.11135690589919 60.697777497036974,7.100378726877778 60.74224333998093,7.191229210793665 60.747595429139174,7.202084288869496 60.70311990430762,7.11135690589919 60.697777497036974)))"
20850006755000,1,0,1,0,"MULTIPOLYGON(((7.383642650954371 60.7136211918994,7.373034241689155 60.758115757314876,7.463988022876255 60.76328390446804,7.474472867549282 60.71877998073688,7.383642650954371 60.7136211918994)))"
21500006755000,7,6,1,37.3,"MULTIPOLYGON(((8.566939220310875 60.77589193817162,8.557948471729228 60.82049966779161,8.649309601434553 60.82486621164646,8.658174949841754 60.780250544648446,8.566939220310875 60.77589193817162)))"
21550006755000,92,48,44,46.6,"MULTIPOLYGON(((8.658174949841754 60.780250544648446,8.649309601434553 60.82486621164646,8.740699320787842 60.82917080978405,8.74943913975869 60.78454731589526,8.658174949841754 60.780250544648446)))"
21600006755000,26,16,10,39.7,"MULTIPOLYGON(((8.74943913975869 60.78454731589526,8.740699320787842 60.82917080978405,8.832117233580517 60.83341342424441,8.840731395588975 60.78878221411099,8.74943913975869 60.78454731589526)))"
21650006755000,4,2,2,0,"MULTIPOLYGON(((8.840731395588975 60.78878221411099,8.832117233580517 60.83341342424441,8.923562942826752 60.837594017593005,8.932051322088506 60.79295520201773,8.840731395588975 60.78878221411099)))"
21700006755000,38,22,16,45.2,"MULTIPOLYGON(((8.932051322088506 60.79295520201773,8.923562942826752 60.837594017593005,9.015036050773675 60.841712552921855,9.023398523251895 60.79706624286213,8.932051322088506 60.79295520201773)))"
21800006755000,18,7,11,50.9,"MULTIPOLYGON(((9.114772602322658 60.801115300416484,9.106536158911629 60.84576899385078,9.198062867984468 60.84976330452867,9.206173161803465 60.805102338979985,9.114772602322658 60.801115300416484)))"
21950006755000,131,76,55,47.4,"MULTIPOLYGON(((9.389052128363312 60.81289021897264,9.381194488240082 60.85756539437882,9.472798597271673 60.861373104504544,9.480529736836209 60.8166909916451,9.389052128363312 60.81289021897264)))"
22000006755000,753,364,389,47.8,"MULTIPOLYGON(((9.480529736836209 60.8166909916451,9.472798597271673 60.861373104504544,9.564427702956761 60.86511854628834,9.572032228527668 60.820429607815676,9.480529736836209 60.8166909916451)))"
22050006755000,20,12,8,49.6,"MULTIPOLYGON(((9.572032228527668 60.820429607815676,9.564427702956761 60.86511854628834,9.656081402463208 60.868801686541744,9.663559202391326 60.82410603443535,9.572032228527668 60.820429607815676)))"
22100006755000,103,56,47,44.2,"MULTIPOLYGON(((9.663559202391326 60.82410603443535,9.656081402463208 60.868801686541744,9.747759292275301 60.872422492612124,9.755110256702412 60.82772023898889,9.663559202391326 60.82410603443535)))"
22150006755000,78,41,37,44.6,"MULTIPOLYGON(((9.755110256702412 60.82772023898889,9.747759292275301 60.872422492612124,9.839460968204412 60.875980932383904,9.846684989068327 60.831272189495834,9.755110256702412 60.82772023898889)))"
22200006755000,229,118,111,40,"MULTIPOLYGON(((9.846684989068327 60.831272189495834,9.839460968204412 60.875980932383904,9.931186025399676 60.879476974279605,9.938282996439252 60.83476185451164,9.846684989068327 60.831272189495834)))"
22250006755000,380,196,184,41.8,"MULTIPOLYGON(((9.938282996439252 60.83476185451164,9.931186025399676 60.879476974279605,10.022934058358754 60.882910587260874,10.02990387511881 60.83818920312871,9.938282996439252 60.83476185451164)))"
22300006755000,1023,486,537,48.2,"MULTIPOLYGON(((10.02990387511881 60.83818920312871,10.022934058358754 60.882910587260874,10.114704660938623 60.88628174082956,10.121547220774811 60.84155420497736,10.02990387511881 60.83818920312871)))"
22350006755000,115,63,52,41.9,"MULTIPOLYGON(((10.121547220774811 60.84155420497736,10.114704660938623 60.88628174082956,10.206497426366402 60.8895904050287,10.213212628449964 60.844856830226966,10.121547220774811 60.84155420497736)))"
22400006755000,72,40,32,38.8,"MULTIPOLYGON(((10.213212628449964 60.844856830226966,10.206497426366402 60.8895904050287,10.29831194725023 60.89283655044357,10.304899692572697 60.84809704958687,10.213212628449964 60.844856830226966)))"
22450006755000,338,169,169,48.5,"MULTIPOLYGON(((10.304899692572697 60.84809704958687,10.29831194725023 60.89283655044357,10.390147815590192 60.896020148202645,10.396608006968 60.85127483430731,10.304899692572697 60.84809704958687)))"
22500006755000,456,242,214,42.2,"MULTIPOLYGON(((10.396608006968 60.85127483430731,10.390147815590192 60.896020148202645,10.482004622789292 60.89914116997859,10.4883371648683 60.854390156180564,10.396608006968 60.85127483430731)))"
22550006755000,328,168,160,42.6,"MULTIPOLYGON(((10.4883371648683 60.854390156180564,10.482004622789292 60.89914116997859,10.573881959664432 60.90219958798915,10.580086758924386 60.857442987541674,10.4883371648683 60.854390156180564)))"
22600006755000,511,264,247,46.6,"MULTIPOLYGON(((10.580086758924386 60.857442987541674,10.573881959664432 60.90219958798915,10.665779416457484 60.90519537499822,10.671856381216381 60.86043330126963,10.580086758924386 60.857442987541674)))"
22650006755000,604,318,286,42.7,"MULTIPOLYGON(((10.671856381216381 60.86043330126963,10.665779416457484 60.90519537499822,10.757696582846359 60.90812850431659,10.763645623264729 60.863361070788,10.671856381216381 60.86043330126963)))"
22700006755000,1047,557,490,40.7,"MULTIPOLYGON(((10.763645623264729 60.863361070788,10.757696582846359 60.90812850431659,10.84963304795615 60.910998949803016,10.855454076041257 60.86622627006606,10.763645623264729 60.863361070788)))"
22750006755000,5435,2693,2742,43.8,"MULTIPOLYGON(((10.855454076041257 60.86622627006606,10.84963304795615 60.910998949803016,10.94158840037027 60.91380668586498,10.947281329980244 60.86902887361951,10.855454076041257 60.86622627006606)))"
22800006755000,6938,3447,3491,42.5,"MULTIPOLYGON(((10.947281329980244 60.86902887361951,10.94158840037027 60.91380668586498,11.033562228141678 60.91655168745957,11.039126974989538 60.871768856511466,10.947281329980244 60.86902887361951)))"
22850006755000,376,204,172,38.3,"MULTIPOLYGON(((11.039126974989538 60.871768856511466,11.033562228141678 60.91655168745957,11.125554118804109 60.91923393009442,11.130990600461718 60.874446194353176,11.039126974989538 60.871768856511466)))"
22900006755000,462,247,215,37.4,"MULTIPOLYGON(((11.130990600461718 60.874446194353176,11.125554118804109 60.91923393009442,11.217563659383345 60.92185338982845,11.22287179528529 60.87706086330493,11.130990600461718 60.874446194353176)))"
22950006755000,122,67,55,45.6,"MULTIPOLYGON(((11.22287179528529 60.87706086330493,11.217563659383345 60.92185338982845,11.309590436408532 60.92441004327269,11.314770147855896 60.87961284007687,11.22287179528529 60.87706086330493)))"
23000006755000,197,100,97,44.5,"MULTIPOLYGON(((11.314770147855896 60.87961284007687,11.309590436408532 60.92441004327269,11.401634035923527 60.926903867591086,11.40668524608759 60.88210210192961,11.314770147855896 60.87961284007687)))"
23100006755000,7160,3466,3694,40.7,"MULTIPOLYGON(((11.49861667742413 60.8845286266753,11.493694043498275 60.92933484050127,11.58577004424022 60.931702940275336,11.590564028850299 60.88689239267814,11.49861667742413 60.8845286266753)))"
23150006755000,1493,775,718,37.8,"MULTIPOLYGON(((11.590564028850299 60.88689239267814,11.58577004424022 60.931702940275336,11.677861622805755 60.93400814574054,11.682526886903277 60.88919337885515,11.590564028850299 60.88689239267814)))"
23200006755000,166,87,79,41.2,"MULTIPOLYGON(((11.682526886903277 60.88919337885515,11.677861622805755 60.93400814574054,11.769968363411701 60.93625043628006,11.774504837684015 60.89143156467703,11.682526886903277 60.88919337885515)))"
23250006755000,180,97,83,46.1,"MULTIPOLYGON(((11.774504837684015 60.89143156467703,11.769968363411701 60.93625043628006,11.862089849846814 60.93842979183366,11.86649746686868 60.893606930168595,11.774504837684015 60.89143156467703)))"
23300006755000,47,24,23,41.8,"MULTIPOLYGON(((11.86649746686868 60.893606930168595,11.862089849846814 60.93842979183366,11.954225665483317 60.9405461928984,11.958504359720079 60.89571945590976,11.86649746686868 60.893606930168595)))"
23350006755000,18,10,8,53.1,"MULTIPOLYGON(((11.958504359720079 60.89571945590976,11.954225665483317 60.9405461928984,12.046375393288487 60.94259962052924,12.050525101099169 60.89776912303593,11.958504359720079 60.89571945590976)))"
19400006760000,424,208,216,46.3,"MULTIPOLYGON(((4.751715673445103 60.581746990855486,4.737552110724941 60.625921720648115,4.827485280293717 60.63286139640254,4.841529997937278 60.58867422532081,4.751715673445103 60.581746990855486)))"
19450006760000,222,114,108,42.6,"MULTIPOLYGON(((4.841529997937278 60.58867422532081,4.827485280293717 60.63286139640254,4.917463049024801 60.639741074151964,4.931388724416755 60.59554156407005,4.841529997937278 60.58867422532081)))"
19500006760000,86,43,43,51.2,"MULTIPOLYGON(((4.931388724416755 60.59554156407005,4.917463049024801 60.639741074151964,5.007485060351459 60.646560694951496,5.021291497756932 60.602348948397854,4.931388724416755 60.59554156407005)))"
19550006760000,1554,792,762,42.3,"MULTIPOLYGON(((5.021291497756932 60.602348948397854,5.007485060351459 60.646560694951496,5.097550956547243 60.653320200318014,5.1112379616799 60.609096320058924,5.021291497756932 60.602348948397854)))"
19600006760000,1084,553,531,40.7,"MULTIPOLYGON(((5.1112379616799 60.609096320058924,5.097550956547243 60.653320200318014,5.187660378733566 60.660019532231864,5.201227758763987 60.615783621269784,5.1112379616799 60.609096320058924)))"
19650006760000,595,315,280,41.3,"MULTIPOLYGON(((5.201227758763987 60.615783621269784,5.187660378733566 60.660019532231864,5.27781296688734 60.66665863313875,5.291260530451344 60.62241079471064,5.201227758763987 60.615783621269784)))"
19700006760000,538,274,264,44.8,"MULTIPOLYGON(((5.291260530451344 60.62241079471064,5.27781296688734 60.66665863313875,5.368008359848725 60.67323744595156,5.381335917055649 60.62897778352716,5.291260530451344 60.62241079471064)))"
19750006760000,273,139,134,43.2,"MULTIPOLYGON(((5.381335917055649 60.62897778352716,5.368008359848725 60.67323744595156,5.458246195328895 60.67975591405217,5.471453557769819 60.635484531332295,5.381335917055649 60.62897778352716)))"
19800006760000,24,13,11,44.3,"MULTIPOLYGON(((5.471453557769819 60.635484531332295,5.458246195328895 60.67975591405217,5.54852610991793 60.68621398129318,5.561613090673864 60.641930982207995,5.471453557769819 60.635484531332295)))"
19850006760000,12,6,6,57.8,"MULTIPOLYGON(((5.561613090673864 60.641930982207995,5.54852610991793 60.68621398129318,5.638847739092752 60.69261159199973,5.651814152742763 60.648317080707024,5.561613090673864 60.641930982207995)))"
19900006760000,58,29,29,42.8,"MULTIPOLYGON(((5.651814152742763 60.648317080707024,5.638847739092752 60.69261159199973,5.729210717225126 60.69894869097126,5.742056379854424 60.65464277185468,5.651814152742763 60.648317080707024)))"
19950006760000,256,132,124,50.5,"MULTIPOLYGON(((5.742056379854424 60.65464277185468,5.729210717225126 60.69894869097126,5.819614677589761 60.705225223483204,5.832339406797722 60.66090800115055,5.742056379854424 60.65464277185468)))"
20050006760000,13,7,6,44.8,"MULTIPOLYGON(((5.922662867280597 60.667112714570244,5.910059252372448 60.711441135288865,6.000544072678287 60.717596372621,6.013026393938218 60.673256858567065,5.922662867280597 60.667112714570244)))"
20100006760000,1,0,1,0,"MULTIPOLYGON(((6.013026393938218 60.673256858567065,6.000544072678287 60.717596372621,6.091068768539989 60.723690882193594,6.103429618341242 60.67934038007377,6.013026393938218 60.673256858567065)))"
20150006760000,9,7,2,46.6,"MULTIPOLYGON(((6.103429618341242 60.67934038007377,6.091068768539989 60.723690882193594,6.181632968926222 60.72972461120359,6.193872171004099 60.68536322650421,6.103429618341242 60.67934038007377)))"
20350006760000,70,44,26,49.4,"MULTIPOLYGON(((6.465432088029173 60.70306719672857,6.45355887113586 60.74746059410616,6.544277358322802 60.75325068255212,6.556028238046006 60.70884682667341,6.465432088029173 60.70306719672857)))"
21400006760000,1,1,0,0,"MULTIPOLYGON(((8.375313562149673 60.81158089738878,8.366042634273507 60.85617128686941,8.457470929501408 60.86066978661628,8.466616327093044 60.81607121670345,8.375313562149673 60.81158089738878)))"
21450006760000,43,25,18,37.6,"MULTIPOLYGON(((8.466616327093044 60.81607121670345,8.457470929501408 60.86066978661628,8.54892873794552 60.86510630768096,8.557948471729228 60.82049966779161,8.466616327093044 60.81607121670345)))"
21500006760000,1383,693,690,38.3,"MULTIPOLYGON(((8.557948471729228 60.82049966779161,8.54892873794552 60.86510630768096,8.64041566324815 60.869480810892654,8.649309601434553 60.82486621164646,8.557948471729228 60.82049966779161)))"
21550006760000,67,38,29,44.7,"MULTIPOLYGON(((8.649309601434553 60.82486621164646,8.64041566324815 60.869480810892654,8.731931308248063 60.87379325760549,8.740699320787842 60.82917080978405,8.649309601434553 60.82486621164646)))"
21600006760000,4,2,2,0,"MULTIPOLYGON(((8.740699320787842 60.82917080978405,8.731931308248063 60.87379325760549,8.823475274990654 60.87804360969984,8.832117233580517 60.83341342424441,8.740699320787842 60.82917080978405)))"
21650006760000,4,3,1,0,"MULTIPOLYGON(((8.832117233580517 60.83341342424441,8.823475274990654 60.87804360969984,8.915047164738173 60.88223182958349,8.923562942826752 60.837594017593005,8.832117233580517 60.83341342424441)))"
21700006760000,3,2,1,0,"MULTIPOLYGON(((8.923562942826752 60.837594017593005,8.915047164738173 60.88223182958349,9.006646577980012 60.88635788019294,9.015036050773675 60.841712552921855,8.923562942826752 60.837594017593005)))"
21750006760000,1,0,1,0,"MULTIPOLYGON(((9.015036050773675 60.841712552921855,9.006646577980012 60.88635788019294,9.098273114443014 60.89042172499468,9.106536158911629 60.84576899385078,9.015036050773675 60.841712552921855)))"
21800006760000,12,6,6,57.7,"MULTIPOLYGON(((9.106536158911629 60.84576899385078,9.098273114443014 60.89042172499468,9.189926373101889 60.89442332798632,9.198062867984468 60.84976330452867,9.106536158911629 60.84576899385078)))"
21850006760000,79,42,37,42.4,"MULTIPOLYGON(((9.198062867984468 60.84976330452867,9.189926373101889 60.89442332798632,9.28160595218961 60.89836265369788,9.289615777999943 60.85369544963453,9.198062867984468 60.84976330452867)))"
21950006760000,109,51,58,42.4,"MULTIPOLYGON(((9.381194488240082 60.85756539437882,9.37331144920794 60.90223966719291,9.465042460937937 60.90605433406967,9.472798597271673 60.861373104504544,9.381194488240082 60.85756539437882)))"
22000006760000,108,48,60,51.8,"MULTIPOLYGON(((9.472798597271673 60.861373104504544,9.465042460937937 60.90605433406967,9.55679858345056 60.90980662046233,9.564427702956761 60.86511854628834,9.472798597271673 60.861373104504544)))"
22050006760000,383,175,208,49.5,"MULTIPOLYGON(((9.564427702956761 60.86511854628834,9.55679858345056 60.90980662046233,9.648579412117284 60.91349649304199,9.656081402463208 60.868801686541744,9.564427702956761 60.86511854628834)))"
22100006760000,62,36,26,47.6,"MULTIPOLYGON(((9.656081402463208 60.868801686541744,9.648579412117284 60.91349649304199,9.740384541620807 60.91712391901793,9.747759292275301 60.872422492612124,9.656081402463208 60.868801686541744)))"
22150006760000,1,1,0,0,"MULTIPOLYGON(((9.747759292275301 60.872422492612124,9.740384541620807 60.91712391901793,9.832213565965759 60.92068886613865,9.839460968204412 60.875980932383904,9.747759292275301 60.872422492612124)))"
22200006760000,2,1,1,0,"MULTIPOLYGON(((9.839460968204412 60.875980932383904,9.832213565965759 60.92068886613865,9.9240660784895 60.92419130269289,9.931186025399676 60.879476974279605,9.839460968204412 60.875980932383904)))"
22300006760000,202,104,98,47.4,"MULTIPOLYGON(((10.022934058358754 60.882910587260874,10.015941671872927 60.927631197510856,10.107839938151363 60.93100851996505,10.114704660938623 60.88628174082956,10.022934058358754 60.882910587260874)))"
22350006760000,38,18,20,39.2,"MULTIPOLYGON(((10.114704660938623 60.88628174082956,10.107839938151363 60.93100851996505,10.199760468725444 60.93432323997155,10.206497426366402 60.8895904050287,10.114704660938623 60.88628174082956)))"
22400006760000,161,89,72,40.7,"MULTIPOLYGON(((10.206497426366402 60.8895904050287,10.199760468725444 60.93432323997155,10.291702854372105 60.937575327990814,10.29831194725023 60.89283655044357,10.206497426366402 60.8895904050287)))"
22450006760000,212,105,107,43.2,"MULTIPOLYGON(((10.29831194725023 60.89283655044357,10.291702854372105 60.937575327990814,10.383666685255568 60.94076475502875,10.390147815590192 60.896020148202645,10.29831194725023 60.89283655044357)))"
22500006760000,34,20,14,45.8,"MULTIPOLYGON(((10.390147815590192 60.896020148202645,10.383666685255568 60.94076475502875,10.475651550938396 60.94389149263776,10.482004622789292 60.89914116997859,10.390147815590192 60.896020148202645)))"
22550006760000,72,41,31,43.7,"MULTIPOLYGON(((10.482004622789292 60.89914116997859,10.475651550938396 60.94389149263776,10.567657040392566 60.946955512917604,10.573881959664432 60.90219958798915,10.482004622789292 60.89914116997859)))"
22600006760000,943,503,440,41.1,"MULTIPOLYGON(((10.573881959664432 60.90219958798915,10.567657040392566 60.946955512917604,10.659682742010617 60.94995678851638,10.665779416457484 60.90519537499822,10.573881959664432 60.90219958798915)))"
22650006760000,4853,2437,2416,45.3,"MULTIPOLYGON(((10.665779416457484 60.90519537499822,10.659682742010617 60.94995678851638,10.7517282436168 60.95289529263146,10.757696582846359 60.90812850431659,10.665779416457484 60.90519537499822)))"
22700006760000,441,235,206,43.8,"MULTIPOLYGON(((10.757696582846359 60.90812850431659,10.7517282436168 60.95289529263146,10.843793132478295 60.95577099901041,10.84963304795615 60.910998949803016,10.757696582846359 60.90812850431659)))"
22750006760000,908,486,422,39.7,"MULTIPOLYGON(((10.84963304795615 60.910998949803016,10.843793132478295 60.95577099901041,10.935876995316468 60.95858388195179,10.94158840037027 60.91380668586498,10.84963304795615 60.910998949803016)))"
22800006760000,694,367,327,39.9,"MULTIPOLYGON(((10.94158840037027 60.91380668586498,10.935876995316468 60.95858388195179,11.027979418318138 60.96133391630617,11.033562228141678 60.91655168745957,10.94158840037027 60.91380668586498)))"
22850006760000,93,55,38,38.3,"MULTIPOLYGON(((11.033562228141678 60.91655168745957,11.027979418318138 60.96133391630617,11.120099987146919 60.96402107747684,11.125554118804109 60.91923393009442,11.033562228141678 60.91655168745957)))"
22950006760000,4,3,1,0,"MULTIPOLYGON(((11.217563659383345 60.92185338982845,11.212238286954562 60.96664534142081,11.304393902392373 60.969206684649386,11.309590436408532 60.92441004327269,11.217563659383345 60.92185338982845)))"
23050006760000,56,32,24,39.8,"MULTIPOLYGON(((11.401634035923527 60.926903867591086,11.39656641762263 60.97170508422923,11.488755416330045 60.97414051778296,11.493694043498275 60.92933484050127,11.401634035923527 60.926903867591086)))"
23100006760000,189,101,88,43.4,"MULTIPOLYGON(((11.493694043498275 60.92933484050127,11.488755416330045 60.97414051778296,11.580960481733284 60.97651296349001,11.58577004424022 60.931702940275336,11.493694043498275 60.92933484050127)))"
23150006760000,624,336,288,40.3,"MULTIPOLYGON(((11.58577004424022 60.931702940275336,11.580960481733284 60.97651296349001,11.673181196596476 60.97882240008729,11.677861622805755 60.93400814574054,11.58577004424022 60.931702940275336)))"
23200006760000,307,151,156,42.8,"MULTIPOLYGON(((11.677861622805755 60.93400814574054,11.673181196596476 60.97882240008729,11.7654171432408 60.98106880686999,11.769968363411701 60.93625043628006,11.677861622805755 60.93400814574054)))"
23250006760000,412,210,202,46.1,"MULTIPOLYGON(((11.769968363411701 60.93625043628006,11.7654171432408 60.98106880686999,11.857667903556063 60.983252163692256,11.862089849846814 60.93842979183366,11.769968363411701 60.93625043628006)))"
23300006760000,42,22,20,41.2,"MULTIPOLYGON(((11.862089849846814 60.93842979183366,11.857667903556063 60.983252163692256,11.949933059012332 60.98537245096785,11.954225665483317 60.9405461928984,11.862089849846814 60.93842979183366)))"
19400006765000,276,152,124,52.3,"MULTIPOLYGON(((4.737552110724941 60.625921720648115,4.723343593247206 60.67009417714398,4.813395963293326 60.67704632769308,4.827485280293717 60.63286139640254,4.737552110724941 60.625921720648115)))"
19450006765000,8,5,3,54.1,"MULTIPOLYGON(((4.827485280293717 60.63286139640254,4.813395963293326 60.67704632769308,4.903493130843986 60.68393837770143,4.917463049024801 60.639741074151964,4.827485280293717 60.63286139640254)))"
19500006765000,429,219,210,42.8,"MULTIPOLYGON(((4.917463049024801 60.639741074151964,4.903493130843986 60.68393837770143,4.993634737884833 60.69077026798332,5.007485060351459 60.646560694951496,4.917463049024801 60.639741074151964)))"
19550006765000,592,296,296,42.3,"MULTIPOLYGON(((5.007485060351459 60.646560694951496,4.993634737884833 60.69077026798332,5.083820425233298 60.697541939816375,5.097550956547243 60.653320200318014,5.007485060351459 60.646560694951496)))"
19600006765000,230,123,107,44.7,"MULTIPOLYGON(((5.097550956547243 60.653320200318014,5.083820425233298 60.697541939816375,5.174049832546228 60.70425333494347,5.187660378733566 60.660019532231864,5.097550956547243 60.653320200318014)))"
19650006765000,511,259,252,38.7,"MULTIPOLYGON(((5.187660378733566 60.660019532231864,5.174049832546228 60.70425333494347,5.26432259832757 60.7109043955745,5.27781296688734 60.66665863313875,5.187660378733566 60.660019532231864)))"
19700006765000,371,187,184,40.3,"MULTIPOLYGON(((5.27781296688734 60.66665863313875,5.26432259832757 60.7109043955745,5.354638359936168 60.71749506438827,5.368008359848725 60.67323744595156,5.27781296688734 60.66665863313875)))"
19750006765000,165,92,73,46.3,"MULTIPOLYGON(((5.368008359848725 60.67323744595156,5.354638359936168 60.71749506438827,5.444996753593581 60.72402528453419,5.458246195328895 60.67975591405217,5.368008359848725 60.67323744595156)))"
19800006765000,1,1,0,0,"MULTIPOLYGON(((5.458246195328895 60.67975591405217,5.444996753593581 60.72402528453419,5.535397414392022 60.73049499963426,5.54852610991793 60.68621398129318,5.458246195328895 60.67975591405217)))"
19850006765000,43,27,16,46.7,"MULTIPOLYGON(((5.54852610991793 60.68621398129318,5.535397414392022 60.73049499963426,5.62583997630234 60.73690415378473,5.638847739092752 60.69261159199973,5.54852610991793 60.68621398129318)))"
19900006765000,69,34,35,45,"MULTIPOLYGON(((5.638847739092752 60.69261159199973,5.62583997630234 60.73690415378473,5.716324072182082 60.743252691557835,5.729210717225126 60.69894869097126,5.638847739092752 60.69261159199973)))"
19950006765000,59,31,28,54.6,"MULTIPOLYGON(((5.729210717225126 60.69894869097126,5.716324072182082 60.743252691557835,5.806849333783634 60.74954055800365,5.819614677589761 60.705225223483204,5.729210717225126 60.69894869097126)))"
20000006765000,16,8,8,53,"MULTIPOLYGON(((5.819614677589761 60.705225223483204,5.806849333783634 60.74954055800365,5.897415391762413 60.7557676986519,5.910059252372448 60.711441135288865,5.819614677589761 60.705225223483204)))"
20150006765000,58,31,27,47.5,"MULTIPOLYGON(((6.091068768539989 60.723690882193594,6.078668414038272 60.76803958708243,6.169354634236226 60.77408422833743,6.181632968926222 60.72972461120359,6.091068768539989 60.723690882193594)))"
20300006765000,37,21,16,38,"MULTIPOLYGON(((6.36287839387746 60.74160951874805,6.350844624515964 60.785990642254454,6.44164764414382 60.79185231131285,6.45355887113586 60.74746059410616,6.36287839387746 60.74160951874805)))"
20350006765000,498,258,240,39.3,"MULTIPOLYGON(((6.45355887113586 60.74746059410616,6.44164764414382 60.79185231131285,6.532488844725987 60.79765288685345,6.544277358322802 60.75325068255212,6.45355887113586 60.74746059410616)))"
20400006765000,301,156,145,47.4,"MULTIPOLYGON(((6.544277358322802 60.75325068255212,6.532488844725987 60.79765288685345,6.623367848446015 60.803392318303935,6.63503347921462 60.758979733722526,6.544277358322802 60.75325068255212)))"
20450006765000,62,32,30,49.4,"MULTIPOLYGON(((6.63503347921462 60.758979733722526,6.623367848446015 60.803392318303935,6.714284276467474 60.80907055558669,6.725826856575225 60.76464769774687,6.63503347921462 60.758979733722526)))"
20700006765000,30,14,16,39.3,"MULTIPOLYGON(((7.089365351045662 60.78670770231226,7.07831661964024 60.83117057889541,7.16941445154995 60.83654211160461,7.180339317396301 60.79206949990994,7.089365351045662 60.78670770231226)))"
20900006765000,3,1,2,0,"MULTIPOLYGON(((7.453469512965184 60.807786452122166,7.442917185636103 60.852287619037554,7.53415322089188 60.85741293774361,7.544581060296868 60.812902469764396,7.453469512965184 60.807786452122166)))"
21350006765000,1,1,0,0,"MULTIPOLYGON(((8.274644247805865 60.851610848134726,8.265217621276937 60.89619178580437,8.356741797499803 60.90076053822137,8.366042634273507 60.85617128686941,8.274644247805865 60.851610848134726)))"
21400006765000,85,44,41,39.8,"MULTIPOLYGON(((8.366042634273507 60.85617128686941,8.356741797499803 60.90076053822137,8.448296018557949 60.90526724106824,8.457470929501408 60.86066978661628,8.366042634273507 60.85617128686941)))"
21450006765000,686,375,311,42.2,"MULTIPOLYGON(((8.457470929501408 60.86066978661628,8.448296018557949 60.90526724106824,8.53987988716937 60.909711854483554,8.54892873794552 60.86510630768096,8.457470929501408 60.86066978661628)))"
21500006765000,164,88,76,42.4,"MULTIPOLYGON(((8.54892873794552 60.86510630768096,8.53987988716937 60.909711854483554,8.631493005232239 60.91409433913156,8.64041566324815 60.869480810892654,8.54892873794552 60.86510630768096)))"
21550006765000,1,1,0,0,"MULTIPOLYGON(((8.64041566324815 60.869480810892654,8.631493005232239 60.91409433913156,8.723134973835084 60.91841465620362,8.731931308248063 60.87379325760549,8.64041566324815 60.869480810892654)))"
21650006765000,41,24,17,44.4,"MULTIPOLYGON(((8.823475274990654 60.87804360969984,8.814805393267052 60.92267276741937,8.906503863028194 60.92686863502804,8.915047164738173 60.88223182958349,8.823475274990654 60.87804360969984)))"
21900006765000,378,201,177,40.7,"MULTIPOLYGON(((9.28160595218961 60.89836265369788,9.273570208328557 60.94302893298298,9.365402895345778 60.94691303491818,9.37331144920794 60.90223966719291,9.28160595218961 60.89836265369788)))"
21950006765000,913,479,434,44.4,"MULTIPOLYGON(((9.37331144920794 60.90223966719291,9.365402895345778 60.94691303491818,9.457261213705005 60.950734677932715,9.465042460937937 60.90605433406967,9.37331144920794 60.90223966719291)))"
22050006765000,183,97,86,51,"MULTIPOLYGON(((9.55679858345056 60.90980662046233,9.549144757675458 60.95449382801734,9.641053120821555 60.958190451702066,9.648579412117284 60.91349649304199,9.55679858345056 60.90980662046233)))"
22100006765000,5,3,2,67,"MULTIPOLYGON(((9.648579412117284 60.91349649304199,9.641053120821555 60.958190451702066,9.732985896013663 60.961824516057135,9.740384541620807 60.91712391901793,9.648579412117284 60.91349649304199)))"
22250006765000,202,110,92,46.2,"MULTIPOLYGON(((9.9240660784895 60.92419130269289,9.916923050612038 60.9689048377679,10.008926612386322 60.972351031975755,10.015941671872927 60.927631197510856,9.9240660784895 60.92419130269289)))"
22300006765000,207,100,107,45.7,"MULTIPOLYGON(((10.015941671872927 60.927631197510856,10.008926612386322 60.972351031975755,10.1009529509645 60.97573454056038,10.107839938151363 60.93100851996505,10.015941671872927 60.927631197510856)))"
22350006765000,463,228,235,44.6,"MULTIPOLYGON(((10.107839938151363 60.93100851996505,10.1009529509645 60.97573454056038,10.19300165590979 60.979055333310036,10.199760468725444 60.93432323997155,10.107839938151363 60.93100851996505)))"
22400006765000,96,43,53,44.8,"MULTIPOLYGON(((10.199760468725444 60.93432323997155,10.19300165590979 60.979055333310036,10.285072316156901 60.982313380559646,10.291702854372105 60.937575327990814,10.199760468725444 60.93432323997155)))"
22450006765000,7,3,4,33.7,"MULTIPOLYGON(((10.291702854372105 60.937575327990814,10.285072316156901 60.982313380559646,10.377164520023156 60.9855086531919,10.383666685255568 60.94076475502875,10.291702854372105 60.937575327990814)))"
22500006765000,143,77,66,44.3,"MULTIPOLYGON(((10.383666685255568 60.94076475502875,10.377164520023156 60.9855086531919,10.469277855219586 60.98864112263817,10.475651550938396 60.94389149263776,10.383666685255568 60.94076475502875)))"
22550006765000,403,210,193,43,"MULTIPOLYGON(((10.475651550938396 60.94389149263776,10.469277855219586 60.98864112263817,10.561411908862114 60.991710760879506,10.567657040392566 60.946955512917604,10.475651550938396 60.94389149263776)))"
22600006765000,1562,771,791,46,"MULTIPOLYGON(((10.567657040392566 60.946955512917604,10.561411908862114 60.991710760879506,10.653566267482775 60.994717540447596,10.659682742010617 60.94995678851638,10.567657040392566 60.946955512917604)))"
22650006765000,608,313,295,44.1,"MULTIPOLYGON(((10.659682742010617 60.94995678851638,10.653566267482775 60.994717540447596,10.745740517040952 60.997661434425666,10.7517282436168 60.95289529263146,10.659682742010617 60.94995678851638)))"
22700006765000,440,237,203,43.6,"MULTIPOLYGON(((10.7517282436168 60.95289529263146,10.745740517040952 60.997661434425666,10.83793424293468 61.000542416449406,10.843793132478295 60.95577099901041,10.7517282436168 60.95289529263146)))"
22750006765000,89,48,41,45,"MULTIPOLYGON(((10.843793132478295 60.95577099901041,10.83793424293468 61.000542416449406,10.930147030011968 61.0033604607079,10.935876995316468 60.95858388195179,10.843793132478295 60.95577099901041)))"
22800006765000,99,55,44,40.3,"MULTIPOLYGON(((10.935876995316468 60.95858388195179,10.930147030011968 61.0033604607079,11.022378462582182 61.006115541944496,11.027979418318138 60.96133391630617,10.935876995316468 60.95858388195179)))"
23050006765000,163,93,70,41.5,"MULTIPOLYGON(((11.39656641762263 60.97170508422923,11.391482315766893 61.01650575098408,11.483800722390239 61.018945657718504,11.488755416330045 60.97414051778296,11.39656641762263 60.97170508422923)))"
23100006765000,44,22,22,46.7,"MULTIPOLYGON(((11.488755416330045 60.97414051778296,11.483800722390239 61.018945657718504,11.576135269692562 61.02132246157689,11.580960481733284 60.97651296349001,11.488755416330045 60.97414051778296)))"
23150006765000,5,3,2,40.6,"MULTIPOLYGON(((11.580960481733284 60.97651296349001,11.576135269692562 61.02132246157689,11.668485538534174 61.0236361412053,11.673181196596476 60.97882240008729,11.580960481733284 60.97651296349001)))"
23200006765000,192,101,91,44.8,"MULTIPOLYGON(((11.673181196596476 60.97882240008729,11.668485538534174 61.0236361412053,11.760851109329002 61.025886675810426,11.7654171432408 60.98106880686999,11.673181196596476 60.97882240008729)))"
23250006765000,172,94,78,43.8,"MULTIPOLYGON(((11.7654171432408 60.98106880686999,11.760851109329002 61.025886675810426,11.853231562056285 61.02807404516024,11.857667903556063 60.983252163692256,11.7654171432408 60.98106880686999)))"
23300006765000,7,4,3,61.4,"MULTIPOLYGON(((11.857667903556063 60.983252163692256,11.853231562056285 61.02807404516024,11.945626476272283 61.03019822958474,11.949933059012332 60.98537245096785,11.857667903556063 60.983252163692256)))"
19400006770000,11,7,4,65.9,"MULTIPOLYGON(((4.723343593247206 60.67009417714398,4.709089921229134 60.714264351649916,4.799261848592423 60.72122901064747,4.813395963293326 60.67704632769308,4.723343593247206 60.67009417714398)))"
19450006770000,71,35,36,40.9,"MULTIPOLYGON(((4.813395963293326 60.67704632769308,4.799261848592423 60.72122901064747,4.889478772978276 60.7281334663208,4.903493130843986 60.68393837770143,4.813395963293326 60.67704632769308)))"
19500006770000,812,449,363,42.9,"MULTIPOLYGON(((4.903493130843986 60.68393837770143,4.889478772978276 60.7281334663208,4.979740334917153 60.73497765924195,4.993634737884833 60.69077026798332,4.903493130843986 60.68393837770143)))"
19550006770000,211,118,93,45.8,"MULTIPOLYGON(((4.993634737884833 60.69077026798332,4.979740334917153 60.73497765924195,5.07004617376274 60.74176153044805,5.083820425233298 60.697541939816375,4.993634737884833 60.69077026798332)))"
19600006770000,1338,697,641,37.9,"MULTIPOLYGON(((5.083820425233298 60.697541939816375,5.07004617376274 60.74176153044805,5.160395927699618 60.748485021443074,5.174049832546228 60.70425333494347,5.083820425233298 60.697541939816375)))"
19650006770000,663,341,322,42.7,"MULTIPOLYGON(((5.174049832546228 60.70425333494347,5.160395927699618 60.748485021443074,5.250789233750999 60.75514807419981,5.26432259832757 60.7109043955745,5.174049832546228 60.70425333494347)))"
19700006770000,224,114,110,47.4,"MULTIPOLYGON(((5.26432259832757 60.7109043955745,5.250789233750999 60.75514807419981,5.341225727786565 60.76175063116157,5.354638359936168 60.71749506438827,5.26432259832757 60.7109043955745)))"
19750006770000,116,53,63,52.1,"MULTIPOLYGON(((5.354638359936168 60.71749506438827,5.341225727786565 60.76175063116157,5.43170504453034 60.768292635244144,5.444996753593581 60.72402528453419,5.354638359936168 60.71749506438827)))"
19850006770000,2,1,1,0,"MULTIPOLYGON(((5.535397414392022 60.73049499963426,5.522226817568685 60.774774029837545,5.612790679358307 60.78119475880774,5.62583997630234 60.73690415378473,5.535397414392022 60.73049499963426)))"
19900006770000,9,6,3,50.4,"MULTIPOLYGON(((5.62583997630234 60.73690415378473,5.612790679358307 60.78119475880774,5.703396261234402 60.78755476649861,5.716324072182082 60.743252691557835,5.62583997630234 60.73690415378473)))"
20000006770000,22,14,8,53.6,"MULTIPOLYGON(((5.806849333783634 60.74954055800365,5.794043193418827 60.79385399773353,5.884731105028352 60.80009239781732,5.897415391762413 60.7557676986519,5.806849333783634 60.74954055800365)))"
20050006770000,23,13,10,44.4,"MULTIPOLYGON(((5.897415391762413 60.7557676986519,5.884731105028352 60.80009239781732,5.975459624083006 60.80626991253784,5.988021875685159 60.76193405951351,5.897415391762413 60.7557676986519)))"
20100006770000,28,15,13,51.3,"MULTIPOLYGON(((5.988021875685159 60.76193405951351,5.975459624083006 60.80626991253784,6.066228377514466 60.81238648816783,6.078668414038272 60.76803958708243,5.988021875685159 60.76193405951351)))"
20150006770000,37,22,15,39.1,"MULTIPOLYGON(((6.078668414038272 60.76803958708243,6.066228377514466 60.81238648816783,6.157036991174527 60.81844207146655,6.169354634236226 60.77408422833743,6.078668414038272 60.76803958708243)))"
20200006770000,2,1,1,0,"MULTIPOLYGON(((6.169354634236226 60.77408422833743,6.157036991174527 60.81844207146655,6.24788508984365 60.82443660968163,6.260080162630069 60.78006793074368,6.169354634236226 60.77408422833743)))"
20350006770000,141,71,70,43,"MULTIPOLYGON(((6.44164764414382 60.79185231131285,6.429698236025996 60.83624234230255,6.520662527821309 60.84205343366019,6.532488844725987 60.79765288685345,6.44164764414382 60.79185231131285)))"
20400006770000,5,2,3,32.2,"MULTIPOLYGON(((6.532488844725987 60.79765288685345,6.520662527821309 60.84205343366019,6.611664793207452 60.84780327384101,6.623367848446015 60.803392318303935,6.532488844725987 60.79765288685345)))"
20450006770000,163,90,73,38.9,"MULTIPOLYGON(((6.623367848446015 60.803392318303935,6.611664793207452 60.84780327384101,6.702704651738763 60.853491812559184,6.714284276467474 60.80907055558669,6.623367848446015 60.803392318303935)))"
20500006770000,1,1,0,0,"MULTIPOLYGON(((6.714284276467474 60.80907055558669,6.702704651738763 60.853491812559184,6.793781721950958 60.85911900002719,6.805237748942874 60.814687549120535,6.714284276467474 60.80907055558669)))"
20550006770000,19,12,7,45.5,"MULTIPOLYGON(((6.805237748942874 60.814687549120535,6.793781721950958 60.85911900002719,6.884895621370137 60.86468478695738,6.896227885022601 60.82024324982219,6.805237748942874 60.814687549120535)))"
20700006770000,429,214,215,41.2,"MULTIPOLYGON(((7.07831661964024 60.83117057889541,7.067232372940462 60.87563196456273,7.158454455177911 60.881013259176406,7.16941445154995 60.83654211160461,7.07831661964024 60.83117057889541)))"
20750006770000,23,11,12,59.5,"MULTIPOLYGON(((7.16941445154995 60.83654211160461,7.158454455177911 60.881013259176406,7.249711826813487 60.88633296113243,7.260547413825953 60.84185216016,7.16941445154995 60.83654211160461)))"
20800006770000,147,79,68,40.6,"MULTIPOLYGON(((7.260547413825953 60.84185216016,7.249711826813487 60.88633296113243,7.341004100462917 60.89159102366638,7.351715120744809 60.8471006779918,7.260547413825953 60.84185216016)))"
21300006770000,3,2,1,0,"MULTIPOLYGON(((8.173723886341415 60.891561024203114,8.164140770822991 60.93613234964041,8.255760553320663 60.94077155869577,8.265217621276937 60.89619178580437,8.173723886341415 60.891561024203114)))"
21400006770000,41,21,20,54.5,"MULTIPOLYGON(((8.356741797499803 60.90076053822137,8.347410915752478 60.945348647860655,8.439091459924573 60.94986357657914,8.448296018557949 60.90526724106824,8.356741797499803 60.90076053822137)))"
21450006770000,1,0,1,0,"MULTIPOLYGON(((8.448296018557949 60.90526724106824,8.439091459924573 60.94986357657914,8.530801786806833 60.95431630482177,8.53987988716937 60.909711854483554,8.448296018557949 60.90526724106824)))"
21650006770000,9,4,5,34,"MULTIPOLYGON(((8.814805393267052 60.92267276741937,8.80610746108448 60.96730089432538,8.897932912139664 60.97150443094649,8.906503863028194 60.92686863502804,8.814805393267052 60.92267276741937)))"
21800006770000,100,53,47,48.6,"MULTIPOLYGON(((9.089983347654917 60.935073491076714,9.081666736543683 60.979724289307555,9.173574301466163 60.983740537897106,9.181763557668583 60.93908240667443,9.089983347654917 60.935073491076714)))"
21850006770000,1261,619,642,46.4,"MULTIPOLYGON(((9.181763557668583 60.93908240667443,9.173574301466163 60.983740537897106,9.265508427989218 60.98769428488605,9.273570208328557 60.94302893298298,9.181763557668583 60.93908240667443)))"
21900006770000,1432,713,719,43.6,"MULTIPOLYGON(((9.273570208328557 60.94302893298298,9.265508427989218 60.98769428488605,9.35746871002236 60.99158549504161,9.365402895345778 60.94691303491818,9.273570208328557 60.94302893298298)))"
21950006770000,1,1,0,0,"MULTIPOLYGON(((9.365402895345778 60.94691303491818,9.35746871002236 60.99158549504161,9.44945474074337 60.99541413367005,9.457261213705005 60.950734677932715,9.365402895345778 60.94691303491818)))"
22050006770000,104,53,51,36.3,"MULTIPOLYGON(((9.549144757675458 60.95449382801734,9.541466112609033 60.9991801666179,9.63350241736594 61.002883560273126,9.641053120821555 60.958190451702066,9.549144757675458 60.95449382801734)))"
22100006770000,13,10,3,68.2,"MULTIPOLYGON(((9.641053120821555 60.958190451702066,9.63350241736594 61.002883560273126,9.725563246061313 61.00652428156628,9.732985896013663 60.961824516057135,9.641053120821555 60.958190451702066)))"
22150006770000,7,4,3,48.7,"MULTIPOLYGON(((9.732985896013663 60.961824516057135,9.725563246061313 61.00652428156628,9.817648189053925 61.010102297971514,9.824942675438908 60.965395988694326,9.732985896013663 60.961824516057135)))"
22200006770000,9,4,5,48.9,"MULTIPOLYGON(((9.824942675438908 60.965395988694326,9.817648189053925 61.010102297971514,9.909756836025 61.01361757750783,9.916923050612038 60.9689048377679,9.824942675438908 60.965395988694326)))"
22250006770000,169,82,87,46.3,"MULTIPOLYGON(((9.916923050612038 60.9689048377679,9.909756836025 61.01361757750783,10.001888775989226 61.01707008874002,10.008926612386322 60.972351031975755,9.916923050612038 60.9689048377679)))"
22300006770000,273,142,131,42.7,"MULTIPOLYGON(((10.008926612386322 60.972351031975755,10.001888775989226 61.01707008874002,10.094043597305781 61.02045980077981,10.1009529509645 60.97573454056038,10.008926612386322 60.972351031975755)))"
22350006770000,65,34,31,47.9,"MULTIPOLYGON(((10.1009529509645 60.97573454056038,10.094043597305781 61.02045980077981,10.1862208876894 61.023786683286886,10.19300165590979 60.979055333310036,10.1009529509645 60.97573454056038)))"
22500006770000,190,106,84,42.4,"MULTIPOLYGON(((10.377164520023156 60.9855086531919,10.370641223361377 61.03025184108757,10.46288344095735 61.03339005844954,10.469277855219586 60.98864112263817,10.377164520023156 60.9855086531919)))"
22550006770000,822,429,393,42.2,"MULTIPOLYGON(((10.469277855219586 60.98864112263817,10.46288344095735 61.03339005844954,10.555146472258086 61.03646533041744,10.561411908862114 60.991710760879506,10.469277855219586 60.98864112263817)))"
22600006770000,586,295,291,43,"MULTIPOLYGON(((10.561411908862114 60.991710760879506,10.555146472258086 61.03646533041744,10.647429901923859 61.039477629405845,10.653566267482775 60.994717540447596,10.561411908862114 60.991710760879506)))"
22650006770000,124,67,57,38.9,"MULTIPOLYGON(((10.653566267482775 60.994717540447596,10.647429901923859 61.039477629405845,10.739733314037885 61.04242692838316,10.745740517040952 60.997661434425666,10.653566267482775 60.994717540447596)))"
22700006770000,485,240,245,41,"MULTIPOLYGON(((10.745740517040952 60.997661434425666,10.739733314037885 61.04242692838316,10.832056292117722 61.045313200872585,10.83793424293468 61.000542416449406,10.745740517040952 60.997661434425666)))"
22750006770000,31,17,14,41.9,"MULTIPOLYGON(((10.83793424293468 61.000542416449406,10.832056292117722 61.045313200872585,10.92439841912666 61.04813642095303,10.930147030011968 61.0033604607079,10.83793424293468 61.000542416449406)))"
22850006770000,1,1,0,0,"MULTIPOLYGON(((11.022378462582182 61.006115541944496,11.016759277485205 61.05089656325991,11.109138449082547 61.05359360298619,11.114628124427453 61.00880763545756,11.022378462582182 61.006115541944496)))"
23000006770000,53,28,25,43.3,"MULTIPOLYGON(((11.299180468504181 61.01400276328743,11.293950056963135 61.05879827826062,11.386381654472244 61.061305866989336,11.391482315766893 61.01650575098408,11.299180468504181 61.01400276328743)))"
23050006770000,10,5,5,49.1,"MULTIPOLYGON(((11.391482315766893 61.01650575098408,11.386381654472244 61.061305866989336,11.478829887695118 61.06375025949998,11.483800722390239 61.018945657718504,11.391482315766893 61.01650575098408)))"
23150006770000,3,2,1,0,"MULTIPOLYGON(((11.576135269692562 61.02132246157689,11.571294336038163 61.06613143378504,11.663774578446203 61.068449368399165,11.668485538534174 61.0236361412053,11.576135269692562 61.02132246157689)))"
23200006770000,67,31,36,48,"MULTIPOLYGON(((11.668485538534174 61.0236361412053,11.663774578446203 61.068449368399165,11.756270193414252 61.07070404245994,11.760851109329002 61.025886675810426,11.668485538534174 61.0236361412053)))"
23250006770000,15,8,7,48.4,"MULTIPOLYGON(((11.760851109329002 61.025886675810426,11.756270193414252 61.07070404245994,11.848780758999254 61.07289543564876,11.853231562056285 61.02807404516024,11.760851109329002 61.025886675810426)))"
23300006770000,25,13,12,50.4,"MULTIPOLYGON(((11.853231562056285 61.02807404516024,11.848780758999254 61.07289543564876,11.94130585283191 61.07502352821129,11.945626476272283 61.03019822958474,11.853231562056285 61.02807404516024)))"
23350006770000,3,1,2,0,"MULTIPOLYGON(((11.945626476272283 61.03019822958474,11.94130585283191 61.07502352821129,12.03384505212851 61.07708830095835,12.03803543112202 61.03225920997663,11.945626476272283 61.03019822958474)))"
23400006770000,3,1,2,0,"MULTIPOLYGON(((12.03803543112202 61.03225920997663,12.03384505212851 61.07708830095835,12.126397933702794 61.079089735266436,12.13045800535107 61.03425696779187,12.03803543112202 61.03225920997663)))"
23500006770000,33,18,15,51.6,"MULTIPOLYGON(((12.22289377731734 61.03619148505049,12.218964073977839 61.08102781307843,12.311543048997995 61.08290251690425,12.315342325002923 61.03806274433705,12.22289377731734 61.03619148505049)))"
23600006770000,17,7,10,43.4,"MULTIPOLYGON(((12.407803226025942 61.03987072880131,12.404134434440827 61.08471382982131,12.496737805629088 61.08646173547529,12.500276057652435 61.04161542215879,12.407803226025942 61.03987072880131)))"
23650006770000,18,8,10,35.5,"MULTIPOLYGON(((12.500276057652435 61.04161542215879,12.496737805629088 61.08646173547529,12.589352737542715 61.088146218080546,12.592760396808266 61.04329680869138,12.500276057652435 61.04161542215879)))"
23700006770000,51,27,24,57.7,"MULTIPOLYGON(((12.592760396808266 61.04329680869138,12.589352737542715 61.088146218080546,12.681978804830864 61.089767262420786,12.685255820091058 61.04491487324775,12.592760396808266 61.04329680869138)))"
19400006775000,51,24,27,49.9,"MULTIPOLYGON(((4.709089921229134 60.714264351649916,4.694790893704694 60.75843223541972,4.785082736671564 60.765409436668584,4.799261848592423 60.72122901064747,4.709089921229134 60.714264351649916)))"
19500006775000,790,414,376,43.9,"MULTIPOLYGON(((4.889478772978276 60.7281334663208,4.875419777363407 60.772326331561054,4.965801654847906 60.77918286042561,4.979740334917153 60.73497765924195,4.889478772978276 60.7281334663208)))"
19550006775000,369,192,177,40,"MULTIPOLYGON(((4.979740334917153 60.73497765924195,4.965801654847906 60.77918286042561,5.056228007007327 60.78597896405743,5.07004617376274 60.74176153044805,4.979740334917153 60.73497765924195)))"
19600006775000,334,181,153,44.6,"MULTIPOLYGON(((5.07004617376274 60.74176153044805,5.056228007007327 60.78597896405743,5.146698470546241 60.79271458372032,5.160395927699618 60.748485021443074,5.07004617376274 60.74176153044805)))"
19650006775000,60,30,30,51.3,"MULTIPOLYGON(((5.160395927699618 60.748485021443074,5.146698470546241 60.79271458372032,5.237212680999299 60.79938966114857,5.250789233750999 60.75514807419981,5.160395927699618 60.748485021443074)))"
19700006775000,194,104,90,41.7,"MULTIPOLYGON(((5.250789233750999 60.75514807419981,5.237212680999299 60.79938966114857,5.327770272739132 60.80600413854874,5.341225727786565 60.76175063116157,5.250789233750999 60.75514807419981)))"
19750006775000,26,12,14,49.7,"MULTIPOLYGON(((5.341225727786565 60.76175063116157,5.327770272739132 60.80600413854874,5.418370878984261 60.81255795860155,5.43170504453034 60.768292635244144,5.341225727786565 60.76175063116157)))"
19900006775000,9,5,4,51.1,"MULTIPOLYGON(((5.612790679358307 60.78119475880774,5.599699662142241 60.82548339976983,5.690427099794208 60.83185490863386,5.703396261234402 60.78755476649861,5.612790679358307 60.78119475880774)))"
19950006775000,7,5,2,60.6,"MULTIPOLYGON(((5.703396261234402 60.78755476649861,5.690427099794208 60.83185490863386,5.78119607344612 60.8381655356513,5.794043193418827 60.79385399773353,5.703396261234402 60.78755476649861)))"
20000006775000,240,119,121,39,"MULTIPOLYGON(((5.794043193418827 60.79385399773353,5.78119607344612 60.8381655356513,5.87200621066777 60.844415225900775,5.884731105028352 60.80009239781732,5.794043193418827 60.79385399773353)))"
20050006775000,36,19,17,50,"MULTIPOLYGON(((5.884731105028352 60.80009239781732,5.87200621066777 60.844415225900775,5.962857137924072 60.85060392494582,5.975459624083006 60.80626991253784,5.884731105028352 60.80009239781732)))"
20200006775000,5,3,2,73.6,"MULTIPOLYGON(((6.157036991174527 60.81844207146655,6.144679862926641 60.86279813411178,6.235650908154755 60.868803537800005,6.24788508984365 60.82443660968163,6.157036991174527 60.81844207146655)))"
20250006775000,19,8,11,55.3,"MULTIPOLYGON(((6.24788508984365 60.82443660968163,6.235650908154755 60.868803537800005,6.326661238398474 60.87474773742188,6.338772297239574 60.83037005055055,6.24788508984365 60.82443660968163)))"
20350006775000,94,54,40,47.2,"MULTIPOLYGON(((6.429698236025996 60.83624234230255,6.417710474726523 60.880630680991516,6.508798237154537 60.8864523170182,6.520662527821309 60.84205343366019,6.429698236025996 60.83624234230255)))"
20500006775000,20,10,10,51.6,"MULTIPOLYGON(((6.702704651738763 60.853491812559184,6.691087815160895 60.89791146296609,6.782288865585291 60.903548872397025,6.793781721950958 60.85911900002719,6.702704651738763 60.853491812559184)))"
20550006775000,45,25,20,48.8,"MULTIPOLYGON(((6.793781721950958 60.85911900002719,6.782288865585291 60.903548872397025,6.873526911819873 60.909124773307695,6.884895621370137 60.86468478695738,6.793781721950958 60.85911900002719)))"
20700006775000,3,2,1,0,"MULTIPOLYGON(((7.067232372940462 60.87563196456273,7.056112450259647 60.92009185411405,7.147459169247167 60.925482937546846,7.158454455177911 60.881013259176406,7.067232372940462 60.87563196456273)))"
20750006775000,977,496,481,43.3,"MULTIPOLYGON(((7.158454455177911 60.881013259176406,7.147459169247167 60.925482937546846,7.238841337628147 60.930812319536706,7.249711826813487 60.88633296113243,7.158454455177911 60.881013259176406)))"
20850006775000,3,1,2,0,"MULTIPOLYGON(((7.341004100462917 60.89159102366638,7.330258566348082 60.936079953123496,7.421710465391206 60.94128579185824,7.432330887787854 60.896787400523124,7.341004100462917 60.89159102366638)))"
21700006775000,34,17,17,57.2,"MULTIPOLYGON(((8.897932912139664 60.97150443094649,8.889334185747105 61.016139214339205,8.981314923628958 61.02028793652533,8.98978613856985 60.975645574888205,8.897932912139664 60.97150443094649)))"
21750006775000,225,122,103,42.8,"MULTIPOLYGON(((8.98978613856985 60.975645574888205,8.981314923628958 61.02028793652533,9.073323158358296 61.02437411687962,9.081666736543683 60.979724289307555,8.98978613856985 60.975645574888205)))"
21800006775000,441,224,217,43,"MULTIPOLYGON(((9.081666736543683 60.979724289307555,9.073323158358296 61.02437411687962,9.165358483539427 61.02839771894072,9.173574301466163 60.983740537897106,9.081666736543683 60.979724289307555)))"
21850006775000,1095,538,557,45.2,"MULTIPOLYGON(((9.173574301466163 60.983740537897106,9.165358483539427 61.02839771894072,9.257420492017834 61.03235870678615,9.265508427989218 60.98769428488605,9.173574301466163 60.983740537897106)))"
21900006775000,49,28,21,39.8,"MULTIPOLYGON(((9.265508427989218 60.98769428488605,9.257420492017834 61.03235870678615,9.349508775890909 61.036257045033594,9.35746871002236 60.99158549504161,9.265508427989218 60.98769428488605)))"
22000006775000,42,25,17,48.9,"MULTIPOLYGON(((9.44945474074337 60.99541413367005,9.441622926518713 61.04009269884204,9.533762534534807 61.04386563391295,9.541466112609033 60.9991801666179,9.44945474074337 60.99541413367005)))"
22050006775000,55,32,23,43.5,"MULTIPOLYGON(((9.541466112609033 60.9991801666179,9.533762534534807 61.04386563391295,9.625927189857103 61.04757581649149,9.63350241736594 61.002883560273126,9.541466112609033 60.9991801666179)))"
22100006775000,41,23,18,47.7,"MULTIPOLYGON(((9.63350241736594 61.002883560273126,9.625927189857103 61.04757581649149,9.718116481698807 61.05122321336751,9.725563246061313 61.00652428156628,9.63350241736594 61.002883560273126)))"
22150006775000,1,0,1,0,"MULTIPOLYGON(((9.725563246061313 61.00652428156628,9.718116481698807 61.05122321336751,9.81032999857938 61.054807791876875,9.817648189053925 61.010102297971514,9.725563246061313 61.00652428156628)))"
22200006775000,80,37,43,49.8,"MULTIPOLYGON(((9.817648189053925 61.010102297971514,9.81032999857938 61.054807791876875,9.902567328335554 61.058329519902436,9.909756836025 61.01361757750783,9.817648189053925 61.010102297971514)))"
22250006775000,45,23,22,40.7,"MULTIPOLYGON(((9.909756836025 61.01361757750783,9.902567328335554 61.058329519902436,9.9948280581324 61.061788365875145,10.001888775989226 61.01707008874002,9.909756836025 61.01361757750783)))"
22300006775000,56,29,27,52.8,"MULTIPOLYGON(((10.001888775989226 61.01707008874002,9.9948280581324 61.061788365875145,10.087111774474447 61.06518429877516,10.094043597305781 61.02045980077981,10.001888775989226 61.01707008874002)))"
22350006775000,9,6,3,37.3,"MULTIPOLYGON(((10.094043597305781 61.02045980077981,10.087111774474447 61.06518429877516,10.179418063216836 61.06851728813287,10.1862208876894 61.023786683286886,10.094043597305781 61.02045980077981)))"
22500006775000,1130,579,551,38.6,"MULTIPOLYGON(((10.370641223361377 61.03025184108757,10.364096698143545 61.0749943171002,10.456468212892286 61.07813829853101,10.46288344095735 61.03339005844954,10.370641223361377 61.03025184108757)))"
22550006775000,520,269,251,43.6,"MULTIPOLYGON(((10.46288344095735 61.03339005844954,10.456468212892286 61.07813829853101,10.548860637192846 61.08121922006383,10.555146472258086 61.03646533041744,10.46288344095735 61.03339005844954)))"
22600006775000,546,281,265,39.7,"MULTIPOLYGON(((10.555146472258086 61.03646533041744,10.548860637192846 61.08121922006383,10.641273553822403 61.084237053995416,10.647429901923859 61.039477629405845,10.555146472258086 61.03646533041744)))"
22650006775000,254,138,116,39.7,"MULTIPOLYGON(((10.647429901923859 61.039477629405845,10.641273553822403 61.084237053995416,10.733706544976634 61.087191773178674,10.739733314037885 61.04242692838316,10.647429901923859 61.039477629405845)))"
22700006775000,60,29,31,42.3,"MULTIPOLYGON(((10.739733314037885 61.04242692838316,10.733706544976634 61.087191773178674,10.826159192281194 61.09008335102362,10.832056292117722 61.045313200872585,10.739733314037885 61.04242692838316)))"
22750006775000,6,2,4,59,"MULTIPOLYGON(((10.832056292117722 61.045313200872585,10.826159192281194 61.09008335102362,10.918631076803203 61.092911761498364,10.92439841912666 61.04813642095303,10.832056292117722 61.045313200872585)))"
22950006775000,8,5,3,43.6,"MULTIPOLYGON(((11.201535515288112 61.056227515883,11.196157956209897 61.10101773677046,11.288702589507176 61.10359322863588,11.293950056963135 61.05879827826062,11.201535515288112 61.056227515883)))"
23000006775000,292,158,134,46.9,"MULTIPOLYGON(((11.293950056963135 61.05879827826062,11.288702589507176 61.10359322863588,11.381264357384948 61.106105431372136,11.386381654472244 61.061305866989336,11.293950056963135 61.05879827826062)))"
23050006775000,27,16,11,45.4,"MULTIPOLYGON(((11.386381654472244 61.061305866989336,11.381264357384948 61.106105431372136,11.473842837802898 61.1085543223134,11.478829887695118 61.06375025949998,11.386381654472244 61.061305866989336)))"
23100006775000,2,1,1,0,"MULTIPOLYGON(((11.478829887695118 61.06375025949998,11.473842837802898 61.1085543223134,11.566437608243785 61.1109398793578,11.571294336038163 61.06613143378504,11.478829887695118 61.06375025949998)))"
23150006775000,13,9,4,45.5,"MULTIPOLYGON(((11.571294336038163 61.06613143378504,11.566437608243785 61.1109398793578,11.65904824572522 61.113262080968006,11.663774578446203 61.068449368399165,11.571294336038163 61.06613143378504)))"
23350006775000,72,36,36,56.8,"MULTIPOLYGON(((11.94130585283191 61.07502352821129,11.936971123860504 61.119848346305254,12.02964099079221 61.12191692212369,12.03384505212851 61.07708830095835,11.94130585283191 61.07502352821129)))"
23400006775000,56,35,21,50.8,"MULTIPOLYGON(((12.03384505212851 61.07708830095835,12.02964099079221 61.12191692212369,12.12232460329063 61.12392204331604,12.126397933702794 61.079089735266436,12.03384505212851 61.07708830095835)))"
23450006775000,3,1,2,0,"MULTIPOLYGON(((12.126397933702794 61.079089735266436,12.12232460329063 61.12392204331604,12.215021535832093 61.12586369174762,12.218964073977839 61.08102781307843,12.126397933702794 61.079089735266436)))"
23600006775000,1,0,1,0,"MULTIPOLYGON(((12.404134434440827 61.08471382982131,12.400453657053152 61.12955650063743,12.493187992825241 61.131307627675724,12.496737805629088 61.08646173547529,12.404134434440827 61.08471382982131)))"
23650006775000,35,16,19,35.6,"MULTIPOLYGON(((12.496737805629088 61.08646173547529,12.493187992825241 61.131307627675724,12.585933942849516 61.13299521511461,12.589352737542715 61.088146218080546,12.496737805629088 61.08646173547529)))"
19400006780000,462,230,232,46.4,"MULTIPOLYGON(((4.694790893704694 60.75843223541972,4.680446308515932 60.80259781965385,4.770858426826893 60.809587597106805,4.785082736671564 60.765409436668584,4.694790893704694 60.75843223541972)))"
19450006780000,143,74,69,47.1,"MULTIPOLYGON(((4.785082736671564 60.765409436668584,4.770858426826893 60.809587597106805,4.861315944758316 60.81651696492156,4.875419777363407 60.772326331561054,4.785082736671564 60.765409436668584)))"
19500006780000,998,511,487,44.5,"MULTIPOLYGON(((4.875419777363407 60.772326331561054,4.861315944758316 60.81651696492156,4.951818499907455 60.823385863181635,4.965801654847906 60.77918286042561,4.875419777363407 60.772326331561054)))"
19550006780000,901,488,413,41.3,"MULTIPOLYGON(((4.965801654847906 60.77918286042561,4.951818499907455 60.823385863181635,5.042365728677447 60.83019423243893,5.056228007007327 60.78597896405743,4.965801654847906 60.77918286042561)))"
19650006780000,11,7,4,59,"MULTIPOLYGON(((5.146698470546241 60.79271458372032,5.132957266285046 60.83694201371571,5.223592746768483 60.8436291485064,5.237212680999299 60.79938966114857,5.146698470546241 60.79271458372032)))"
19700006780000,329,163,166,39.8,"MULTIPOLYGON(((5.237212680999299 60.79938966114857,5.223592746768483 60.8436291485064,5.31427180299539 60.85025557877945,5.327770272739132 60.80600413854874,5.237212680999299 60.79938966114857)))"
19750006780000,166,88,78,39,"MULTIPOLYGON(((5.327770272739132 60.80600413854874,5.31427180299539 60.85025557877945,5.404994066670764 60.85682124697925,5.418370878984261 60.81255795860155,5.327770272739132 60.80600413854874)))"
19850006780000,51,29,22,49.6,"MULTIPOLYGON(((5.509014131807143 60.81905106446376,5.495759168345077 60.86332609602788,5.586566737422376 60.86977006932703,5.599699662142241 60.82548339976983,5.509014131807143 60.81905106446376)))"
20100006780000,93,48,45,43.4,"MULTIPOLYGON(((5.962857137924072 60.85060392494582,5.950214236180684 60.8949360899474,6.041228543788947 60.90107485243463,6.053748480583505 60.85673157883661,5.962857137924072 60.85060392494582)))"
20500006780000,12,8,4,33.2,"MULTIPOLYGON(((6.691087815160895 60.89791146296609,6.679433598496057 60.942329501073566,6.77075901324145 60.94797716062317,6.782288865585291 60.903548872397025,6.691087815160895 60.89791146296609)))"
20550006780000,9,6,3,56.7,"MULTIPOLYGON(((6.782288865585291 60.903548872397025,6.77075901324145 60.94797716062317,6.862121591408245 60.953563203392115,6.873526911819873 60.909124773307695,6.782288865585291 60.903548872397025)))"
20700006780000,57,28,29,49.2,"MULTIPOLYGON(((7.056112450259647 60.92009185411405,7.044956689938252 60.964550242316605,7.136428433761167 60.96995114160548,7.147459169247167 60.925482937546846,7.056112450259647 60.92009185411405)))"
20750006780000,13,6,7,49,"MULTIPOLYGON(((7.147459169247167 60.925482937546846,7.136428433761167 60.96995114160548,7.22793578794364 60.97529023038358,7.238841337628147 60.930812319536706,7.147459169247167 60.925482937546846)))"
21700006780000,6,3,3,63,"MULTIPOLYGON(((8.889334185747105 61.016139214339205,8.880707556750822 61.060772982187096,8.97281621171233 61.064929303799296,8.981314923628958 61.02028793652533,8.889334185747105 61.016139214339205)))"
21750006780000,599,307,292,43,"MULTIPOLYGON(((8.981314923628958 61.02028793652533,8.97281621171233 61.064929303799296,9.06495248959465 61.06902297096699,9.073323158358296 61.02437411687962,8.981314923628958 61.02028793652533)))"
21800006780000,235,123,112,42,"MULTIPOLYGON(((9.073323158358296 61.02437411687962,9.06495248959465 61.06902297096699,9.15711598219073 61.07305394707395,9.165358483539427 61.02839771894072,9.073323158358296 61.02437411687962)))"
21850006780000,601,301,300,43.2,"MULTIPOLYGON(((9.165358483539427 61.02839771894072,9.15711598219073 61.07305394707395,9.249306280528895 61.077022196045164,9.257420492017834 61.03235870678615,9.165358483539427 61.02839771894072)))"
21900006780000,1,0,1,0,"MULTIPOLYGON(((9.257420492017834 61.03235870678615,9.249306280528895 61.077022196045164,9.341522974883642 61.08092768234793,9.349508775890909 61.036257045033594,9.257420492017834 61.03235870678615)))"
21950006780000,81,44,37,44,"MULTIPOLYGON(((9.349508775890909 61.036257045033594,9.341522974883642 61.08092768234793,9.433765654786502 61.084770370993,9.441622926518713 61.04009269884204,9.349508775890909 61.036257045033594)))"
22000006780000,53,32,21,47,"MULTIPOLYGON(((9.441622926518713 61.04009269884204,9.433765654786502 61.084770370993,9.526033909036924 61.088550227536,9.533762534534807 61.04386563391295,9.441622926518713 61.04009269884204)))"
22050006780000,37,16,21,43.9,"MULTIPOLYGON(((9.533762534534807 61.04386563391295,9.526033909036924 61.088550227536,9.618327325713237 61.09226721807832,9.625927189857103 61.04757581649149,9.533762534534807 61.04386563391295)))"
22250006780000,4,2,2,0,"MULTIPOLYGON(((9.902567328335554 61.058329519902436,9.895354420495346 61.103040662927974,9.987744353622142 61.10650586143965,9.9948280581324 61.061788365875145,9.902567328335554 61.058329519902436)))"
22450006780000,249,126,123,40.6,"MULTIPOLYGON(((10.271746509576525 61.0717873040299,10.265051042621607 61.11652317153638,10.357530846643275 61.11973607960314,10.364096698143545 61.0749943171002,10.271746509576525 61.0717873040299)))"
22500006780000,2133,1055,1078,39.1,"MULTIPOLYGON(((10.364096698143545 61.0749943171002,10.357530846643275 61.11973607960314,10.450032075176587 61.1228858413311,10.456468212892286 61.07813829853101,10.364096698143545 61.0749943171002)))"
22550006780000,13854,6654,7200,42.4,"MULTIPOLYGON(((10.456468212892286 61.07813829853101,10.450032075176587 61.1228858413311,10.542554309701696 61.12597242834094,10.548860637192846 61.08121922006383,10.456468212892286 61.07813829853101)))"
22600006780000,224,118,106,40.2,"MULTIPOLYGON(((10.548860637192846 61.08121922006383,10.542554309701696 61.12597242834094,10.635097131101263 61.12899581281086,10.641273553822403 61.084237053995416,10.548860637192846 61.08121922006383)))"
22650006780000,565,275,290,42.4,"MULTIPOLYGON(((10.641273553822403 61.084237053995416,10.635097131101263 61.12899581281086,10.727660119671967 61.13195596747762,10.733706544976634 61.087191773178674,10.641273553822403 61.084237053995416)))"
22700006780000,15,9,6,38.9,"MULTIPOLYGON(((10.733706544976634 61.087191773178674,10.727660119671967 61.13195596747762,10.820242855136055 61.1348528656374,10.826159192281194 61.09008335102362,10.733706544976634 61.087191773178674)))"
22950006780000,24,12,12,29.9,"MULTIPOLYGON(((11.196157956209897 61.10101773677046,11.190762840916175 61.14580737876182,11.283437987389277 61.14838761347323,11.288702589507176 61.10359322863588,11.196157956209897 61.10101773677046)))"
23000006780000,2608,1353,1255,41.4,"MULTIPOLYGON(((11.288702589507176 61.10359322863588,11.283437987389277 61.14838761347323,11.376130347677979 61.1509044432532,11.381264357384948 61.106105431372136,11.288702589507176 61.10359322863588)))"
23050006780000,219,130,89,38.7,"MULTIPOLYGON(((11.381264357384948 61.106105431372136,11.376130347677979 61.1509044432532,11.46883949781022 61.153357845338604,11.473842837802898 61.1085543223134,11.381264357384948 61.106105431372136)))"
23100006780000,12,7,5,44.1,"MULTIPOLYGON(((11.473842837802898 61.1085543223134,11.46883949781022 61.153357845338604,11.561565013333311 61.15574779753264,11.566437608243785 61.1109398793578,11.473842837802898 61.1085543223134)))"
23150006780000,13,8,5,58.5,"MULTIPOLYGON(((11.566437608243785 61.1109398793578,11.561565013333311 61.15574779753264,11.654306469325808 61.15807427820554,11.65904824572522 61.113262080968006,11.566437608243785 61.1109398793578)))"
23300006780000,7,4,3,49.3,"MULTIPOLYGON(((11.844315427625496 61.11771633456419,11.839835500761119 61.16253674130812,11.932622224124787 61.16467268331991,11.936971123860504 61.119848346305254,11.844315427625496 61.11771633456419)))"
23350006780000,85,41,44,49.9,"MULTIPOLYGON(((11.936971123860504 61.119848346305254,11.932622224124787 61.16467268331991,12.025423183823582 61.16674507297615,12.02964099079221 61.12191692212369,11.936971123860504 61.119848346305254)))"
23400006780000,198,103,95,48.8,"MULTIPOLYGON(((12.02964099079221 61.12191692212369,12.025423183823582 61.16674507297615,12.118237952771814 61.16875389149287,12.12232460329063 61.12392204331604,12.02964099079221 61.12191692212369)))"
23450006780000,17,9,8,31.9,"MULTIPOLYGON(((12.12232460329063 61.12392204331604,12.118237952771814 61.16875389149287,12.211066103487042 61.170699120657396,12.215021535832093 61.12586369174762,12.12232460329063 61.12392204331604)))"
23550006780000,4,3,1,0,"MULTIPOLYGON(((12.307731362511259 61.12774184985318,12.303907208102197 61.17258074282887,12.396760838377705 61.17439874093886,12.400453657053152 61.12955650063743,12.307731362511259 61.12774184985318)))"
23600006780000,12,6,6,44.6,"MULTIPOLYGON(((12.400453657053152 61.12955650063743,12.396760838377705 61.17439874093886,12.48962656571365 61.17615309849197,12.493187992825241 61.131307627675724,12.400453657053152 61.12955650063743)))"
23650006780000,70,42,28,54.2,"MULTIPOLYGON(((12.493187992825241 61.131307627675724,12.48962656571365 61.17615309849197,12.582503961161958 61.17784379956648,12.585933942849516 61.13299521511461,12.493187992825241 61.131307627675724)))"
23750006780000,13,8,5,55.3,"MULTIPOLYGON(((12.678691079814618 61.13461924767227,12.675392595438613 61.17947082881473,12.76829203893588 61.18103417146382,12.77145897608797 61.136179710639176,12.678691079814618 61.13461924767227)))"
19450006785000,4,3,1,0,"MULTIPOLYGON(((4.770858426826893 60.809587597106805,4.756588717161453 60.85376348325963,4.847167074736471 60.860705357849646,4.861315944758316 60.81651696492156,4.770858426826893 60.809587597106805)))"
19500006785000,5,2,3,70.2,"MULTIPOLYGON(((4.861315944758316 60.81651696492156,4.847167074736471 60.860705357849646,4.937790671148418 60.86758665910624,4.951818499907455 60.823385863181635,4.861315944758316 60.81651696492156)))"
19550006785000,44,24,20,42.3,"MULTIPOLYGON(((4.951818499907455 60.823385863181635,4.937790671148418 60.86758665910624,5.028459141313525 60.874407327336684,5.042365728677447 60.83019423243893,4.951818499907455 60.823385863181635)))"
19600006785000,189,94,95,35,"MULTIPOLYGON(((5.042365728677447 60.83019423243893,5.028459141313525 60.874407327336684,5.119172118952898 60.88116730332029,5.132957266285046 60.83694201371571,5.042365728677447 60.83019423243893)))"
19650006785000,228,122,106,47.7,"MULTIPOLYGON(((5.132957266285046 60.83694201371571,5.119172118952898 60.88116730332029,5.209929236600429 60.8878665283103,5.223592746768483 60.8436291485064,5.132957266285046 60.83694201371571)))"
19700006785000,74,36,38,54.3,"MULTIPOLYGON(((5.223592746768483 60.8436291485064,5.209929236600429 60.8878665283103,5.300730125610739 60.89450494403569,5.31427180299539 60.85025557877945,5.223592746768483 60.8436291485064)))"
19750006785000,24,10,14,43.4,"MULTIPOLYGON(((5.31427180299539 60.85025557877945,5.300730125610739 60.89450494403569,5.391574416167261 60.90108249270312,5.404994066670764 60.85682124697925,5.31427180299539 60.85025557877945)))"
19800006785000,58,29,29,51,"MULTIPOLYGON(((5.404994066670764 60.85682124697925,5.391574416167261 60.90108249270312,5.482461737290313 60.90759911699875,5.495759168345077 60.86332609602788,5.404994066670764 60.85682124697925)))"
19850006785000,226,120,106,45.6,"MULTIPOLYGON(((5.495759168345077 60.86332609602788,5.482461737290313 60.90759911699875,5.573391716845324 60.91405476009007,5.586566737422376 60.86977006932703,5.495759168345077 60.86332609602788)))"
19900006785000,23,11,12,39.1,"MULTIPOLYGON(((5.586566737422376 60.86977006932703,5.573391716845324 60.91405476009007,5.664363981551099 60.9204493656277,5.677416402168535 60.876153110759695,5.586566737422376 60.86977006932703)))"
20100006785000,1,1,0,0,"MULTIPOLYGON(((5.950214236180684 60.8949360899474,5.937530736737246 60.93926640071053,6.028668386595026 60.94541630226644,6.041228543788947 60.90107485243463,5.950214236180684 60.8949360899474)))"
20600006785000,1,1,0,0,"MULTIPOLYGON(((6.862121591408245 60.953563203392115,6.850679494172858 60.99800007169528,6.942203934662263 61.00353450960618,6.95352094623107 60.95908758018581,6.862121591408245 60.953563203392115)))"
21000006785000,72,38,34,47.5,"MULTIPOLYGON(((7.594313479114648 60.99602754495507,7.583876601339652 61.04054184043483,7.675682487854744 61.045580363567794,7.685993004855851 61.00105688411191,7.594313479114648 60.99602754495507)))"
21050006785000,2,1,1,0,"MULTIPOLYGON(((7.685993004855851 61.00105688411191,7.675682487854744 61.045580363567794,7.7675217776898 61.05055669046802,7.777705782216793 61.0060241375455,7.685993004855851 61.00105688411191)))"
21100006785000,59,35,24,42,"MULTIPOLYGON(((7.777705782216793 61.0060241375455,7.7675217776898 61.05055669046802,7.85939407271286 61.055470776895284,7.869451414797648 61.010929261201355,7.777705782216793 61.0060241375455)))"
21650006785000,1,1,0,0,"MULTIPOLYGON(((8.788626932141836 61.05655404328639,8.779844076813758 61.10117905908589,8.872052897271013 61.105405731451484,8.880707556750822 61.060772982187096,8.788626932141836 61.05655404328639)))"
21700006785000,82,38,44,41.8,"MULTIPOLYGON(((8.880707556750822 61.060772982187096,8.872052897271013 61.105405731451484,8.96428987674565 61.10956967376928,8.97281621171233 61.064929303799296,8.880707556750822 61.060772982187096)))"
21750006785000,581,279,302,45.6,"MULTIPOLYGON(((8.97281621171233 61.064929303799296,8.96428987674565 61.10956967376928,9.0565546059898 61.11367084872529,9.06495248959465 61.06902297096699,8.97281621171233 61.064929303799296)))"
21800006785000,637,334,303,41.4,"MULTIPOLYGON(((9.06495248959465 61.06902297096699,9.0565546059898 61.11367084872529,9.148846674974306 61.11770921954762,9.15711598219073 61.07305394707395,9.06495248959465 61.06902297096699)))"
21850006785000,27,14,13,42.3,"MULTIPOLYGON(((9.15711598219073 61.07305394707395,9.148846674974306 61.11770921954762,9.241165672899536 61.121684750007724,9.249306280528895 61.077022196045164,9.15711598219073 61.07305394707395)))"
22100006785000,2,1,1,0,"MULTIPOLYGON(((9.618327325713237 61.09226721807832,9.610702711658757 61.136957762739776,9.703150166090586 61.14061856706214,9.710645492183648 61.09592130926843,9.618327325713237 61.09226721807832)))"
22200006785000,6,2,4,54.2,"MULTIPOLYGON(((9.802987995117295 61.09951246830302,9.795622069097996 61.14421632512855,9.888118004795446 61.14775100454722,9.895354420495346 61.103040662927974,9.802987995117295 61.09951246830302)))"
22250006785000,3,1,2,0,"MULTIPOLYGON(((9.895354420495346 61.103040662927974,9.888118004795446 61.14775100454722,9.980637556615347 61.151222573479,9.987744353622142 61.10650586143965,9.895354420495346 61.103040662927974)))"
22350006785000,54,25,29,46.6,"MULTIPOLYGON(((10.08015737913641 61.10990803268581,10.073180307319374 61.15463100063853,10.165745839009777 61.157976255295274,10.172593081022482 61.11324714606676,10.08015737913641 61.10990803268581)))"
22400006785000,167,89,78,40.6,"MULTIPOLYGON(((10.172593081022482 61.11324714606676,10.165745839009777 61.157976255295274,10.25833373314075 61.16125830727456,10.265051042621607 61.11652317153638,10.172593081022482 61.11324714606676)))"
22450006785000,101,58,43,46,"MULTIPOLYGON(((10.265051042621607 61.11652317153638,10.25833373314075 61.16125830727456,10.350943570529859 61.16447712695864,10.357530846643275 61.11973607960314,10.265051042621607 61.11652317153638)))"
22500006785000,3087,1555,1532,41.3,"MULTIPOLYGON(((10.357530846643275 61.11973607960314,10.350943570529859 61.16447712695864,10.443574931369502 61.16763268528769,10.450032075176587 61.1228858413311,10.357530846643275 61.11973607960314)))"
22550006785000,6288,2972,3316,44.1,"MULTIPOLYGON(((10.450032075176587 61.1228858413311,10.443574931369502 61.16763268528769,10.536227395238418 61.17072495376082,10.542554309701696 61.12597242834094,10.450032075176587 61.1228858413311)))"
22600006785000,17,10,7,52.2,"MULTIPOLYGON(((10.542554309701696 61.12597242834094,10.536227395238418 61.17072495376082,10.628900541113248 61.173753904437,10.635097131101263 61.12899581281086,10.542554309701696 61.12597242834094)))"
22650006785000,49,31,18,49.3,"MULTIPOLYGON(((10.635097131101263 61.12899581281086,10.628900541113248 61.173753904437,10.721593947380109 61.176719509936106,10.727660119671967 61.13195596747762,10.635097131101263 61.12899581281086)))"
22750006785000,1,1,0,0,"MULTIPOLYGON(((10.820242855136055 61.1348528656374,10.814307191846256 61.17962174343979,10.907039851751742 61.18246057869245,10.912844916652928 61.137686481146716,10.820242855136055 61.1348528656374)))"
22950006785000,2,1,1,0,"MULTIPOLYGON(((11.190762840916175 61.14580737876182,11.185350088243226 61.19059644084774,11.278156171373691 61.19318143182581,11.283437987389277 61.14838761347323,11.190762840916175 61.14580737876182)))"
23000006785000,146,73,73,43.6,"MULTIPOLYGON(((11.283437987389277 61.14838761347323,11.278156171373691 61.19318143182581,11.370979548047362 61.195702901746614,11.376130347677979 61.1509044432532,11.283437987389277 61.14838761347323)))"
23050006785000,158,78,80,46,"MULTIPOLYGON(((11.376130347677979 61.1509044432532,11.370979548047362 61.195702901746614,11.46381979234857 61.1981608277492,11.46883949781022 61.153357845338604,11.376130347677979 61.1509044432532)))"
23100006785000,52,27,25,46.6,"MULTIPOLYGON(((11.46883949781022 61.153357845338604,11.46381979234857 61.1981608277492,11.55667647787729 61.200555187541255,11.561565013333311 61.15574779753264,11.46883949781022 61.153357845338604)))"
23150006785000,5,2,3,75.8,"MULTIPOLYGON(((11.561565013333311 61.15574779753264,11.55667647787729 61.200555187541255,11.649549177761106 61.20288595939995,11.654306469325808 61.15807427820554,11.561565013333311 61.15574779753264)))"
23300006785000,47,28,19,52.3,"MULTIPOLYGON(((11.839835500761119 61.16253674130812,11.835340910814589 61.20735665527734,11.928259087985802 61.209496538704094,11.932622224124787 61.16467268331991,11.839835500761119 61.16253674130812)))"
23350006785000,9,7,2,47.1,"MULTIPOLYGON(((11.932622224124787 61.16467268331991,11.928259087985802 61.209496538704094,12.021191567539395 61.21157275301501,12.025423183823582 61.16674507297615,11.932622224124787 61.16467268331991)))"
23400006785000,2,2,0,0,"MULTIPOLYGON(((12.025423183823582 61.16674507297615,12.021191567539395 61.21157275301501,12.114137920421891 61.21358527934523,12.118237952771814 61.16875389149287,12.025423183823582 61.16674507297615)))"
23450006785000,34,20,14,49.7,"MULTIPOLYGON(((12.118237952771814 61.16875389149287,12.114137920421891 61.21358527934523,12.207097717179977 61.21553409940355,12.211066103487042 61.170699120657396,12.118237952771814 61.16875389149287)))"
23550006785000,5,3,2,56,"MULTIPOLYGON(((12.303907208102197 61.17258074282887,12.300070527972723 61.21741919547307,12.393055922583791 61.21924055041176,12.396760838377705 61.17439874093886,12.303907208102197 61.17258074282887)))"
23600006785000,86,43,43,48.9,"MULTIPOLYGON(((12.396760838377705 61.17439874093886,12.393055922583791 61.21924055041176,12.486053470433701 61.22099814765306,12.48962656571365 61.17615309849197,12.396760838377705 61.17439874093886)))"
23650006785000,38,21,17,44.8,"MULTIPOLYGON(((12.48962656571365 61.17615309849197,12.486053470433701 61.22099814765306,12.579062740592102 61.22269197120657,12.582503961161958 61.17784379956648,12.48962656571365 61.17615309849197)))"
23700006785000,9,4,5,49.6,"MULTIPOLYGON(((12.582503961161958 61.17784379956648,12.579062740592102 61.22269197120657,12.672083301790082 61.224322005658394,12.675392595438613 61.17947082881473,12.582503961161958 61.17784379956648)))"
19450006790000,73,37,36,50.6,"MULTIPOLYGON(((4.756588717161453 60.85376348325963,4.742273404576455 60.89793708637116,4.832972965677205 60.90489150174009,4.847167074736471 60.860705357849646,4.756588717161453 60.85376348325963)))"
19500006790000,219,106,113,44.8,"MULTIPOLYGON(((4.847167074736471 60.860705357849646,4.832972965677205 60.90489150174009,4.923717968437043 60.91178523974395,4.937790671148418 60.86758665910624,4.847167074736471 60.860705357849646)))"
19550006790000,72,42,30,45.4,"MULTIPOLYGON(((4.937790671148418 60.86758665910624,4.923717968437043 60.91178523974395,5.014508046277472 60.918618240443976,5.028459141313525 60.874407327336684,4.937790671148418 60.86758665910624)))"
19600006790000,67,34,33,46.4,"MULTIPOLYGON(((5.028459141313525 60.874407327336684,5.014508046277472 60.918618240443976,5.105342831416067 60.92539044437515,5.119172118952898 60.88116730332029,5.028459141313525 60.874407327336684)))"
19650006790000,45,25,20,46.3,"MULTIPOLYGON(((5.119172118952898 60.88116730332029,5.105342831416067 60.92539044437515,5.196221954874387 60.93210179254814,5.209929236600429 60.8878665283103,5.119172118952898 60.88116730332029)))"
19700006790000,17,8,9,52.8,"MULTIPOLYGON(((5.209929236600429 60.8878665283103,5.196221954874387 60.93210179254814,5.287145046486045 60.93875222645109,5.300730125610739 60.89450494403569,5.209929236600429 60.8878665283103)))"
19750006790000,28,17,11,42.9,"MULTIPOLYGON(((5.300730125610739 60.89450494403569,5.287145046486045 60.93875222645109,5.378111734904742 60.94534168805162,5.391574416167261 60.90108249270312,5.300730125610739 60.89450494403569)))"
19800006790000,10,5,5,70.4,"MULTIPOLYGON(((5.391574416167261 60.90108249270312,5.378111734904742 60.94534168805162,5.469121647612488 60.95187011979855,5.482461737290313 60.90759911699875,5.391574416167261 60.90108249270312)))"
19850006790000,50,26,24,41.6,"MULTIPOLYGON(((5.482461737290313 60.90759911699875,5.469121647612488 60.95187011979855,5.560174410927805 60.958337464623874,5.573391716845324 60.91405476009007,5.482461737290313 60.90759911699875)))"
20300006790000,24,7,17,56.5,"MULTIPOLYGON(((6.302322226188476 60.96349792183895,6.290093920262088 61.00787040676126,6.381515335585649 61.01378548184657,6.39361919916897 60.96940225694257,6.302322226188476 60.96349792183895)))"
20350006790000,57,31,26,46.2,"MULTIPOLYGON(((6.39361919916897 60.96940225694257,6.381515335585649 61.01378548184657,6.472975802579045 61.01963892630001,6.484955047572059 60.97524506938562,6.39361919916897 60.96940225694257)))"
20650006790000,5,3,2,47.8,"MULTIPOLYGON(((6.942203934662263 61.00353450960618,6.930850368741189 61.047979899545446,7.022537004827202 61.05346249357932,7.033764929336534 61.00900712390467,6.942203934662263 61.00353450960618)))"
20950006790000,218,113,105,43.5,"MULTIPOLYGON(((7.49210451534969 61.035441165832374,7.481507233274837 61.07994478865918,7.57340592288341 61.08505478340694,7.583876601339652 61.04054184043483,7.49210451534969 61.035441165832374)))"
21000006790000,227,117,110,44.6,"MULTIPOLYGON(((7.583876601339652 61.04054184043483,7.57340592288341 61.08505478340694,7.665338567379219 61.090102516072974,7.675682487854744 61.045580363567794,7.583876601339652 61.04054184043483)))"
21050006790000,12,8,4,45,"MULTIPOLYGON(((7.675682487854744 61.045580363567794,7.665338567379219 61.090102516072974,7.757304767822001 61.09508794170511,7.7675217776898 61.05055669046802,7.675682487854744 61.045580363567794)))"
21100006790000,78,39,39,39.8,"MULTIPOLYGON(((7.7675217776898 61.05055669046802,7.757304767822001 61.09508794170511,7.849304124337682 61.100011015876206,7.85939407271286 61.055470776895284,7.7675217776898 61.05055669046802)))"
21150006790000,124,64,60,44.8,"MULTIPOLYGON(((7.85939407271286 61.055470776895284,7.849304124337682 61.100011015876206,7.941336236128436 61.1048716946856,7.951298973875202 61.06032257913368,7.85939407271286 61.055470776895284)))"
21200006790000,10,5,5,60.6,"MULTIPOLYGON(((7.951298973875202 61.06032257913368,7.941336236128436 61.1048716946856,8.033400701482835 61.10966993476061,8.043236081221375 61.065112053993204,7.951298973875202 61.06032257913368)))"
21250006790000,5,4,1,29.4,"MULTIPOLYGON(((8.043236081221375 61.065112053993204,8.033400701482835 61.10966993476061,8.125497117786031 61.11440569325792,8.135204993899336 61.06983915881112,8.043236081221375 61.065112053993204)))"
21500006790000,397,194,203,40.7,"MULTIPOLYGON(((8.503390650079748 61.088123042946854,8.494194209146615 61.132723073213995,8.586444310073192 61.13714579980263,8.595512545971816 61.09253767617008,8.503390650079748 61.088123042946854)))"
21550006790000,180,93,87,41.9,"MULTIPOLYGON(((8.595512545971816 61.09253767617008,8.586444310073192 61.13714579980263,8.67872392786659 61.14150579895078,8.687663823829686 61.0968896945273,8.595512545971816 61.09253767617008)))"
21650006790000,443,237,206,44.8,"MULTIPOLYGON(((8.779844076813758 61.10117905908589,8.77103265387871 61.1458030315604,8.863370078641815 61.150037459073786,8.872052897271013 61.105405731451484,8.779844076813758 61.10117905908589)))"
21700006790000,350,179,171,44.9,"MULTIPOLYGON(((8.872052897271013 61.105405731451484,8.863370078641815 61.150037459073786,8.95573579187924 61.154209043475106,8.96428987674565 61.10956967376928,8.872052897271013 61.105405731451484)))"
21750006790000,182,99,83,45.6,"MULTIPOLYGON(((8.96428987674565 61.10956967376928,8.95573579187924 61.154209043475106,9.048129382516187 61.158317747291484,9.0565546059898 61.11367084872529,8.96428987674565 61.10956967376928)))"
21800006790000,778,367,411,47.2,"MULTIPOLYGON(((9.0565546059898 61.11367084872529,9.048129382516187 61.158317747291484,9.140550438690568 61.1623635335944,9.148846674974306 61.11770921954762,9.0565546059898 61.11367084872529)))"
21850006790000,3,2,1,0,"MULTIPOLYGON(((9.148846674974306 61.11770921954762,9.140550438690568 61.1623635335944,9.23299854776392 61.166346366000845,9.241165672899536 61.121684750007724,9.148846674974306 61.11770921954762)))"
22300006790000,1,1,0,0,"MULTIPOLYGON(((9.980637556615347 61.151222573479,9.973507560614522 61.19593850002538,10.066180454407963 61.199353200747346,10.073180307319374 61.15463100063853,9.980637556615347 61.151222573479)))"
22350006790000,516,265,251,47.8,"MULTIPOLYGON(((10.073180307319374 61.15463100063853,10.066180454407963 61.199353200747346,10.1588762344504 61.202704614012816,10.165745839009777 61.157976255295274,10.073180307319374 61.15463100063853)))"
22400006790000,55,28,27,46.9,"MULTIPOLYGON(((10.165745839009777 61.157976255295274,10.1588762344504 61.202704614012816,10.251594480297564 61.20599270951782,10.25833373314075 61.16125830727456,10.165745839009777 61.157976255295274)))"
22450006790000,646,340,306,41.1,"MULTIPOLYGON(((10.25833373314075 61.16125830727456,10.251594480297564 61.20599270951782,10.344334770863636 61.20921745751762,10.350943570529859 61.16447712695864,10.25833373314075 61.16125830727456)))"
22500006790000,803,426,377,42,"MULTIPOLYGON(((10.350943570529859 61.16447712695864,10.344334770863636 61.20921745751762,10.437096684432795 61.21237882882779,10.443574931369502 61.16763268528769,10.350943570529859 61.16447712695864)))"
22550006790000,61,28,33,38.1,"MULTIPOLYGON(((10.443574931369502 61.16763268528769,10.437096684432795 61.21237882882779,10.529879798670818 61.2154767948251,10.536227395238418 61.17072495376082,10.443574931369502 61.16763268528769)))"
22600006790000,21,10,11,40.1,"MULTIPOLYGON(((10.536227395238418 61.17072495376082,10.529879798670818 61.2154767948251,10.622683690636721 61.21851132744865,10.628900541113248 61.173753904437,10.536227395238418 61.17072495376082)))"
23000006790000,67,38,29,53.2,"MULTIPOLYGON(((11.278156171373691 61.19318143182581,11.272857061732186 61.23797468273966,11.365811880708481 61.24050080595986,11.370979548047362 61.195702901746614,11.278156171373691 61.19318143182581)))"
23100006790000,16,7,9,41.6,"MULTIPOLYGON(((11.46381979234857 61.1981608277492,11.45878364558068 61.24296326871255,11.551771927989442 61.24536204860939,11.55667647787729 61.200555187541255,11.46381979234857 61.1981608277492)))"
23200006790000,3,1,2,0,"MULTIPOLYGON(((11.649549177761106 61.20288595939995,11.644776299099362 61.24769712383387,11.737796329611104 61.24996847314215,11.74243746466724 61.20515312217256,11.649549177761106 61.20288595939995)))"
23250006790000,19,8,11,67.5,"MULTIPOLYGON(((11.74243746466724 61.20515312217256,11.737796329611104 61.24996847314215,11.830831589773506 61.25217607586366,11.835340910814589 61.20735665527734,11.74243746466724 61.20515312217256)))"
23300006790000,40,19,21,57.3,"MULTIPOLYGON(((11.835340910814589 61.20735665527734,11.830831589773506 61.25217607586366,11.923881649395772 61.254319911901945,11.928259087985802 61.209496538704094,11.835340910814589 61.20735665527734)))"
23350006790000,23,11,12,49.7,"MULTIPOLYGON(((11.928259087985802 61.209496538704094,11.923881649395772 61.254319911901945,12.016946077859673 61.25639996173526,12.021191567539395 61.21157275301501,11.928259087985802 61.209496538704094)))"
23400006790000,120,61,59,51.4,"MULTIPOLYGON(((12.021191567539395 61.21157275301501,12.016946077859673 61.25639996173526,12.11002444413177 61.258416206417394,12.114137920421891 61.21358527934523,12.021191567539395 61.21157275301501)))"
23450006790000,10,8,2,48.9,"MULTIPOLYGON(((12.114137920421891 61.21358527934523,12.11002444413177 61.258416206417394,12.203116316775686 61.26036862757813,12.207097717179977 61.21553409940355,12.114137920421891 61.21358527934523)))"
23500006790000,87,47,40,52.3,"MULTIPOLYGON(((12.207097717179977 61.21553409940355,12.203116316775686 61.26036862757813,12.2962212639644 61.26225720742406,12.300070527972723 61.21741919547307,12.207097717179977 61.21553409940355)))"
23550006790000,376,198,178,41.5,"MULTIPOLYGON(((12.300070527972723 61.21741919547307,12.2962212639644 61.26225720742406,12.389338853492559 61.26408192873909,12.393055922583791 61.21924055041176,12.300070527972723 61.21741919547307)))"
23600006790000,11,6,5,39.4,"MULTIPOLYGON(((12.393055922583791 61.21924055041176,12.389338853492559 61.26408192873909,12.482468652788835 61.265842774885144,12.486053470433701 61.22099814765306,12.393055922583791 61.21924055041176)))"
23650006790000,254,138,116,47.1,"MULTIPOLYGON(((12.486053470433701 61.22099814765306,12.482468652788835 61.265842774885144,12.575610228928296 61.26753972980263,12.579062740592102 61.22269197120657,12.486053470433701 61.22099814765306)))"
23700006790000,41,20,21,57.3,"MULTIPOLYGON(((12.579062740592102 61.22269197120657,12.575610228928296 61.26753972980263,12.668763148644807 61.26917277801109,12.672083301790082 61.224322005658394,12.579062740592102 61.22269197120657)))"
23750006790000,10,8,2,47.4,"MULTIPOLYGON(((12.672083301790082 61.224322005658394,12.668763148644807 61.26917277801109,12.761926978343451 61.27074190460971,12.765114722432495 61.22588823617187,12.672083301790082 61.224322005658394)))"
23800006790000,19,10,9,60.9,"MULTIPOLYGON(((12.765114722432495 61.22588823617187,12.761926978343451 61.27074190460971,12.855101284112992 61.27224709527784,12.858156570610316 61.22739064848803,12.765114722432495 61.22588823617187)))"
19450006795000,12,6,6,51.8,"MULTIPOLYGON(((4.742273404576455 60.89793708637116,4.727912284762398 60.94210839763184,4.818733414756881 60.94907538793493,4.832972965677205 60.90489150174009,4.742273404576455 60.89793708637116)))"
19500006795000,89,41,48,45.2,"MULTIPOLYGON(((4.832972965677205 60.90489150174009,4.818733414756881 60.94907538793493,4.909600190444412 60.9559815965874,4.923717968437043 60.91178523974395,4.832972965677205 60.90489150174009)))"
19550006795000,18,9,9,36.4,"MULTIPOLYGON(((4.923717968437043 60.91178523974395,4.909600190444412 60.9559815965874,5.000512243743924 60.96282696340305,5.014508046277472 60.918618240443976,4.923717968437043 60.91178523974395)))"
19600006795000,19,10,9,50.8,"MULTIPOLYGON(((5.014508046277472 60.918618240443976,5.000512243743924 60.96282696340305,5.091469205361486 60.9696114286712,5.105342831416067 60.92539044437515,5.014508046277472 60.918618240443976)))"
19650006795000,160,85,75,44.5,"MULTIPOLYGON(((5.105342831416067 60.92539044437515,5.091469205361486 60.9696114286712,5.182470704798361 60.976334933158476,5.196221954874387 60.93210179254814,5.105342831416067 60.92539044437515)))"
19700006795000,38,16,22,51.1,"MULTIPOLYGON(((5.196221954874387 60.93210179254814,5.182470704798361 60.976334933158476,5.273516370359009 60.98299741811089,5.287145046486045 60.93875222645109,5.196221954874387 60.93210179254814)))"
19750006795000,2,1,1,0,"MULTIPOLYGON(((5.287145046486045 60.93875222645109,5.273516370359009 60.98299741811089,5.364605829159265 60.989598825255555,5.378111734904742 60.94534168805162,5.287145046486045 60.93875222645109)))"
19800006795000,14,8,6,58.6,"MULTIPOLYGON(((5.378111734904742 60.94534168805162,5.364605829159265 60.989598825255555,5.455738707134562 60.9961390968027,5.469121647612488 60.95187011979855,5.378111734904742 60.94534168805162)))"
19850006795000,5,3,2,68,"MULTIPOLYGON(((5.469121647612488 60.95187011979855,5.455738707134562 60.9961390968027,5.546914629048198 61.00261817544743,5.560174410927805 60.958337464623874,5.469121647612488 60.95187011979855)))"
20300006795000,20,11,9,40.4,"MULTIPOLYGON(((6.290093920262088 61.00787040676126,6.277826177640203 61.05224114501142,6.369372420154499 61.058166989733074,6.381515335585649 61.01378548184657,6.290093920262088 61.00787040676126)))"
20350006795000,22,12,10,52,"MULTIPOLYGON(((6.381515335585649 61.01378548184657,6.369372420154499 61.058166989733074,6.460957891653749 61.06403109557509,6.472975802579045 61.01963892630001,6.381515335585649 61.01378548184657)))"
20400006795000,88,46,42,51.5,"MULTIPOLYGON(((6.472975802579045 61.01963892630001,6.460957891653749 61.06403109557509,6.552582204577276 61.06983341068602,6.564474935328268 61.025430688486445,6.472975802579045 61.01963892630001)))"
20450006795000,236,122,114,46.3,"MULTIPOLYGON(((6.564474935328268 61.025430688486445,6.552582204577276 61.06983341068602,6.64424497029772 61.07557388372075,6.656012346860564 61.03116071727504,6.564474935328268 61.025430688486445)))"
20500006795000,9,6,3,37.8,"MULTIPOLYGON(((6.656012346860564 61.03116071727504,6.64424497029772 61.07557388372075,6.735945799130294 61.08125246384205,6.747587649153657 61.03682896204094,6.656012346860564 61.03116071727504)))"
20600006795000,59,33,26,42.8,"MULTIPOLYGON(((6.839200453145016 61.042435372667036,6.827684300342109 61.08686910072242,6.919460082161592 61.09242374454556,6.930850368741189 61.047979899545446,6.839200453145016 61.042435372667036)))"
20650006795000,138,69,69,45.8,"MULTIPOLYGON(((6.930850368741189 61.047979899545446,6.919460082161592 61.09242374454556,7.011272751787945 61.097916346008226,7.022537004827202 61.05346249357932,6.930850368741189 61.047979899545446)))"
20700006795000,5,3,2,61,"MULTIPOLYGON(((7.022537004827202 61.05346249357932,7.011272751787945 61.097916346008226,7.103121915400688 61.10334685632168,7.114259969276053 61.058883106184325,7.022537004827202 61.05346249357932)))"
20750006795000,3,1,2,0,"MULTIPOLYGON(((7.114259969276053 61.058883106184325,7.103121915400688 61.10334685632168,7.195007178169281 61.10871522721335,7.206018868958244 61.06424168929034,7.114259969276053 61.058883106184325)))"
20900006795000,70,38,32,45.2,"MULTIPOLYGON(((7.389642896549942 61.074772577305325,7.378884416859606 61.119265360231935,7.470875598157338 61.124447028409136,7.481507233274837 61.07994478865918,7.389642896549942 61.074772577305325)))"
20950006795000,1218,619,599,44.2,"MULTIPOLYGON(((7.481507233274837 61.07994478865918,7.470875598157338 61.124447028409136,7.562901289382622 61.12956636926828,7.57340592288341 61.08505478340694,7.481507233274837 61.07994478865918)))"
21400006795000,13,8,5,36.1,"MULTIPOLYGON(((8.309784188323976 61.12368959680202,8.300301011296902 61.168271943306664,8.392619191836863 61.17282834663624,8.401974032904603 61.12823765882214,8.309784188323976 61.12368959680202)))"
21450006795000,63,32,31,36.9,"MULTIPOLYGON(((8.401974032904603 61.12823765882214,8.392619191836863 61.17282834663624,8.484967843388743 61.17732198979919,8.494194209146615 61.132723073213995,8.401974032904603 61.12823765882214)))"
21500006795000,32,17,15,54.3,"MULTIPOLYGON(((8.494194209146615 61.132723073213995,8.484967843388743 61.17732198979919,8.577346557169362 61.18175283244966,8.586444310073192 61.13714579980263,8.494194209146615 61.132723073213995)))"
21550006795000,90,48,42,44.9,"MULTIPOLYGON(((8.586444310073192 61.13714579980263,8.577346557169362 61.18175283244966,8.669754923548151 61.18612083478182,8.67872392786659 61.14150579895078,8.586444310073192 61.13714579980263)))"
21600006795000,289,149,140,47.5,"MULTIPOLYGON(((8.67872392786659 61.14150579895078,8.669754923548151 61.18612083478182,8.762192532057853 61.190425957531076,8.77103265387871 61.1458030315604,8.67872392786659 61.14150579895078)))"
21650006795000,100,58,42,44.4,"MULTIPOLYGON(((8.77103265387871 61.1458030315604,8.762192532057853 61.190425957531076,8.854658971405273 61.19466816197557,8.863370078641815 61.150037459073786,8.77103265387871 61.1458030315604)))"
21700006795000,60,35,25,40.6,"MULTIPOLYGON(((8.863370078641815 61.150037459073786,8.854658971405273 61.19466816197557,8.947153829482092 61.19884740993737,8.95573579187924 61.154209043475106,8.863370078641815 61.150037459073786)))"
21750006795000,318,166,152,40.8,"MULTIPOLYGON(((8.95573579187924 61.154209043475106,8.947153829482092 61.19884740993737,9.03967669337573 61.20296366378382,9.048129382516187 61.158317747291484,8.95573579187924 61.154209043475106)))"
21800006795000,101,54,47,45,"MULTIPOLYGON(((9.048129382516187 61.158317747291484,9.03967669337573 61.20296366378382,9.132227149380286 61.20701688642881,9.140550438690568 61.1623635335944,9.048129382516187 61.158317747291484)))"
21850006795000,5,2,3,58.4,"MULTIPOLYGON(((9.140550438690568 61.1623635335944,9.132227149380286 61.20701688642881,9.224804783007498 61.211007041334064,9.23299854776392 61.166346366000845,9.140550438690568 61.1623635335944)))"
22300006795000,24,12,12,52.5,"MULTIPOLYGON(((9.973507560614522 61.19593850002538,9.966354258462726 61.240653639097765,10.059157715138703 61.244074631113534,10.066180454407963 61.199353200747346,9.973507560614522 61.19593850002538)))"
22350006795000,540,252,288,47.4,"MULTIPOLYGON(((10.066180454407963 61.199353200747346,10.059157715138703 61.244074631113534,10.151984163979366 61.247432220401556,10.1588762344504 61.202704614012816,10.066180454407963 61.199353200747346)))"
22400006795000,1449,748,701,45.4,"MULTIPOLYGON(((10.1588762344504 61.202704614012816,10.151984163979366 61.247432220401556,10.24483318263047 61.250726376527766,10.251594480297564 61.20599270951782,10.1588762344504 61.202704614012816)))"
22450006795000,1687,825,862,42.9,"MULTIPOLYGON(((10.251594480297564 61.20599270951782,10.24483318263047 61.250726376527766,10.337704348091256 61.25395706961972,10.344334770863636 61.20921745751762,10.251594480297564 61.20599270951782)))"
22500006795000,241,120,121,35.3,"MULTIPOLYGON(((10.344334770863636 61.20921745751762,10.337704348091256 61.25395706961972,10.43059723672609 61.25712427036759,10.437096684432795 61.21237882882779,10.344334770863636 61.20921745751762)))"
22550006795000,1930,987,943,42.6,"MULTIPOLYGON(((10.437096684432795 61.21237882882779,10.43059723672609 61.25712427036759,10.523511424276151 61.26022795002513,10.529879798670818 61.2154767948251,10.437096684432795 61.21237882882779)))"
22600006795000,6,5,1,34,"MULTIPOLYGON(((10.529879798670818 61.2154767948251,10.523511424276151 61.26022795002513,10.616446485871151 61.26326808041076,10.622683690636721 61.21851132744865,10.529879798670818 61.2154767948251)))"
22700006795000,36,13,23,36.1,"MULTIPOLYGON(((10.715507936794436 61.22148239920067,10.709401996041104 61.266244633908464,10.802377528728151 61.26915758346879,10.80835211302454 61.22438998314767,10.715507936794436 61.22148239920067)))"
23000006795000,94,59,35,48.2,"MULTIPOLYGON(((11.272857061732186 61.23797468273966,11.267540578240196 61.28276736525386,11.360627267392342 61.28529815499376,11.365811880708481 61.24050080595986,11.272857061732186 61.23797468273966)))"
23050006795000,6,4,2,50.3,"MULTIPOLYGON(((11.365811880708481 61.24050080595986,11.360627267392342 61.28529815499376,11.453730981196887 61.287765167389736,11.45878364558068 61.24296326871255,11.365811880708481 61.24050080595986)))"
23100006795000,21,15,6,41,"MULTIPOLYGON(((11.45878364558068 61.24296326871255,11.453730981196887 61.287765167389736,11.546851289323103 61.29016837995683,11.551771927989442 61.24536204860939,11.45878364558068 61.24296326871255)))"
23200006795000,8,5,3,43.3,"MULTIPOLYGON(((11.644776299099362 61.24769712383387,11.6399877609605 61.292507770784354,11.733139964831032 61.29478331853671,11.737796329611104 61.24996847314215,11.644776299099362 61.24769712383387)))"
23250006795000,25,13,12,45.6,"MULTIPOLYGON(((11.737796329611104 61.24996847314215,11.733139964831032 61.29478331853671,11.826307469201316 61.29699500245407,11.830831589773506 61.25217607586366,11.737796329611104 61.24996847314215)))"
23300006795000,1,0,1,0,"MULTIPOLYGON(((11.830831589773506 61.25217607586366,11.826307469201316 61.29699500245407,11.919489841894906 61.299142802353096,11.923881649395772 61.254319911901945,11.830831589773506 61.25217607586366)))"
23350006795000,9,5,4,36.2,"MULTIPOLYGON(((11.923881649395772 61.254319911901945,11.919489841894906 61.299142802353096,12.012686650304595 61.30122669862771,12.016946077859673 61.25639996173526,11.923881649395772 61.254319911901945)))"
23500006795000,742,386,356,41.3,"MULTIPOLYGON(((12.203116316775686 61.26036862757813,12.199121841763546 61.30520270476957,12.292359357555634 61.30709477831678,12.2962212639644 61.26225720742406,12.203116316775686 61.26036862757813)))"
23550006795000,214,114,100,43.1,"MULTIPOLYGON(((12.2962212639644 61.26225720742406,12.292359357555634 61.30709477831678,12.385609574574277 61.3089228756008,12.389338853492559 61.26408192873909,12.2962212639644 61.26225720742406)))"
23600006795000,60,31,29,45.1,"MULTIPOLYGON(((12.389338853492559 61.26408192873909,12.385609574574277 61.3089228756008,12.478872058243915 61.310686979911566,12.482468652788835 61.265842774885144,12.389338853492559 61.26408192873909)))"
23650006795000,5,2,3,61,"MULTIPOLYGON(((12.482468652788835 61.265842774885144,12.478872058243915 61.310686979911566,12.572146373632643 61.31238707511992,12.575610228928296 61.26753972980263,12.482468652788835 61.265842774885144)))"
23700006795000,12,4,8,45.4,"MULTIPOLYGON(((12.575610228928296 61.26753972980263,12.572146373632643 61.31238707511992,12.665432085464673 61.31402314567842,12.668763148644807 61.26917277801109,12.575610228928296 61.26753972980263)))"
23800006795000,5,3,2,53.6,"MULTIPOLYGON(((12.761926978343451 61.27074190460971,12.758728758132872 61.315595176621684,12.852035955711312 61.31710315356704,12.855101284112992 61.27224709527784,12.761926978343451 61.27074190460971)))"
19450006800000,4,4,0,0,"MULTIPOLYGON(((4.727912284762398 60.94210839763184,4.71350515219019 60.986277408177955,4.804448217940052 60.99325700772288,4.818733414756881 60.94907538793493,4.727912284762398 60.94210839763184)))"
19500006800000,3,2,1,0,"MULTIPOLYGON(((4.818733414756881 60.94907538793493,4.804448217940052 60.99325700772288,4.895437134637677 61.0001757210768,4.909600190444412 60.9559815965874,4.818733414756881 60.94907538793493)))"
19550006800000,7,3,4,65.4,"MULTIPOLYGON(((4.909600190444412 60.9559815965874,4.895437134637677 61.0001757210768,4.986471532691502 61.007033487804634,5.000512243743924 60.96282696340305,4.909600190444412 60.9559815965874)))"
19600006800000,335,165,170,42.3,"MULTIPOLYGON(((5.000512243743924 60.96282696340305,4.986471532691502 61.007033487804634,5.077551041288149 61.01383024794859,5.091469205361486 60.9696114286712,5.000512243743924 60.96282696340305)))"
19650006800000,62,30,32,43.6,"MULTIPOLYGON(((5.091469205361486 60.9696114286712,5.077551041288149 61.01383024794859,5.16867528840046 61.02056594203,5.182470704798361 60.976334933158476,5.091469205361486 60.9696114286712)))"
19700006800000,108,55,53,44.6,"MULTIPOLYGON(((5.182470704798361 60.976334933158476,5.16867528840046 61.02056594203,5.259843900795633 61.02724051105122,5.273516370359009 60.98299741811089,5.182470704798361 60.976334933158476)))"
19750006800000,35,18,17,51.8,"MULTIPOLYGON(((5.273516370359009 60.98299741811089,5.259843900795633 61.02724051105122,5.351056504043403 61.033853896497604,5.364605829159265 60.989598825255555,5.273516370359009 60.98299741811089)))"
19800006800000,96,44,52,48.8,"MULTIPOLYGON(((5.364605829159265 60.989598825255555,5.351056504043403 61.033853896497604,5.442312722524332 61.04040604033931,5.455738707134562 60.9961390968027,5.364605829159265 60.989598825255555)))"
19850006800000,232,125,107,40.5,"MULTIPOLYGON(((5.455738707134562 60.9961390968027,5.442312722524332 61.04040604033931,5.533612179438127 61.04689688503328,5.546914629048198 61.00261817544743,5.455738707134562 60.9961390968027)))"
19950006800000,1,0,1,0,"MULTIPOLYGON(((5.638133218499753 61.00903600437165,5.624954496812098 61.053326373524996,5.716339295509659 61.05969444925038,5.729394097933508 61.01539252724587,5.638133218499753 61.00903600437165)))"
20000006800000,13,5,8,51.3,"MULTIPOLYGON(((5.729394097933508 61.01539252724587,5.716339295509659 61.05969444925038,5.807766195238887 61.066001056137665,5.82069688864699 61.021687688231005,5.729394097933508 61.01539252724587)))"
20050006800000,8,2,6,43.4,"MULTIPOLYGON(((5.82069688864699 61.021687688231005,5.807766195238887 61.066001056137665,5.899234814561212 61.07224613860915,5.912041210799551 61.02792143198027,5.82069688864699 61.021687688231005)))"
20100006800000,20,11,9,36.1,"MULTIPOLYGON(((5.912041210799551 61.02792143198027,5.899234814561212 61.07224613860915,5.990744770900114 61.07842964158312,6.003426683421075 61.03409370364088,5.912041210799551 61.02792143198027)))"
20300006800000,6,5,1,71.2,"MULTIPOLYGON(((6.277826177640203 61.05224114501142,6.265518819367732 61.09661013017865,6.357190275559084 61.102546774325916,6.369372420154499 61.058166989733074,6.277826177640203 61.05224114501142)))"
20400006800000,34,19,15,55.2,"MULTIPOLYGON(((6.460957891653749 61.06403109557509,6.448901139126392 61.10842157106813,6.540651020853138 61.11423446833632,6.552582204577276 61.06983341068602,6.460957891653749 61.06403109557509)))"
20450006800000,1303,651,652,44.4,"MULTIPOLYGON(((6.552582204577276 61.06983341068602,6.540651020853138 61.11423446833632,6.632439530448078 61.119985414569825,6.64424497029772 61.07557388372075,6.552582204577276 61.06983341068602)))"
20550006800000,37,17,20,43,"MULTIPOLYGON(((6.735945799130294 61.08125246384205,6.724266276554575 61.12567435871782,6.816130866759999 61.13130125024117,6.827684300342109 61.08686910072242,6.735945799130294 61.08125246384205)))"
20750006800000,2,1,1,0,"MULTIPOLYGON(((7.103121915400688 61.10334685632168,7.091947762202749 61.14780911138093,7.183959783890301 61.15318729730463,7.195007178169281 61.10871522721335,7.103121915400688 61.10334685632168)))"
20850006800000,1,1,0,0,"MULTIPOLYGON(((7.28692814426278 61.11402141092856,7.276007672107362 61.15850318564017,7.36809102830653 61.16375672895274,7.378884416859606 61.119265360231935,7.28692814426278 61.11402141092856)))"
20900006800000,21,12,9,37,"MULTIPOLYGON(((7.378884416859606 61.119265360231935,7.36809102830653 61.16375672895274,7.460209452952132 61.168947880330514,7.470875598157338 61.124447028409136,7.378884416859606 61.119265360231935)))"
21300006800000,2,1,1,0,"MULTIPOLYGON(((8.115757694084786 61.15897102022271,8.105986578064188 61.203535135761534,8.19837105171786 61.208225526109175,8.20801370969402 61.16365282069492,8.115757694084786 61.15897102022271)))"
21350006800000,32,18,14,48.8,"MULTIPOLYGON(((8.20801370969402 61.16365282069492,8.19837105171786 61.208225526109175,8.290786955187983 61.21285312610545,8.300301011296902 61.168271943306664,8.20801370969402 61.16365282069492)))"
21400006800000,107,67,40,46.5,"MULTIPOLYGON(((8.300301011296902 61.168271943306664,8.290786955187983 61.21285312610545,8.383233879614194 61.21741789415247,8.392619191836863 61.17282834663624,8.300301011296902 61.168271943306664)))"
21450006800000,26,14,12,36.5,"MULTIPOLYGON(((8.392619191836863 61.17282834663624,8.383233879614194 61.21741789415247,8.475711415260905 61.22191978919174,8.484967843388743 61.17732198979919,8.392619191836863 61.17282834663624)))"
21650006800000,2,1,1,0,"MULTIPOLYGON(((8.762192532057853 61.190425957531076,8.753323579263427 61.23504783379834,8.845919445305288 61.23929783705819,8.854658971405273 61.19466816197557,8.762192532057853 61.190425957531076)))"
21700006800000,378,188,190,43.9,"MULTIPOLYGON(((8.854658971405273 61.19466816197557,8.845919445305288 61.23929783705819,8.938543861135894 61.24348477015708,8.947153829482092 61.19884740993737,8.854658971405273 61.19466816197557)))"
21750006800000,88,42,46,43.9,"MULTIPOLYGON(((8.947153829482092 61.19884740993737,8.938543861135894 61.24348477015708,9.03119641199397 61.247608595301585,9.03967669337573 61.20296366378382,8.947153829482092 61.19884740993737)))"
21800006800000,1,1,0,0,"MULTIPOLYGON(((9.03967669337573 61.20296366378382,9.03119641199397 61.247608595301585,9.123876682318796 61.2516692752471,9.132227149380286 61.20701688642881,9.03967669337573 61.20296366378382)))"
22300006800000,117,67,50,43.4,"MULTIPOLYGON(((9.966354258462726 61.240653639097765,9.959177542338496 61.28536798870164,10.052111983595077 61.28879528982542,10.059157715138703 61.244074631113534,9.966354258462726 61.240653639097765)))"
22350006800000,271,139,132,45.6,"MULTIPOLYGON(((10.059157715138703 61.244074631113534,10.052111983595077 61.28879528982542,10.145069523590143 61.292159072631215,10.151984163979366 61.247432220401556,10.059157715138703 61.244074631113534)))"
22400006800000,638,347,291,42.5,"MULTIPOLYGON(((10.151984163979366 61.247432220401556,10.145069523590143 61.292159072631215,10.23804973804788 61.295459306554086,10.24483318263047 61.250726376527766,10.151984163979366 61.247432220401556)))"
22450006800000,127,69,58,43.7,"MULTIPOLYGON(((10.24483318263047 61.250726376527766,10.23804973804788 61.295459306554086,10.33105220204096 61.29869596159308,10.337704348091256 61.25395706961972,10.24483318263047 61.250726376527766)))"
22500006800000,977,495,482,42.6,"MULTIPOLYGON(((10.337704348091256 61.25395706961972,10.33105220204096 61.29869596159308,10.424076490002252 61.30186900831225,10.43059723672609 61.25712427036759,10.337704348091256 61.25395706961972)))"
22550006800000,166,80,86,43.1,"MULTIPOLYGON(((10.43059723672609 61.25712427036759,10.424076490002252 61.30186900831225,10.517122175736601 61.30497841784158,10.523511424276151 61.26022795002513,10.43059723672609 61.25712427036759)))"
22950006800000,20,10,10,61.5,"MULTIPOLYGON(((11.174471343579247 61.280172821228476,11.169005186723508 61.32496013746732,11.262206640172995 61.32755947840024,11.267540578240196 61.28276736525386,11.174471343579247 61.280172821228476)))"
23000006800000,39,15,24,50.5,"MULTIPOLYGON(((11.267540578240196 61.28276736525386,11.262206640172995 61.32755947840024,11.35542562934182 61.33009494794228,11.360627267392342 61.28529815499376,11.267540578240196 61.28276736525386)))"
23050006800000,48,23,25,56.5,"MULTIPOLYGON(((11.360627267392342 61.28529815499376,11.35542562934182 61.33009494794228,11.448661722411465 61.33256652293539,11.453730981196887 61.287765167389736,11.360627267392342 61.28529815499376)))"
23100006800000,66,39,27,44.6,"MULTIPOLYGON(((11.453730981196887 61.287765167389736,11.448661722411465 61.33256652293539,11.541914487067658 61.334974180797346,11.546851289323103 61.29016837995683,11.453730981196887 61.287765167389736)))"
23200006800000,20,13,7,50.2,"MULTIPOLYGON(((11.6399877609605 61.292507770784354,11.635183490512617 61.337317899522745,11.72846829947736 61.33959765768368,11.733139964831032 61.29478331853671,11.6399877609605 61.292507770784354)))"
23250006800000,205,97,108,51.3,"MULTIPOLYGON(((11.733139964831032 61.29478331853671,11.72846829947736 61.33959765768368,11.821768480234022 61.3418134344305,11.826307469201316 61.29699500245407,11.733139964831032 61.29478331853671)))"
23300006800000,12,6,6,56.8,"MULTIPOLYGON(((11.826307469201316 61.29699500245407,11.821768480234022 61.3418134344305,11.91508359860821 61.34396520949251,11.919489841894906 61.299142802353096,11.826307469201316 61.29699500245407)))"
23350006800000,9,6,3,33.6,"MULTIPOLYGON(((11.919489841894906 61.299142802353096,11.91508359860821 61.34396520949251,12.008413219991398 61.34605296317872,12.012686650304595 61.30122669862771,11.919489841894906 61.299142802353096)))"
23450006800000,4,3,1,0,"MULTIPOLYGON(((12.10589746140472 61.30324667224975,12.101756909353353 61.34807667637859,12.19511423125459 61.35003633056253,12.199121841763546 61.30520270476957,12.10589746140472 61.30324667224975)))"
23500006800000,2113,1070,1043,44.9,"MULTIPOLYGON(((12.199121841763546 61.30520270476957,12.19511423125459 61.35003633056253,12.288484749858847 61.35193190778272,12.292359357555634 61.30709477831678,12.199121841763546 61.30520270476957)))"
23650006800000,12,5,7,69.5,"MULTIPOLYGON(((12.478872058243915 61.310686979911566,12.475263631922601 61.355530762452766,12.568671121838463 61.35723400692103,12.572146373632643 61.31238707511992,12.478872058243915 61.310686979911566)))"
23700006800000,2,1,1,0,"MULTIPOLYGON(((12.572146373632643 61.31238707511992,12.568671121838463 61.35723400692103,12.662090061395233 61.35887310846351,12.665432085464673 61.31402314567842,12.572146373632643 61.31238707511992)))"
19350006805000,9,4,5,68.1,"MULTIPOLYGON(((4.53175804574335 60.97213579462961,4.517060710900034 61.01627689475825,4.608032857537199 61.02339093601856,4.622608305749907 60.97923698335232,4.53175804574335 60.97213579462961)))"
19400006805000,18,9,9,68.2,"MULTIPOLYGON(((4.622608305749907 60.97923698335232,4.608032857537199 61.02339093601856,4.699051800102132 61.03044410909128,4.71350515219019 60.986277408177955,4.622608305749907 60.97923698335232)))"
19450006805000,28,13,15,50.1,"MULTIPOLYGON(((4.71350515219019 60.986277408177955,4.699051800102132 61.03044410909128,4.790117169970486 61.03743635233904,4.804448217940052 60.99325700772288,4.71350515219019 60.986277408177955)))"
19550006805000,6,4,2,52.5,"MULTIPOLYGON(((4.895437134637677 61.0001757210768,4.881228597271104 61.044367604599564,4.972385710893971 61.051237805187505,4.986471532691502 61.007033487804634,4.895437134637677 61.0001757210768)))"
19600006805000,42,24,18,54.9,"MULTIPOLYGON(((4.986471532691502 61.007033487804634,4.972385710893971 61.051237805187505,5.063588138498195 61.05804689389655,5.077551041288149 61.01383024794859,4.986471532691502 61.007033487804634)))"
19650006805000,3,3,0,0,"MULTIPOLYGON(((5.077551041288149 61.01383024794859,5.063588138498195 61.05804689389655,5.154835506520109 61.06479481100127,5.16867528840046 61.02056594203,5.077551041288149 61.01383024794859)))"
19700006805000,21,11,10,41.2,"MULTIPOLYGON(((5.16867528840046 61.02056594203,5.154835506520109 61.06479481100127,5.246127440181451 61.071481497259036,5.259843900795633 61.02724051105122,5.16867528840046 61.02056594203)))"
19750006805000,38,18,20,54.3,"MULTIPOLYGON(((5.259843900795633 61.02724051105122,5.246127440181451 61.071481497259036,5.337463563497579 61.078106893912015,5.351056504043403 61.033853896497604,5.259843900795633 61.02724051105122)))"
19800006805000,14,8,6,42.1,"MULTIPOLYGON(((5.351056504043403 61.033853896497604,5.337463563497579 61.078106893912015,5.428843499285827 61.08467094268895,5.442312722524332 61.04040604033931,5.351056504043403 61.033853896497604)))"
19850006805000,39,23,16,55.7,"MULTIPOLYGON(((5.442312722524332 61.04040604033931,5.428843499285827 61.08467094268895,5.520266869173885 61.09117358580722,5.533612179438127 61.04689688503328,5.442312722524332 61.04040604033931)))"
19900006805000,60,32,28,43.2,"MULTIPOLYGON(((5.533612179438127 61.04689688503328,5.520266869173885 61.09117358580722,5.611733293608298 61.09761476597452,5.624954496812098 61.053326373524996,5.533612179438127 61.04689688503328)))"
19950006805000,55,30,25,45.2,"MULTIPOLYGON(((5.624954496812098 61.053326373524996,5.611733293608298 61.09761476597452,5.703242391863022 61.103994426390884,5.716339295509659 61.05969444925038,5.624954496812098 61.053326373524996)))"
20000006805000,40,19,21,55.8,"MULTIPOLYGON(((5.716339295509659 61.05969444925038,5.703242391863022 61.103994426390884,5.794793782048033 61.1103125107505,5.807766195238887 61.066001056137665,5.716339295509659 61.05969444925038)))"
20050006805000,120,66,54,45.2,"MULTIPOLYGON(((5.807766195238887 61.066001056137665,5.794793782048033 61.1103125107505,5.886387081118094 61.11656896324343,5.899234814561212 61.07224613860915,5.807766195238887 61.066001056137665)))"
20150006805000,14,6,8,52.1,"MULTIPOLYGON(((5.990744770900114 61.07842964158312,5.978021904881491 61.12276372855765,6.069697868008931 61.12889675188066,6.082295680549962 61.0845515104755,5.990744770900114 61.07842964158312)))"
20200006805000,62,36,26,40.4,"MULTIPOLYGON(((6.082295680549962 61.0845515104755,6.069697868008931 61.12889675188066,6.161414584042476 61.1349679789014,6.17388715868489 61.09061169120176,6.082295680549962 61.0845515104755)))"
20300006805000,78,39,39,48.8,"MULTIPOLYGON(((6.265518819367732 61.09661013017865,6.253171665404551 61.140977355812005,6.344968723407047 61.14692482930957,6.357190275559084 61.102546774325916,6.265518819367732 61.09661013017865)))"
20350006805000,20,9,11,44.9,"MULTIPOLYGON(((6.357190275559084 61.102546774325916,6.344968723407047 61.14692482930957,6.436805368260476 61.152810346597896,6.448901139126392 61.10842157106813,6.357190275559084 61.102546774325916)))"
20400006805000,37,18,19,54.5,"MULTIPOLYGON(((6.448901139126392 61.10842157106813,6.436805368260476 61.152810346597896,6.528681209083232 61.15863385538928,6.540651020853138 61.11423446833632,6.448901139126392 61.10842157106813)))"
20450006805000,62,31,31,45.2,"MULTIPOLYGON(((6.540651020853138 61.11423446833632,6.528681209083232 61.15863385538928,6.620595853910864 61.16439530390617,6.632439530448078 61.119985414569825,6.540651020853138 61.11423446833632)))"
20500006805000,159,80,79,47.2,"MULTIPOLYGON(((6.632439530448078 61.119985414569825,6.620595853910864 61.16439530390617,6.7125489097055 61.17009464088295,6.724266276554575 61.12567435871782,6.632439530448078 61.119985414569825)))"
20550006805000,172,89,83,45.9,"MULTIPOLYGON(((6.724266276554575 61.12567435871782,6.7125489097055 61.17009464088295,6.804539982365296 61.175731815567616,6.816130866759999 61.13130125024117,6.724266276554575 61.12567435871782)))"
20600006805000,90,45,45,44.4,"MULTIPOLYGON(((6.816130866759999 61.13130125024117,6.804539982365296 61.175731815567616,6.896568676733939 61.18130677772345,6.908032907605179 61.13686603911399,6.816130866759999 61.13130125024117)))"
20650006805000,315,169,146,42.3,"MULTIPOLYGON(((6.908032907605179 61.13686603911399,6.896568676733939 61.18130677772345,6.9886345966103 61.186819477630664,6.999972004593952 61.14236867582534,6.908032907605179 61.13686603911399)))"
20700006805000,52,22,30,50.6,"MULTIPOLYGON(((6.999972004593952 61.14236867582534,6.9886345966103 61.186819477630664,7.080737344758052 61.19226986608818,7.091947762202749 61.14780911138093,6.999972004593952 61.14236867582534)))"
20800006805000,1333,682,651,38.9,"MULTIPOLYGON(((7.183959783890301 61.15318729730463,7.172876522915449 61.19765789441506,7.265051731805121 61.20298351445236,7.276007672107362 61.15850318564017,7.183959783890301 61.15318729730463)))"
20850006805000,15,6,9,50.5,"MULTIPOLYGON(((7.276007672107362 61.15850318564017,7.265051731805121 61.20298351445236,7.35726257114397 61.20824667856458,7.36809102830653 61.16375672895274,7.276007672107362 61.15850318564017)))"
20950006805000,1,0,1,0,"MULTIPOLYGON(((7.460209452952132 61.168947880330514,7.449508639653104 61.21344733964135,7.541789535067866 61.21858545109891,7.552362545530158 61.17407659338629,7.460209452952132 61.168947880330514)))"
21000006805000,93,52,41,44.2,"MULTIPOLYGON(((7.552362545530158 61.17407659338629,7.541789535067866 61.21858545109891,7.63410485414793 61.223660966881816,7.6445499045583 61.179142822258996,7.552362545530158 61.17407659338629)))"
21650006805000,43,24,19,46.1,"MULTIPOLYGON(((8.753323579263427 61.23504783379834,8.744425662592509 61.27966865714167,8.837151369281482 61.28392648120276,8.845919445305288 61.23929783705819,8.753323579263427 61.23504783379834)))"
21700006805000,299,156,143,44.5,"MULTIPOLYGON(((8.845919445305288 61.23929783705819,8.837151369281482 61.28392648120276,8.929905757628998 61.28812112111558,8.938543861135894 61.24348477015708,8.845919445305288 61.23929783705819)))"
22200006805000,28,17,11,55.9,"MULTIPOLYGON(((9.773379649816391 61.278322956572985,9.765916924256468 61.323023513495514,9.858935085815164 61.32658431573274,9.866266623433006 61.281877200387626,9.773379649816391 61.278322956572985)))"
22250006805000,82,43,39,49.2,"MULTIPOLYGON(((9.866266623433006 61.281877200387626,9.858935085815164 61.32658431573274,9.951977303750699 61.33008154682903,9.959177542338496 61.28536798870164,9.866266623433006 61.281877200387626)))"
22300006805000,63,29,34,48.2,"MULTIPOLYGON(((9.959177542338496 61.28536798870164,9.951977303750699 61.33008154682903,10.045043153202434 61.33351517495838,10.052111983595077 61.28879528982542,9.959177542338496 61.28536798870164)))"
22350006805000,17,11,6,47.1,"MULTIPOLYGON(((10.052111983595077 61.28879528982542,10.045043153202434 61.33351517495838,10.138132208629656 61.33688516885904,10.145069523590143 61.292159072631215,10.052111983595077 61.28879528982542)))"
22400006805000,239,122,117,45.2,"MULTIPOLYGON(((10.145069523590143 61.292159072631215,10.138132208629656 61.33688516885904,10.231244043823315 61.34019149783443,10.23804973804788 61.295459306554086,10.145069523590143 61.292159072631215)))"
22450006805000,1305,640,665,45.5,"MULTIPOLYGON(((10.23804973804788 61.295459306554086,10.231244043823315 61.34019149783443,10.324378231917777 61.34343413175434,10.33105220204096 61.29869596159308,10.23804973804788 61.295459306554086)))"
22500006805000,39,19,20,51.1,"MULTIPOLYGON(((10.33105220204096 61.29869596159308,10.324378231917777 61.34343413175434,10.417534345402645 61.34661304105592,10.424076490002252 61.30186900831225,10.33105220204096 61.29869596159308)))"
22950006805000,37,21,16,57.7,"MULTIPOLYGON(((11.169005186723508 61.32496013746732,11.163521062751192 61.369746869688555,11.25685516630179 61.37235102120357,11.262206640172995 61.32755947840024,11.169005186723508 61.32496013746732)))"
23000006805000,1,0,1,0,"MULTIPOLYGON(((11.262206640172995 61.32755947840024,11.25685516630179 61.37235102120357,11.350206887307847 61.374891183892764,11.35542562934182 61.33009494794228,11.262206640172995 61.32755947840024)))"
23050006805000,13,8,5,35.7,"MULTIPOLYGON(((11.35542562934182 61.33009494794228,11.350206887307847 61.374891183892764,11.443575791958914 61.377367334497784,11.448661722411465 61.33256652293539,11.35542562934182 61.33009494794228)))"
23150006805000,1,1,0,0,"MULTIPOLYGON(((11.541914487067658 61.334974180797346,11.536961445944906 61.379779450338695,11.630363414468466 61.38212750931475,11.635183490512617 61.337317899522745,11.541914487067658 61.334974180797346)))"
23200006805000,22,13,9,57.9,"MULTIPOLYGON(((11.635183490512617 61.337317899522745,11.630363414468466 61.38212750931475,11.72378126225735 61.38441148990516,11.72846829947736 61.33959765768368,11.635183490512617 61.337317899522745)))"
23250006805000,24,12,12,60,"MULTIPOLYGON(((11.72846829947736 61.33959765768368,11.72378126225735 61.38441148990516,11.817214553576846 61.38663137116991,11.821768480234022 61.3418134344305,11.72846829947736 61.33959765768368)))"
23300006805000,8,4,4,47.4,"MULTIPOLYGON(((11.821768480234022 61.3418134344305,11.817214553576846 61.38663137116991,11.910662852242218 61.38878713275046,11.91508359860821 61.34396520949251,11.821768480234022 61.3418134344305)))"
23350006805000,127,61,66,44.5,"MULTIPOLYGON(((11.91508359860821 61.34396520949251,11.910662852242218 61.38878713275046,12.00412572163122 61.39087875487038,12.008413219991398 61.34605296317872,11.91508359860821 61.34396520949251)))"
23400006805000,9,3,6,50.2,"MULTIPOLYGON(((12.008413219991398 61.34605296317872,12.00412572163122 61.39087875487038,12.097602724696578 61.3929062183362,12.101756909353353 61.34807667637859,12.008413219991398 61.34605296317872)))"
23450006805000,31,17,14,45.7,"MULTIPOLYGON(((12.101756909353353 61.34807667637859,12.097602724696578 61.3929062183362,12.191093423978575 61.39486950453798,12.19511423125459 61.35003633056253,12.101756909353353 61.34807667637859)))"
23500006805000,139,73,66,38.7,"MULTIPOLYGON(((12.19511423125459 61.35003633056253,12.191093423978575 61.39486950453798,12.284597381617607 61.39676859544994,12.288484749858847 61.35193190778272,12.19511423125459 61.35003633056253)))"
23550006805000,49,24,25,42.2,"MULTIPOLYGON(((12.288484749858847 61.35193190778272,12.284597381617607 61.39676859544994,12.378114159366804 61.398603473631205,12.381868028945597 61.35376339067365,12.288484749858847 61.35193190778272)))"
23700006805000,11,6,5,47.5,"MULTIPOLYGON(((12.568671121838463 61.35723400692103,12.56518442034772 61.40208052496591,12.658737025263232 61.40372266616717,12.662090061395233 61.35887310846351,12.568671121838463 61.35723400692103)))"
23750006805000,189,96,93,53.9,"MULTIPOLYGON(((12.662090061395233 61.35887310846351,12.658737025263232 61.40372266616717,12.752300693681896 61.4053005307345,12.755520012961014 61.36044805204993,12.662090061395233 61.35887310846351)))"
19400006810000,37,19,18,41.7,"MULTIPOLYGON(((4.608032857537199 61.02339093601856,4.593410613187607 61.067542535208204,4.684552020502848 61.07460849139861,4.699051800102132 61.03044410909128,4.608032857537199 61.02339093601856)))"
19450006810000,34,20,14,42.9,"MULTIPOLYGON(((4.699051800102132 61.03044410909128,4.684552020502848 61.07460849139861,4.775740064362169 61.08161341296442,4.790117169970486 61.03743635233904,4.699051800102132 61.03044410909128)))"
19500006810000,341,170,171,41.5,"MULTIPOLYGON(((4.790117169970486 61.03743635233904,4.775740064362169 61.08161341296442,4.866974373377141 61.08855723848996,4.881228597271104 61.044367604599564,4.790117169970486 61.03743635233904)))"
19550006810000,23,12,11,34.3,"MULTIPOLYGON(((4.881228597271104 61.044367604599564,4.866974373377141 61.08855723848996,4.958254574911279 61.09543990703818,4.972385710893971 61.051237805187505,4.881228597271104 61.044367604599564)))"
19650006810000,15,6,9,38,"MULTIPOLYGON(((5.063588138498195 61.05804689389655,5.049580295088106 61.10226135815281,5.140951158799274 61.10902153186025,5.154835506520109 61.06479481100127,5.063588138498195 61.05804689389655)))"
19700006810000,36,17,19,47.4,"MULTIPOLYGON(((5.154835506520109 61.06479481100127,5.140951158799274 61.10902153186025,5.232366789712805 61.11572036867152,5.246127440181451 61.071481497259036,5.154835506520109 61.06479481100127)))"
19750006810000,22,14,8,59.2,"MULTIPOLYGON(((5.246127440181451 61.071481497259036,5.232366789712805 61.11572036867152,5.323826810281359 61.122357809584145,5.337463563497579 61.078106893912015,5.246127440181451 61.071481497259036)))"
19800006810000,29,13,16,54.7,"MULTIPOLYGON(((5.337463563497579 61.078106893912015,5.323826810281359 61.122357809584145,5.415330841750651 61.12893379608414,5.428843499285827 61.08467094268895,5.337463563497579 61.078106893912015)))"
19850006810000,157,62,95,48.6,"MULTIPOLYGON(((5.428843499285827 61.08467094268895,5.415330841750651 61.12893379608414,5.506878504167856 61.13544827014786,5.520266869173885 61.09117358580722,5.428843499285827 61.08467094268895)))"
19900006810000,95,49,46,47.6,"MULTIPOLYGON(((5.520266869173885 61.09117358580722,5.506878504167856 61.13544827014786,5.598469416390205 61.14190117424393,5.611733293608298 61.09761476597452,5.520266869173885 61.09117358580722)))"
19950006810000,24,13,11,57.1,"MULTIPOLYGON(((5.611733293608298 61.09761476597452,5.598469416390205 61.14190117424393,5.690103196093544 61.1482924513351,5.703242391863022 61.103994426390884,5.611733293608298 61.09761476597452)))"
20000006810000,4,2,2,0,"MULTIPOLYGON(((5.703242391863022 61.103994426390884,5.690103196093544 61.1482924513351,5.78177945978106 61.15462204488008,5.794793782048033 61.1103125107505,5.703242391863022 61.103994426390884)))"
20050006810000,7,3,4,56.4,"MULTIPOLYGON(((5.794793782048033 61.1103125107505,5.78177945978106 61.15462204488008,5.873497822792038 61.16088989883547,5.886387081118094 61.11656896324343,5.794793782048033 61.1103125107505)))"
20100006810000,214,112,102,49,"MULTIPOLYGON(((5.886387081118094 61.11656896324343,5.873497822792038 61.16088989883547,5.965257899310716 61.16709595765754,5.978021904881491 61.12276372855765,5.886387081118094 61.11656896324343)))"
20200006810000,4,2,2,0,"MULTIPOLYGON(((6.069697868008931 61.12889675188066,6.05705930237519 61.173240166304076,6.148901643886437 61.17932247023618,6.161414584042476 61.1349679789014,6.069697868008931 61.12889675188066)))"
20250006810000,14,5,9,44.3,"MULTIPOLYGON(((6.161414584042476 61.1349679789014,6.148901643886437 61.17932247023618,6.240784534617384 61.185342815420036,6.253171665404551 61.140977355812005,6.161414584042476 61.1349679789014)))"
20450006810000,471,243,228,43.8,"MULTIPOLYGON(((6.528681209083232 61.15863385538928,6.516672593129538 61.20303156575863,6.608713766229315 61.2088035457763,6.620595853910864 61.16439530390617,6.528681209083232 61.15863385538928)))"
20500006810000,141,77,64,42.4,"MULTIPOLYGON(((6.620595853910864 61.16439530390617,6.608713766229315 61.2088035457763,6.70079352581553 61.21451330451555,6.7125489097055 61.17009464088295,6.620595853910864 61.16439530390617)))"
20550006810000,218,109,109,46.2,"MULTIPOLYGON(((6.7125489097055 61.17009464088295,6.70079352581553 61.21451330451555,6.792911476087592 61.220160791010265,6.804539982365296 61.175731815567616,6.7125489097055 61.17009464088295)))"
20600006810000,2062,1014,1048,41.4,"MULTIPOLYGON(((6.804539982365296 61.175731815567616,6.792911476087592 61.220160791010265,6.885067220182464 61.225745954811664,6.896568676733939 61.18130677772345,6.804539982365296 61.175731815567616)))"
20650006810000,21,15,6,45.5,"MULTIPOLYGON(((6.896568676733939 61.18130677772345,6.885067220182464 61.225745954811664,6.977260360184354 61.23126874598994,6.9886345966103 61.186819477630664,6.896568676733939 61.18130677772345)))"
20700006810000,371,179,192,40.7,"MULTIPOLYGON(((6.9886345966103 61.186819477630664,6.977260360184354 61.23126874598994,7.06949049713444 61.23672911513593,7.080737344758052 61.19226986608818,6.9886345966103 61.186819477630664)))"
20750006810000,5280,2705,2575,36.7,"MULTIPOLYGON(((7.080737344758052 61.19226986608818,7.06949049713444 61.23672911513593,7.161757231040696 61.242127013362776,7.172876522915449 61.19765789441506,7.080737344758052 61.19226986608818)))"
20800006810000,291,150,141,38.8,"MULTIPOLYGON(((7.172876522915449 61.19765789441506,7.161757231040696 61.242127013362776,7.254060160887739 61.247462392307625,7.265051731805121 61.20298351445236,7.172876522915449 61.19765789441506)))"
21000006810000,9,5,4,33.4,"MULTIPOLYGON(((7.541789535067866 61.21858545109891,7.531182100779361 61.263092937714255,7.623625784118904 61.26817776643748,7.63410485414793 61.223660966881816,7.541789535067866 61.21858545109891)))"
21050006810000,1727,909,818,44.5,"MULTIPOLYGON(((7.63410485414793 61.223660966881816,7.623625784118904 61.26817776643748,7.716103643323048 61.273199841979725,7.726454192687424 61.22867384146436,7.63410485414793 61.223660966881816)))"
21100006810000,89,44,45,50,"MULTIPOLYGON(((7.726454192687424 61.22867384146436,7.716103643323048 61.273199841979725,7.808615271447794 61.27815911915525,7.818837145525182 61.23362402985219,7.726454192687424 61.22867384146436)))"
21250006810000,1,1,0,0,"MULTIPOLYGON(((8.003702268736072 61.243336170731865,7.993738201932255 61.287889100339875,8.086348685684507 61.29265971665857,8.09618362410323 61.248098035905144,8.003702268736072 61.243336170731865)))"
22150006810000,49,28,21,48.4,"MULTIPOLYGON(((9.672923243243538 61.319399172506344,9.66530453861659 61.364092206138935,9.758429718033563 61.36772323999457,9.765916924256468 61.323023513495514,9.672923243243538 61.319399172506344)))"
22200006810000,106,56,50,46.3,"MULTIPOLYGON(((9.765916924256468 61.323023513495514,9.758429718033563 61.36772323999457,9.851579491705182 61.3712906192772,9.858935085815164 61.32658431573274,9.765916924256468 61.323023513495514)))"
22250006810000,4,2,2,0,"MULTIPOLYGON(((9.858935085815164 61.32658431573274,9.851579491705182 61.3712906192772,9.944753433533359 61.374794311458245,9.951977303750699 61.33008154682903,9.858935085815164 61.32658431573274)))"
22350006810000,23,14,9,38.9,"MULTIPOLYGON(((10.045043153202434 61.33351517495838,10.03795111672291 61.37823428457457,10.131172113793307 61.38161050722958,10.138132208629656 61.33688516885904,10.045043153202434 61.33351517495838)))"
22400006810000,7,4,3,34.9,"MULTIPOLYGON(((10.138132208629656 61.33688516885904,10.131172113793307 61.38161050722958,10.224415996590485 61.384922948594294,10.231244043823315 61.34019149783443,10.138132208629656 61.33688516885904)))"
22450006810000,240,124,116,45.7,"MULTIPOLYGON(((10.231244043823315 61.34019149783443,10.224415996590485 61.384922948594294,10.317682336298699 61.38817157840847,10.324378231917777 61.34343413175434,10.231244043823315 61.34019149783443)))"
22900006810000,38,27,11,54.8,"MULTIPOLYGON(((11.070205009954568 61.367078753183726,11.064569835987555 61.41185995835657,11.158018887937532 61.41453301684519,11.163521062751192 61.369746869688555,11.070205009954568 61.367078753183726)))"
22950006810000,12,8,4,47.8,"MULTIPOLYGON(((11.163521062751192 61.369746869688555,11.158018887937532 61.41453301684519,11.2514860748898 61.41714199268126,11.25685516630179 61.37235102120357,11.163521062751192 61.369746869688555)))"
23050006810000,8,3,5,58.4,"MULTIPOLYGON(((11.350206887307847 61.374891183892764,11.344970961545599 61.4196868619255,11.438473112090222 61.42216760121869,11.443575791958914 61.377367334497784,11.350206887307847 61.374891183892764)))"
23150006810000,7,5,2,63.7,"MULTIPOLYGON(((11.536961445944906 61.379779450338695,11.531992090205433 61.424584187782486,11.62552745908191 61.42693659942025,11.630363414468466 61.38212750931475,11.536961445944906 61.379779450338695)))"
23200006810000,6,4,2,64.2,"MULTIPOLYGON(((11.630363414468466 61.38212750931475,11.62552745908191 61.42693659942025,11.719078781431726 61.42922481451782,11.72378126225735 61.38441148990516,11.630363414468466 61.38212750931475)))"
23250006810000,17,7,10,61.1,"MULTIPOLYGON(((11.72378126225735 61.38441148990516,11.719078781431726 61.42922481451782,11.812645619500865 61.43144881204423,11.817214553576846 61.38663137116991,11.72378126225735 61.38441148990516)))"
23300006810000,6,5,1,53.8,"MULTIPOLYGON(((11.817214553576846 61.38663137116991,11.812645619500865 61.43144881204423,11.906227535081772 61.43360857155248,11.910662852242218 61.38878713275046,11.817214553576846 61.38663137116991)))"
23350006810000,24,12,12,47.3,"MULTIPOLYGON(((11.910662852242218 61.38878713275046,11.906227535081772 61.43360857155248,11.99982408952594 61.435704073180304,12.00412572163122 61.39087875487038,11.910662852242218 61.38878713275046)))"
23400006810000,109,59,50,49,"MULTIPOLYGON(((12.00412572163122 61.39087875487038,11.99982408952594 61.435704073180304,12.09343484375652 61.43773529765077,12.097602724696578 61.3929062183362,12.00412572163122 61.39087875487038)))"
23450006810000,373,192,181,43,"MULTIPOLYGON(((12.097602724696578 61.3929062183362,12.09343484375652 61.43773529765077,12.187059358280978 61.439702226273006,12.191093423978575 61.39486950453798,12.097602724696578 61.3929062183362)))"
23550006810000,6,3,3,43.2,"MULTIPOLYGON(((12.284597381617607 61.39676859544994,12.280697193203762 61.44160484094296,12.374347908239018 61.443443124143826,12.378114159366804 61.398603473631205,12.284597381617607 61.39676859544994)))"
23600006810000,5,3,2,65.8,"MULTIPOLYGON(((12.378114159366804 61.398603473631205,12.374347908239018 61.443443124143826,12.468011062723319 61.44521705894684,12.471643318604663 61.400374122226324,12.378114159366804 61.398603473631205)))"
23700006810000,10,6,4,51.2,"MULTIPOLYGON(((12.56518442034772 61.40208052496591,12.561686215628432 61.4469266290118,12.655372925574106 61.44857181858771,12.658737025263232 61.40372266616717,12.56518442034772 61.40208052496591)))"
19450006815000,62,34,28,55.8,"MULTIPOLYGON(((4.684552020502848 61.07460849139861,4.670005604150151 61.1187705460713,4.761316693390192 61.12578818072554,4.775740064362169 61.08161341296442,4.684552020502848 61.07460849139861)))"
19500006815000,9,6,3,52.1,"MULTIPOLYGON(((4.775740064362169 61.08161341296442,4.761316693390192 61.12578818072554,4.852674256757338 61.132744614028624,4.866974373377141 61.08855723848996,4.775740064362169 61.08161341296442)))"
19550006815000,64,34,30,49.2,"MULTIPOLYGON(((4.866974373377141 61.08855723848996,4.852674256757338 61.132744614028624,4.944077920080592 61.13963978479042,4.958254574911279 61.09543990703818,4.866974373377141 61.08855723848996)))"
19600006815000,9,4,5,64.6,"MULTIPOLYGON(((4.958254574911279 61.09543990703818,4.944077920080592 61.13963978479042,5.035527307939733 61.14647363230328,5.049580295088106 61.10226135815281,4.958254574911279 61.09543990703818)))"
19650006815000,2,1,1,0,"MULTIPOLYGON(((5.049580295088106 61.10226135815281,5.035527307939733 61.14647363230328,5.127022043673525 61.15324609634401,5.140951158799274 61.10902153186025,5.049580295088106 61.10226135815281)))"
19700006815000,22,12,10,50.4,"MULTIPOLYGON(((5.140951158799274 61.10902153186025,5.127022043673525 61.15324609634401,5.218561749387969 61.159957117175814,5.232366789712805 61.11572036867152,5.140951158799274 61.10902153186025)))"
19750006815000,54,28,26,38.9,"MULTIPOLYGON(((5.232366789712805 61.11572036867152,5.218561749387969 61.159957117175814,5.310146045964663 61.16660663555022,5.323826810281359 61.122357809584145,5.232366789712805 61.11572036867152)))"
19800006815000,320,178,142,45.1,"MULTIPOLYGON(((5.323826810281359 61.122357809584145,5.310146045964663 61.16660663555022,5.401774553069221 61.173194592709095,5.415330841750651 61.12893379608414,5.323826810281359 61.122357809584145)))"
19850006815000,96,47,49,47.7,"MULTIPOLYGON(((5.415330841750651 61.12893379608414,5.401774553069221 61.173194592709095,5.4934468891598 61.17972093038642,5.506878504167856 61.13544827014786,5.415330841750651 61.12893379608414)))"
19900006815000,67,33,34,44.1,"MULTIPOLYGON(((5.506878504167856 61.13544827014786,5.4934468891598 61.17972093038642,5.58516267149567 61.1861855908103,5.598469416390205 61.14190117424393,5.506878504167856 61.13544827014786)))"
19950006815000,28,15,13,57.1,"MULTIPOLYGON(((5.598469416390205 61.14190117424393,5.58516267149567 61.1861855908103,5.676921516145908 61.19258851670485,5.690103196093544 61.1482924513351,5.598469416390205 61.14190117424393)))"
20000006815000,42,21,21,57.7,"MULTIPOLYGON(((5.690103196093544 61.1482924513351,5.676921516145908 61.19258851670485,5.768723037998113 61.19892965129204,5.78177945978106 61.15462204488008,5.690103196093544 61.1482924513351)))"
20050006815000,68,36,32,48.2,"MULTIPOLYGON(((5.78177945978106 61.15462204488008,5.768723037998113 61.19892965129204,5.860566850767271 61.20520893829353,5.873497822792038 61.16088989883547,5.78177945978106 61.15462204488008)))"
20100006815000,410,220,190,45.4,"MULTIPOLYGON(((5.873497822792038 61.16088989883547,5.860566850767271 61.20520893829353,5.952452567004618 61.21142632193264,5.965257899310716 61.16709595765754,5.873497822792038 61.16088989883547)))"
20150006815000,39,20,19,46.1,"MULTIPOLYGON(((5.965257899310716 61.16709595765754,5.952452567004618 61.21142632193264,6.044379798106668 61.21758174693603,6.05705930237519 61.173240166304076,5.965257899310716 61.16709595765754)))"
20200006815000,562,271,291,43,"MULTIPOLYGON(((6.05705930237519 61.173240166304076,6.044379798106668 61.21758174693603,6.136348154324223 61.22367515853565,6.148901643886437 61.17932247023618,6.05705930237519 61.173240166304076)))"
20250006815000,13,6,7,38.4,"MULTIPOLYGON(((6.148901643886437 61.17932247023618,6.136348154324223 61.22367515853565,6.228357244771558 61.229706502470506,6.240784534617384 61.185342815420036,6.148901643886437 61.17932247023618)))"
20400006815000,21,12,9,56,"MULTIPOLYGON(((6.424670401244775 61.19719741594426,6.412496059185196 61.241582772847885,6.504624995780573 61.24742759331976,6.516672593129538 61.20303156575863,6.424670401244775 61.19719741594426)))"
20450006815000,417,194,223,42.8,"MULTIPOLYGON(((6.516672593129538 61.20303156575863,6.504624995780573 61.24742759331976,6.596793091882654 61.25321013418913,6.608713766229315 61.2088035457763,6.516672593129538 61.20303156575863)))"
20500006815000,1,1,0,0,"MULTIPOLYGON(((6.608713766229315 61.2088035457763,6.596793091882654 61.25321013418913,6.688999951062648 61.25893034375688,6.70079352581553 61.21451330451555,6.608713766229315 61.2088035457763)))"
20700006815000,332,177,155,37.5,"MULTIPOLYGON(((6.977260360184354 61.23126874598994,6.965849126638006 61.27571647543438,7.058207052384113 61.28118685318298,7.06949049713444 61.23672911513593,6.977260360184354 61.23126874598994)))"
20750006815000,271,143,128,43.3,"MULTIPOLYGON(((7.06949049713444 61.23672911513593,7.058207052384113 61.28118685318298,7.15060174305625 61.28659464893292,7.161757231040696 61.242127013362776,7.06949049713444 61.23672911513593)))"
20800006815000,61,29,32,44.2,"MULTIPOLYGON(((7.161757231040696 61.242127013362776,7.15060174305625 61.28659464893292,7.243032795891095 61.29193981411615,7.254060160887739 61.247462392307625,7.161757231040696 61.242127013362776)))"
20850006815000,8,6,2,54,"MULTIPOLYGON(((7.254060160887739 61.247462392307625,7.243032795891095 61.29193981411615,7.335499807104216 61.29722230069239,7.346398884646826 61.25273520413311,7.254060160887739 61.247462392307625)))"
20900006815000,4,2,2,0,"MULTIPOLYGON(((7.346398884646826 61.25273520413311,7.335499807104216 61.29722230069239,7.42800237190018 61.302442061150515,7.438772999285829 61.25794540152912,7.346398884646826 61.25273520413311)))"
21100006815000,1637,803,834,46.2,"MULTIPOLYGON(((7.716103643323048 61.273199841979725,7.705719324879376 61.317724518678254,7.798360036189092 61.32269291019448,7.808615271447794 61.27815911915525,7.716103643323048 61.273199841979725)))"
21150006815000,1454,753,701,44.5,"MULTIPOLYGON(((7.808615271447794 61.27815911915525,7.798360036189092 61.32269291019448,7.891034262297254 61.327598346031905,7.901160260596883 61.28305555331336,7.808615271447794 61.27815911915525)))"
21650006815000,3,2,1,0,"MULTIPOLYGON(((8.73549864832079 61.32428842431949,8.726542401896232 61.368907132069,8.819529039162394 61.37318066409977,8.828354611463027 61.32855409126994,8.73549864832079 61.32428842431949)))"
22100006815000,13,6,7,56.2,"MULTIPOLYGON(((9.572204378843539 61.36039755080315,9.56442884701041 61.40508290487608,9.657660814225645 61.40878438810857,9.66530453861659 61.364092206138935,9.572204378843539 61.36039755080315)))"
22250006815000,6,3,3,31.3,"MULTIPOLYGON(((9.851579491705182 61.3712906192772,9.844199729322458 61.415996108899755,9.937505821840421 61.419506280553904,9.944753433533359 61.374794311458245,9.851579491705182 61.3712906192772)))"
22400006815000,83,44,39,41.4,"MULTIPOLYGON(((10.131172113793307 61.38161050722958,10.124189133119891 61.42633508587474,10.21756549233832 61.42965365704701,10.224415996590485 61.384922948594294,10.131172113793307 61.38161050722958)))"
22450006815000,338,173,165,46.1,"MULTIPOLYGON(((10.224415996590485 61.384922948594294,10.21756549233832 61.42965365704701,10.310964413127804 61.432908299848684,10.317682336298699 61.38817157840847,10.224415996590485 61.384922948594294)))"
22850006815000,34,15,19,45.8,"MULTIPOLYGON(((10.971139353810315 61.40912284173391,10.965352262839723 61.453898372643685,11.058916092157691 61.45664056327423,11.064569835987555 61.41185995835657,10.971139353810315 61.40912284173391)))"
22900006815000,88,41,47,36.7,"MULTIPOLYGON(((11.064569835987555 61.41185995835657,11.058916092157691 61.45664056327423,11.152498578033528 61.459318577882456,11.158018887937532 61.41453301684519,11.064569835987555 61.41185995835657)))"
23000006815000,22,13,9,48.5,"MULTIPOLYGON(((11.2514860748898 61.41714199268126,11.246099283688292 61.46193239184345,11.3397177718106 61.46448198111395,11.344970961545599 61.4196868619255,11.2514860748898 61.41714199268126)))"
23050006815000,9,5,4,47.9,"MULTIPOLYGON(((11.344970961545599 61.4196868619255,11.3397177718106 61.46448198111395,11.43335360456909 61.46696732223328,11.438473112090222 61.42216760121869,11.344970961545599 61.4196868619255)))"
23200006815000,6,4,2,67.5,"MULTIPOLYGON(((11.62552745908191 61.42693659942025,11.620675550144338 61.471745169093374,11.714360784811193 61.47403763083287,11.719078781431726 61.42922481451782,11.62552745908191 61.42693659942025)))"
23350006815000,11,5,6,49.5,"MULTIPOLYGON(((11.906227535081772 61.43360857155248,11.901777578986675 61.47842952531934,11.995508257564962 61.48052891758165,11.99982408952594 61.435704073180304,11.906227535081772 61.43360857155248)))"
23400006815000,28,15,13,50.6,"MULTIPOLYGON(((11.99982408952594 61.435704073180304,11.995508257564962 61.48052891758165,12.089253202455415 61.48256391384627,12.09343484375652 61.43773529765077,11.99982408952594 61.435704073180304)))"
23450006815000,42,19,23,53.4,"MULTIPOLYGON(((12.09343484375652 61.43773529765077,12.089253202455415 61.48256391384627,12.183011972120003 61.48453449534098,12.187059358280978 61.439702226273006,12.09343484375652 61.43773529765077)))"
23500006815000,29,16,13,42.6,"MULTIPOLYGON(((12.187059358280978 61.439702226273006,12.183011972120003 61.48453449534098,12.276784124614519 61.48644064388276,12.280697193203762 61.44160484094296,12.187059358280978 61.439702226273006)))"
23550006815000,13,8,5,59.3,"MULTIPOLYGON(((12.280697193203762 61.44160484094296,12.276784124614519 61.48644064388276,12.370569217601387 61.48828234187858,12.374347908239018 61.443443124143826,12.280697193203762 61.44160484094296)))"
23600006815000,1,1,0,0,"MULTIPOLYGON(((12.374347908239018 61.443443124143826,12.370569217601387 61.48828234187858,12.464366808362492 61.49005957232591,12.468011062723319 61.44521705894684,12.374347908239018 61.443443124143826)))"
23650006815000,22,12,10,56.7,"MULTIPOLYGON(((12.468011062723319 61.44521705894684,12.464366808362492 61.49005957232591,12.558176453812044 61.4917723188133,12.561686215628432 61.4469266290118,12.468011062723319 61.44521705894684)))"
23700006815000,10,6,4,58.8,"MULTIPOLYGON(((12.561686215628432 61.4469266290118,12.558176453812044 61.4917723188133,12.651997710509473 61.49342056552107,12.655372925574106 61.44857181858771,12.561686215628432 61.4469266290118)))"
19500006820000,13,5,8,61.3,"MULTIPOLYGON(((4.761316693390192 61.12578818072554,4.74684684808155 61.16996064669402,4.838328039973224 61.17692972244224,4.852674256757338 61.132744614028624,4.761316693390192 61.12578818072554)))"
19550006820000,35,19,16,53.3,"MULTIPOLYGON(((4.852674256757338 61.132744614028624,4.838328039973224 61.17692972244224,4.929855540507166 61.18383742982493,4.944077920080592 61.13963978479042,4.852674256757338 61.132744614028624)))"
19600006820000,10,5,5,48.8,"MULTIPOLYGON(((4.944077920080592 61.13963978479042,4.929855540507166 61.18383742982493,5.021428972711241 61.190683707881696,5.035527307939733 61.14647363230328,4.944077920080592 61.13963978479042)))"
19650006820000,4,3,1,0,"MULTIPOLYGON(((5.035527307939733 61.14647363230328,5.021428972711241 61.190683707881696,5.113047958363047 61.19746849613825,5.127022043673525 61.15324609634401,5.035527307939733 61.14647363230328)))"
19700006820000,31,16,15,43.8,"MULTIPOLYGON(((5.127022043673525 61.15324609634401,5.113047958363047 61.19746849613825,5.204712117998216 61.20419173460862,5.218561749387969 61.159957117175814,5.127022043673525 61.15324609634401)))"
19750006820000,224,108,116,39.9,"MULTIPOLYGON(((5.218561749387969 61.159957117175814,5.204712117998216 61.20419173460862,5.296421070918839 61.21085336379691,5.310146045964663 61.16660663555022,5.218561749387969 61.159957117175814)))"
19800006820000,150,75,75,49.2,"MULTIPOLYGON(((5.310146045964663 61.16660663555022,5.296421070918839 61.21085336379691,5.388174435201951 61.217453324699356,5.401774553069221 61.173194592709095,5.310146045964663 61.16660663555022)))"
19850006820000,2,1,1,0,"MULTIPOLYGON(((5.401774553069221 61.173194592709095,5.388174435201951 61.217453324699356,5.479971827708068 61.22399155880622,5.4934468891598 61.17972093038642,5.401774553069221 61.173194592709095)))"
19900006820000,1,0,1,0,"MULTIPOLYGON(((5.4934468891598 61.17972093038642,5.479971827708068 61.22399155880622,5.571812864089857 61.23046800810375,5.58516267149567 61.1861855908103,5.4934468891598 61.17972093038642)))"
19950006820000,21,11,10,48.9,"MULTIPOLYGON(((5.58516267149567 61.1861855908103,5.571812864089857 61.23046800810375,5.663697158800849 61.236882615076,5.676921516145908 61.19258851670485,5.58516267149567 61.1861855908103)))"
20000006820000,14,8,6,45.6,"MULTIPOLYGON(((5.676921516145908 61.19258851670485,5.663697158800849 61.236882615076,5.755624325104256 61.24323532270679,5.768723037998113 61.19892965129204,5.676921516145908 61.19258851670485)))"
20050006820000,280,132,148,50.4,"MULTIPOLYGON(((5.768723037998113 61.19892965129204,5.755624325104256 61.24323532270679,5.847593975081839 61.24952607448152,5.860566850767271 61.20520893829353,5.768723037998113 61.19892965129204)))"
20200006820000,1388,711,677,43.2,"MULTIPOLYGON(((6.044379798106668 61.21758174693603,6.031659168533198 61.26192148692404,6.123753930344335 61.26802603708748,6.136348154324223 61.22367515853565,6.044379798106668 61.21758174693603)))"
20450006820000,79,42,37,43.9,"MULTIPOLYGON(((6.504624995780573 61.24742759331976,6.49253823874327 61.29182193190941,6.584833654278048 61.29761506311573,6.596793091882654 61.25321013418913,6.504624995780573 61.24742759331976)))"
20700006820000,63,37,26,42.1,"MULTIPOLYGON(((6.965849126638006 61.27571647543438,6.954400726259906 61.320162660460504,7.046886842535891 61.32564307485419,7.058207052384113 61.28118685318298,6.965849126638006 61.27571647543438)))"
20750006820000,2,1,1,0,"MULTIPOLYGON(((7.058207052384113 61.28118685318298,7.046886842535891 61.32564307485419,7.139409892738908 61.33106079587739,7.15060174305625 61.28659464893292,7.058207052384113 61.28118685318298)))"
20800006820000,1577,782,795,39.7,"MULTIPOLYGON(((7.15060174305625 61.28659464893292,7.139409892738908 61.33106079587739,7.231969472347656 61.33641577475579,7.243032795891095 61.29193981411615,7.15060174305625 61.28659464893292)))"
20850006820000,163,76,87,44,"MULTIPOLYGON(((7.243032795891095 61.29193981411615,7.231969472347656 61.33641577475579,7.32456517581195 61.341707963244836,7.335499807104216 61.29722230069239,7.243032795891095 61.29193981411615)))"
20900006820000,4,2,2,0,"MULTIPOLYGON(((7.335499807104216 61.29722230069239,7.32456517581195 61.341707963244836,7.41719659656287 61.346937313631315,7.42800237190018 61.302442061150515,7.335499807104216 61.29722230069239)))"
21100006820000,17,8,9,47.9,"MULTIPOLYGON(((7.705719324879376 61.317724518678254,7.695301081780586 61.36224786704814,7.788071285973763 61.367225398576316,7.798360036189092 61.32269291019448,7.705719324879376 61.317724518678254)))"
21150006820000,144,73,71,35.1,"MULTIPOLYGON(((7.798360036189092 61.32269291019448,7.788071285973763 61.367225398576316,7.880875159688525 61.37213986146265,7.891034262297254 61.327598346031905,7.798360036189092 61.32269291019448)))"
21400006820000,1,1,0,0,"MULTIPOLYGON(((8.26205808778586 61.346589654657855,8.252419086362046 61.39116614490218,8.34538510197184 61.39576460807498,8.354893709590256 61.35117965839153,8.26205808778586 61.346589654657855)))"
22050006820000,9,5,4,67.2,"MULTIPOLYGON(((9.471222442390761 61.40131771796535,9.463289232816958 61.44599523510767,9.556627752458718 61.449767385531636,9.56442884701041 61.40508290487608,9.471222442390761 61.40131771796535)))"
22250006820000,5,2,3,67,"MULTIPOLYGON(((9.844199729322458 61.415996108899755,9.836795686189264 61.4607007824648,9.930234358140467 61.46421745206674,9.937505821840421 61.419506280553904,9.844199729322458 61.415996108899755)))"
22350006820000,18,15,3,41.6,"MULTIPOLYGON(((10.030835766250284 61.42295261672297,10.023696993204778 61.467670169439224,10.11718315998652 61.47105890291355,10.124189133119891 61.42633508587474,10.030835766250284 61.42295261672297)))"
22400006820000,1275,635,640,44.8,"MULTIPOLYGON(((10.124189133119891 61.42633508587474,10.11718315998652 61.47105890291355,10.210692426405954 61.47438362139353,10.21756549233832 61.42965365704701,10.124189133119891 61.42633508587474)))"
22450006820000,165,81,84,46.5,"MULTIPOLYGON(((10.21756549233832 61.42965365704701,10.210692426405954 61.47438362139353,10.304224359711307 61.47764429435646,10.310964413127804 61.432908299848684,10.21756549233832 61.42965365704701)))"
22500006820000,57,27,30,41.6,"MULTIPOLYGON(((10.310964413127804 61.432908299848684,10.304224359711307 61.47764429435646,10.397778526490873 61.480840891854164,10.404385464055746 61.43609898446083,10.310964413127804 61.432908299848684)))"
22850006820000,64,34,30,54.2,"MULTIPOLYGON(((10.965352262839723 61.453898372643685,10.959546078984319 61.498673287633515,11.05324369167915 61.50142056680746,11.058916092157691 61.45664056327423,10.965352262839723 61.453898372643685)))"
22900006820000,10,6,4,44.5,"MULTIPOLYGON(((11.058916092157691 61.45664056327423,11.05324369167915 61.50142056680746,11.14696004826185 61.50410355173793,11.152498578033528 61.459318577882456,11.058916092157691 61.45664056327423)))"
23000006820000,26,16,10,48.5,"MULTIPOLYGON(((11.246099283688292 61.46193239184345,11.24069470993257 61.50672221769292,11.334447237354837 61.50927654052458,11.3397177718106 61.46448198111395,11.246099283688292 61.46193239184345)))"
23350006820000,22,8,14,46.2,"MULTIPOLYGON(((11.901777578986675 61.47842952531934,11.897312915388385 61.52324999346702,11.991178159221993 61.52535328754317,11.995508257564962 61.48052891758165,11.901777578986675 61.47842952531934)))"
23400006820000,11,6,5,56.5,"MULTIPOLYGON(((11.995508257564962 61.48052891758165,11.991178159221993 61.52535328754317,12.085057736312477 61.527392066442644,12.089253202455415 61.48256391384627,11.995508257564962 61.48052891758165)))"
23450006820000,46,23,23,40.4,"MULTIPOLYGON(((12.089253202455415 61.48256391384627,12.085057736312477 61.527392066442644,12.178951203063535 61.52936631131131,12.183011972120003 61.48453449534098,12.089253202455415 61.48256391384627)))"
23500006820000,20,11,9,58.1,"MULTIPOLYGON(((12.183011972120003 61.48453449534098,12.178951203063535 61.52936631131131,12.2728581154695 61.53127600388684,12.276784124614519 61.48644064388276,12.183011972120003 61.48453449534098)))"
23550006820000,1,1,0,0,"MULTIPOLYGON(((12.276784124614519 61.48644064388276,12.2728581154695 61.53127600388684,12.36677802912824 61.533121126499374,12.370569217601387 61.48828234187858,12.276784124614519 61.48644064388276)))"
23600006820000,5,2,3,19.2,"MULTIPOLYGON(((12.370569217601387 61.48828234187858,12.36677802912824 61.533121126499374,12.460710499254082 61.534901662072215,12.464366808362492 61.49005957232591,12.370569217601387 61.48828234187858)))"
23650006820000,21,9,12,57.9,"MULTIPOLYGON(((12.464366808362492 61.49005957232591,12.460710499254082 61.534901662072215,12.554655080690798 61.53661759412224,12.558176453812044 61.4917723188133,12.464366808362492 61.49005957232591)))"
19450006825000,8,5,3,54.8,"MULTIPOLYGON(((4.655412340545769 61.16293026402503,4.640772017926088 61.207087636119134,4.732330318205912 61.21413080188616,4.74684684808155 61.16996064669402,4.655412340545769 61.16293026402503)))"
19500006825000,8,4,4,69.4,"MULTIPOLYGON(((4.74684684808155 61.16996064669402,4.732330318205912 61.21413080188616,4.823935514337097 61.221112554902994,4.838328039973224 61.17692972244224,4.74684684808155 61.16996064669402)))"
19550006825000,36,19,17,53.5,"MULTIPOLYGON(((4.838328039973224 61.17692972244224,4.823935514337097 61.221112554902994,4.915587229055236 61.22803283346886,4.929855540507166 61.18383742982493,4.838328039973224 61.17692972244224)))"
19650006825000,40,21,19,53.8,"MULTIPOLYGON(((5.021428972711241 61.190683707881696,5.007285083828043 61.23489157636907,5.099028698863612 61.24168872287693,5.113047958363047 61.19746849613825,5.021428972711241 61.190683707881696)))"
19700006825000,176,81,95,57.6,"MULTIPOLYGON(((5.113047958363047 61.19746849613825,5.099028698863612 61.24168872287693,5.190817693118827 61.24842421275572,5.204712117998216 61.20419173460862,5.113047958363047 61.19746849613825)))"
19750006825000,85,49,36,50,"MULTIPOLYGON(((5.204712117998216 61.20419173460862,5.190817693118827 61.24842421275572,5.282651684307794 61.25509798626075,5.296421070918839 61.21085336379691,5.204712117998216 61.20419173460862)))"
19800006825000,46,23,23,47.6,"MULTIPOLYGON(((5.296421070918839 61.21085336379691,5.282651684307794 61.25509798626075,5.374530288910371 61.26170998414127,5.388174435201951 61.217453324699356,5.296421070918839 61.21085336379691)))"
19850006825000,26,15,11,61.3,"MULTIPOLYGON(((5.388174435201951 61.217453324699356,5.374530288910371 61.26170998414127,5.466453122180814 61.26826014764237,5.479971827708068 61.22399155880622,5.388174435201951 61.217453324699356)))"
19900006825000,65,32,33,46.2,"MULTIPOLYGON(((5.479971827708068 61.22399155880622,5.466453122180814 61.26826014764237,5.558419798156448 61.27474841850697,5.571812864089857 61.23046800810375,5.479971827708068 61.22399155880622)))"
19950006825000,47,25,22,39.4,"MULTIPOLYGON(((5.571812864089857 61.23046800810375,5.558419798156448 61.27474841850697,5.650429929666483 61.281174738977725,5.663697158800849 61.236882615076,5.571812864089857 61.23046800810375)))"
20050006825000,12,7,5,34.8,"MULTIPOLYGON(((5.755624325104256 61.24323532270679,5.742483128340819 61.28753905179895,5.834579004619048 61.293841300218446,5.847593975081839 61.24952607448152,5.755624325104256 61.24323532270679)))"
20100006825000,27,12,15,50.9,"MULTIPOLYGON(((5.847593975081839 61.24952607448152,5.834579004619048 61.293841300218446,5.926717167759446 61.30008142798944,5.939605719642869 61.25575481438919,5.847593975081839 61.24952607448152)))"
20300006825000,21,11,10,44.1,"MULTIPOLYGON(((6.215889612522679 61.27406841039001,6.203381453408309 61.318428532563736,6.295684833273983 61.324419625446,6.308065821378767 61.28004855285289,6.215889612522679 61.27406841039001)))"
20450006825000,62,31,31,45.8,"MULTIPOLYGON(((6.49253823874327 61.29182193190941,6.480412142634828 61.33621457532519,6.572835275742508 61.342018326488905,6.584833654278048 61.29761506311573,6.49253823874327 61.29182193190941)))"
20550006825000,3,1,2,0,"MULTIPOLYGON(((6.67716801056237 61.30334575271123,6.665297528359723 61.34775952544528,6.7577984995318 61.35343812057836,6.769540908369298 61.309013949297785,6.67716801056237 61.30334575271123)))"
20650006825000,35,20,15,44.6,"MULTIPOLYGON(((6.861951947393269 61.31461960199875,6.850337787217254 61.35905406079563,6.942914988297631 61.36460729552972,6.954400726259906 61.320162660460504,6.861951947393269 61.31461960199875)))"
20700006825000,14,9,5,43.1,"MULTIPOLYGON(((6.954400726259906 61.320162660460504,6.942914988297631 61.36460729552972,7.035529698587483 61.37009777474003,7.046886842535891 61.32564307485419,6.954400726259906 61.320162660460504)))"
20850006825000,476,239,237,41.8,"MULTIPOLYGON(((7.231969472347656 61.33641577475579,7.220870024778892 61.380890269071486,7.313594827064975 61.386192186760766,7.32456517581195 61.341707963244836,7.231969472347656 61.33641577475579)))"
20900006825000,166,85,81,38.9,"MULTIPOLYGON(((7.32456517581195 61.341707963244836,7.313594827064975 61.386192186760766,7.406355511349987 61.39143115406595,7.41719659656287 61.346937313631315,7.32456517581195 61.341707963244836)))"
20950006825000,3,1,2,0,"MULTIPOLYGON(((7.41719659656287 61.346937313631315,7.406355511349987 61.39143115406595,7.499151668265076 61.39660712360565,7.509863327022997 61.352103778735085,7.41719659656287 61.346937313631315)))"
21950006825000,2,1,1,0,"MULTIPOLYGON(((9.27669094881318 61.4382596133213,9.268466911135722 61.482921919143436,9.361885082366443 61.486828821078596,9.369976822587986 61.44215929934445,9.27669094881318 61.4382596133213)))"
22000006825000,13,8,5,47.4,"MULTIPOLYGON(((9.369976822587986 61.44215929934445,9.361885082366443 61.486828821078596,9.455329913704498 61.49067185655779,9.463289232816958 61.44599523510767,9.369976822587986 61.44215929934445)))"
22050006825000,2,1,1,0,"MULTIPOLYGON(((9.463289232816958 61.44599523510767,9.455329913704498 61.49067185655779,9.548800976166916 61.49445099035008,9.556627752458718 61.449767385531636,9.463289232816958 61.44599523510767)))"
22200006825000,178,94,84,34.1,"MULTIPOLYGON(((9.743381408050789 61.457120192873354,9.735820074739355 61.501817414791084,9.829367249125342 61.505404637822174,9.836795686189264 61.4607007824648,9.743381408050789 61.457120192873354)))"
22250006825000,2,1,1,0,"MULTIPOLYGON(((9.836795686189264 61.4607007824648,9.829367249125342 61.505404637822174,9.922938931211405 61.50892782393349,9.930234358140467 61.46421745206674,9.836795686189264 61.4607007824648)))"
22300006825000,2,1,1,0,"MULTIPOLYGON(((9.930234358140467 61.46421745206674,9.922938931211405 61.50892782393349,10.016534688327836 61.512386940745444,10.023696993204778 61.467670169439224,9.930234358140467 61.46421745206674)))"
22350006825000,2,1,1,0,"MULTIPOLYGON(((10.023696993204778 61.467670169439224,10.016534688327836 61.512386940745444,10.110154087103455 61.51578195645209,10.11718315998652 61.47105890291355,10.023696993204778 61.467670169439224)))"
22400006825000,263,134,129,43.9,"MULTIPOLYGON(((10.11718315998652 61.47105890291355,10.110154087103455 61.51578195645209,10.203796693477678 61.51911283982239,10.210692426405954 61.47438362139353,10.11718315998652 61.47105890291355)))"
22450006825000,7,4,3,30.4,"MULTIPOLYGON(((10.210692426405954 61.47438362139353,10.203796693477678 61.51911283982239,10.29746207271264 61.522379560201216,10.304224359711307 61.47764429435646,10.210692426405954 61.47438362139353)))"
22500006825000,2,1,1,0,"MULTIPOLYGON(((10.304224359711307 61.47764429435646,10.29746207271264 61.522379560201216,10.391149789405384 61.52558208751044,10.397778526490873 61.480840891854164,10.304224359711307 61.47764429435646)))"
22850006825000,56,28,28,49.3,"MULTIPOLYGON(((10.959546078984319 61.498673287633515,10.953720712896734 61.543447585496985,11.047552547221215 61.54619996781863,11.05324369167915 61.50142056680746,10.959546078984319 61.498673287633515)))"
22900006825000,38,21,17,40.2,"MULTIPOLYGON(((11.05324369167915 61.50142056680746,11.047552547221215 61.54619996781863,11.14140321331272 61.548887937341185,11.14696004826185 61.50410355173793,11.05324369167915 61.50142056680746)))"
22950006825000,1,0,1,0,"MULTIPOLYGON(((11.14696004826185 61.50410355173793,11.14140321331272 61.548887937341185,11.23527227033796 61.55151146922493,11.24069470993257 61.50672221769292,11.14696004826185 61.50410355173793)))"
23400006825000,45,28,17,45,"MULTIPOLYGON(((11.991178159221993 61.52535328754317,11.98683372755178 61.570177182528965,12.080848380440735 61.572219754955476,12.085057736312477 61.527392066442644,11.991178159221993 61.52535328754317)))"
23500006825000,13,5,8,40.5,"MULTIPOLYGON(((12.178951203063535 61.52936631131131,12.174876988286083 61.57419767374949,12.26891910500779 61.57611092056892,12.2728581154695 61.53127600388684,12.178951203063535 61.52936631131131)))"
23550006825000,2,1,1,0,"MULTIPOLYGON(((12.2728581154695 61.53127600388684,12.26891910500779 61.57611092056892,12.362974284126222 61.577959477666674,12.36677802912824 61.533121126499374,12.2728581154695 61.53127600388684)))"
23650006825000,21,10,11,57.6,"MULTIPOLYGON(((12.460710499254082 61.534901662072215,12.457042078775206 61.57974332789129,12.551122041715066 61.581462454687646,12.554655080690798 61.53661759412224,12.460710499254082 61.534901662072215)))"
19600006830000,45,25,20,42.1,"MULTIPOLYGON(((4.915587229055236 61.22803283346886,4.901272777338704 61.27222598699548,4.993095434473528 61.27909722919355,5.007285083828043 61.23489157636907,4.915587229055236 61.22803283346886)))"
19650006830000,149,74,75,47.8,"MULTIPOLYGON(((5.007285083828043 61.23489157636907,4.993095434473528 61.27909722919355,5.084964059937399 61.285906768141906,5.099028698863612 61.24168872287693,5.007285083828043 61.23489157636907)))"
19700006830000,25,13,12,45.7,"MULTIPOLYGON(((5.099028698863612 61.24168872287693,5.084964059937399 61.285906768141906,5.176878271099986 61.29265454335175,5.190817693118827 61.24842421275572,5.099028698863612 61.24168872287693)))"
19750006830000,29,15,14,49.5,"MULTIPOLYGON(((5.190817693118827 61.24842421275572,5.176878271099986 61.29265454335175,5.268837684078857 61.299340494828144,5.282651684307794 61.25509798626075,5.190817693118827 61.24842421275572)))"
19800006830000,55,28,27,48,"MULTIPOLYGON(((5.282651684307794 61.25509798626075,5.268837684078857 61.299340494828144,5.360841913748104 61.30596456307184,5.374530288910371 61.26170998414127,5.282651684307794 61.25509798626075)))"
19850006830000,4,1,3,0,"MULTIPOLYGON(((5.374530288910371 61.26170998414127,5.360841913748104 61.30596456307184,5.452890573747003 61.31252668908137,5.466453122180814 61.26826014764237,5.374530288910371 61.26170998414127)))"
19900006830000,5,3,2,71.4,"MULTIPOLYGON(((5.466453122180814 61.26826014764237,5.452890573747003 61.31252668908137,5.54498327648877 61.319026814355006,5.558419798156448 61.27474841850697,5.466453122180814 61.26826014764237)))"
19950006830000,1,1,0,0,"MULTIPOLYGON(((5.558419798156448 61.27474841850697,5.54498327648877 61.319026814355006,5.637119633169409 61.325464880892525,5.650429929666483 61.281174738977725,5.558419798156448 61.27474841850697)))"
20000006830000,12,7,5,52.2,"MULTIPOLYGON(((5.650429929666483 61.281174738977725,5.637119633169409 61.325464880892525,5.729299253776593 61.33184083119735,5.742483128340819 61.28753905179895,5.650429929666483 61.281174738977725)))"
20050006830000,1116,559,557,35.8,"MULTIPOLYGON(((5.742483128340819 61.28753905179895,5.729299253776593 61.33184083119735,5.821521747098723 61.33815460827825,5.834579004619048 61.293841300218446,5.742483128340819 61.28753905179895)))"
20100006830000,98,47,51,42,"MULTIPOLYGON(((5.834579004619048 61.293841300218446,5.821521747098723 61.33815460827825,5.913786720733952 61.344406155651406,5.926717167759446 61.30008142798944,5.834579004619048 61.293841300218446)))"
20150006830000,51,24,27,42.4,"MULTIPOLYGON(((5.926717167759446 61.30008142798944,5.913786720733952 61.344406155651406,6.006093781099387 61.350595417342156,6.018897225848068 61.306259379372406,5.926717167759446 61.30008142798944)))"
20200006830000,62,34,28,46.2,"MULTIPOLYGON(((6.018897225848068 61.306259379372406,6.006093781099387 61.350595417342156,6.098442533440299 61.35672233788693,6.111118785807942 61.31237509913698,6.018897225848068 61.306259379372406)))"
20250006830000,159,85,74,48.7,"MULTIPOLYGON(((6.111118785807942 61.31237509913698,6.098442533440299 61.35672233788693,6.190832581839455 61.36278686233508,6.203381453408309 61.318428532563736,6.111118785807942 61.31237509913698)))"
20300006830000,105,54,51,46.8,"MULTIPOLYGON(((6.203381453408309 61.318428532563736,6.190832581839455 61.36278686233508,6.283263529226518 61.36878893625071,6.295684833273983 61.324419625446,6.203381453408309 61.318428532563736)))"
20350006830000,2,1,1,0,"MULTIPOLYGON(((6.295684833273983 61.324419625446,6.283263529226518 61.36878893625071,6.375734977387511 61.374728505714494,6.38802852889474 61.33034832409171,6.295684833273983 61.324419625446)))"
20550006830000,10,8,2,63.6,"MULTIPOLYGON(((6.665297528359723 61.34775952544528,6.653388327421069 61.39217165598823,6.74601777400144 61.39786067884601,6.7577984995318 61.35343812057836,6.665297528359723 61.34775952544528)))"
20600006830000,5,2,3,61.8,"MULTIPOLYGON(((6.7577984995318 61.35343812057836,6.74601777400144 61.39786067884601,6.838685713468472 61.40348693546678,6.850337787217254 61.35905406079563,6.7577984995318 61.35343812057836)))"
20850006830000,1336,661,675,41.4,"MULTIPOLYGON(((7.220870024778892 61.380890269071486,7.209734286687481 61.42536329187526,7.302588596149705 61.430674966178344,7.313594827064975 61.386192186760766,7.220870024778892 61.380890269071486)))"
20900006830000,132,72,60,42.5,"MULTIPOLYGON(((7.313594827064975 61.386192186760766,7.302588596149705 61.430674966178344,7.39547895333938 61.43592357751738,7.406355511349987 61.39143115406595,7.313594827064975 61.386192186760766)))"
20950006830000,217,113,104,43.4,"MULTIPOLYGON(((7.406355511349987 61.39143115406595,7.39547895333938 61.43592357751738,7.488404947085858 61.44110907830862,7.499151668265076 61.39660712360565,7.406355511349987 61.39143115406595)))"
21000006830000,6,5,1,62.7,"MULTIPOLYGON(((7.499151668265076 61.39660712360565,7.488404947085858 61.44110907830862,7.581366165204939 61.44623142150722,7.591982887435558 61.40172004853523,7.499151668265076 61.39660712360565)))"
21700006830000,1,1,0,0,"MULTIPOLYGON(((8.80179091624318 61.4624306853035,8.792878096109124 61.50705412725292,8.886288633967824 61.51128762993963,8.895069379650648 61.466656371266836,8.80179091624318 61.4624306853035)))"
22000006830000,217,113,104,52.2,"MULTIPOLYGON(((9.361885082366443 61.486828821078596,9.353766681908763 61.53149742432022,9.447344363340827 61.53534757978647,9.455329913704498 61.49067185655779,9.361885082366443 61.486828821078596)))"
22050006830000,5,1,4,42,"MULTIPOLYGON(((9.455329913704498 61.49067185655779,9.447344363340827 61.53534757978647,9.540948398369917 61.53913371689557,9.548800976166916 61.49445099035008,9.455329913704498 61.49067185655779)))"
22150006830000,4,3,1,0,"MULTIPOLYGON(((9.64229784000964 61.498166187792506,9.6345783552927 61.54285580083439,9.728233801650735 61.546513797361236,9.735820074739355 61.501817414791084,9.64229784000964 61.498166187792506)))"
22200006830000,30,15,15,53,"MULTIPOLYGON(((9.735820074739355 61.501817414791084,9.728233801650735 61.546513797361236,9.821914304242428 61.5501076728071,9.829367249125342 61.505404637822174,9.735820074739355 61.501817414791084)))"
22250006830000,17,10,7,31.9,"MULTIPOLYGON(((9.829367249125342 61.505404637822174,9.821914304242428 61.5501076728071,9.91561942913505 61.55363739407685,9.922938931211405 61.50892782393349,9.829367249125342 61.505404637822174)))"
22300006830000,994,503,491,42.5,"MULTIPOLYGON(((9.922938931211405 61.50892782393349,9.91561942913505 61.55363739407685,10.0093487416768 61.55710292865028,10.016534688327836 61.512386940745444,9.922938931211405 61.50892782393349)))"
22350006830000,421,219,202,43.9,"MULTIPOLYGON(((10.016534688327836 61.512386940745444,10.0093487416768 61.55710292865028,10.103101806508901 61.56050424458344,10.110154087103455 61.51578195645209,10.016534688327836 61.512386940745444)))"
22400006830000,1652,793,859,46.4,"MULTIPOLYGON(((10.110154087103455 61.51578195645209,10.103101806508901 61.56050424458344,10.196878187577802 61.56384131050961,10.203796693477678 61.51911283982239,10.110154087103455 61.51578195645209)))"
22450006830000,8,6,2,29.9,"MULTIPOLYGON(((10.203796693477678 61.51911283982239,10.196878187577802 61.56384131050961,10.290677448147376 61.56711409564046,10.29746207271264 61.522379560201216,10.203796693477678 61.51911283982239)))"
22850006830000,743,389,354,48.8,"MULTIPOLYGON(((10.953720712896734 61.543447585496985,10.947876074667946 61.58822126501907,11.041842570904013 61.59097876516188,11.047552547221215 61.54619996781863,10.953720712896734 61.543447585496985)))"
22900006830000,600,278,322,50.4,"MULTIPOLYGON(((11.047552547221215 61.54619996781863,11.041842570904013 61.59097876516188,11.135827987339713 61.593671733613995,11.14140321331272 61.548887937341185,11.047552547221215 61.54619996781863)))"
22950006830000,12,5,7,44.9,"MULTIPOLYGON(((11.14140321331272 61.548887937341185,11.135827987339713 61.593671733613995,11.229831881095706 61.5963001454273,11.23527227033796 61.55151146922493,11.14140321331272 61.548887937341185)))"
23350006830000,2,1,1,0,"MULTIPOLYGON(((11.89283347528666 61.568069975406516,11.888339189246139 61.612889470544076,11.982474895186797 61.61500060199867,11.98683372755178 61.570177182528965,11.89283347528666 61.568069975406516)))"
23400006830000,18,10,8,33.7,"MULTIPOLYGON(((11.98683372755178 61.570177182528965,11.982474895186797 61.61500060199867,12.07662506954383 61.61704697889617,12.080848380440735 61.572219754955476,11.98683372755178 61.570177182528965)))"
23550006830000,2,2,0,0,"MULTIPOLYGON(((12.26891910500779 61.57611092056892,12.26496703208492 61.62094539353929,12.359157923531411 61.622797395037665,12.362974284126222 61.577959477666674,12.26891910500779 61.57611092056892)))"
19400006835000,1,0,1,0,"MULTIPOLYGON(((4.534449440399893 61.24412521265393,4.519590028692157 61.28826490554977,4.611349342202951 61.29539530588238,4.626084423252695 61.25124265315639,4.534449440399893 61.24412521265393)))"
19450006835000,225,119,106,44,"MULTIPOLYGON(((4.626084423252695 61.25124265315639,4.611349342202951 61.29539530588238,4.703156357489326 61.302464143727526,4.71776689226622 61.25829863726255,4.626084423252695 61.25124265315639)))"
19500006835000,12,7,5,42.2,"MULTIPOLYGON(((4.71776689226622 61.25829863726255,4.703156357489326 61.302464143727526,4.795010695455841 61.309471356380364,4.809496469902689 61.26529310252832,4.71776689226622 61.25829863726255)))"
19600006835000,41,20,21,41.2,"MULTIPOLYGON(((4.901272777338704 61.27222598699548,4.886911975711864 61.316416881623645,4.978859816579868 61.323300657729675,4.993095434473528 61.27909722919355,4.901272777338704 61.27222598699548)))"
19650006835000,159,84,75,44.4,"MULTIPOLYGON(((4.993095434473528 61.27909722919355,4.978859816579868 61.323300657729675,5.070853835103805 61.33012262346248,5.084964059937399 61.285906768141906,4.993095434473528 61.27909722919355)))"
19700006835000,237,128,109,51.7,"MULTIPOLYGON(((5.084964059937399 61.285906768141906,5.070853835103805 61.33012262346248,5.162893647057608 61.33688271807969,5.176878271099986 61.29265454335175,5.084964059937399 61.285906768141906)))"
19750006835000,111,60,51,48.7,"MULTIPOLYGON(((5.176878271099986 61.29265454335175,5.162893647057608 61.33688271807969,5.254978866953738 61.34358088133459,5.268837684078857 61.299340494828144,5.176878271099986 61.29265454335175)))"
19800006835000,384,150,234,28,"MULTIPOLYGON(((5.268837684078857 61.299340494828144,5.254978866953738 61.34358088133459,5.347109108051838 61.350217053478104,5.360841913748104 61.30596456307184,5.268837684078857 61.299340494828144)))"
19850006835000,384,197,187,41.8,"MULTIPOLYGON(((5.360841913748104 61.30596456307184,5.347109108051838 61.350217053478104,5.439283982367456 61.356791175260796,5.452890573747003 61.31252668908137,5.360841913748104 61.30596456307184)))"
19900006835000,58,30,28,46.2,"MULTIPOLYGON(((5.452890573747003 61.31252668908137,5.439283982367456 61.356791175260796,5.531503100680843 61.36330318793475,5.54498327648877 61.319026814355006,5.452890573747003 61.31252668908137)))"
19950006835000,90,48,42,45.9,"MULTIPOLYGON(((5.54498327648877 61.319026814355006,5.531503100680843 61.36330318793475,5.623766072545894 61.36975303325554,5.637119633169409 61.325464880892525,5.54498327648877 61.319026814355006)))"
20000006835000,140,72,68,41.3,"MULTIPOLYGON(((5.637119633169409 61.325464880892525,5.623766072545894 61.36975303325554,5.716072506299058 61.37614065348427,5.729299253776593 61.33184083119735,5.637119633169409 61.325464880892525)))"
20050006835000,264,147,117,42.9,"MULTIPOLYGON(((5.729299253776593 61.33184083119735,5.716072506299058 61.37614065348427,5.808422009068446 61.38246599138935,5.821521747098723 61.33815460827825,5.729299253776593 61.33184083119735)))"
20100006835000,35,19,16,41.8,"MULTIPOLYGON(((5.821521747098723 61.33815460827825,5.808422009068446 61.38246599138935,5.900814186782958 61.38872899024843,5.913786720733952 61.344406155651406,5.821521747098723 61.33815460827825)))"
20250006835000,4,3,1,0,"MULTIPOLYGON(((6.098442533440299 61.35672233788693,6.08572498482223 61.40106774649712,6.178242811092093 61.40714339300534,6.190832581839455 61.36278686233508,6.098442533440299 61.35672233788693)))"
20300006835000,63,34,29,43.2,"MULTIPOLYGON(((6.190832581839455 61.36278686233508,6.178242811092093 61.40714339300534,6.270801724216107 61.41315647870863,6.283263529226518 61.36878893625071,6.190832581839455 61.36278686233508)))"
20350006835000,24,12,12,29.3,"MULTIPOLYGON(((6.283263529226518 61.36878893625071,6.270801724216107 61.41315647870863,6.363401324266992 61.41910694945906,6.375734977387511 61.374728505714494,6.283263529226518 61.36878893625071)))"
20400006835000,53,24,29,45.4,"MULTIPOLYGON(((6.375734977387511 61.374728505714494,6.363401324266992 61.41910694945906,6.456041210174785 61.424994751629136,6.468246526974389 61.38060551732551,6.375734977387511 61.374728505714494)))"
20550006835000,90,42,48,44.6,"MULTIPOLYGON(((6.653388327421069 61.39217165598823,6.64144022962595 61.43658213833112,6.734198555403556 61.44228161822619,6.74601777400144 61.39786067884601,6.653388327421069 61.39217165598823)))"
20600006835000,126,67,59,44.2,"MULTIPOLYGON(((6.74601777400144 61.39786067884601,6.734198555403556 61.44228161822619,6.826995551526284 61.44791822027081,6.838685713468472 61.40348693546678,6.74601777400144 61.39786067884601)))"
20750006835000,4,3,1,0,"MULTIPOLYGON(((7.02413545049756 61.41455094739654,7.012703927177888 61.459002587344855,7.10561449019387 61.46445025197156,7.116916435099346 61.41998860272912,7.02413545049756 61.41455094739654)))"
20850006835000,9,5,4,46.9,"MULTIPOLYGON(((7.209734286687481 61.42536329187526,7.198562090549589 61.46983483794582,7.29154631733632 61.47515629640314,7.302588596149705 61.430674966178344,7.209734286687481 61.42536329187526)))"
20950006835000,255,123,132,47.9,"MULTIPOLYGON(((7.39547895333938 61.43592357751738,7.384566758603041 61.48041457901679,7.477623001366858 61.485609637999495,7.488404947085858 61.44110907830862,7.39547895333938 61.43592357751738)))"
21000006835000,20,15,5,60.8,"MULTIPOLYGON(((7.488404947085858 61.44110907830862,7.477623001366858 61.485609637999495,7.570714631623544 61.49074142610499,7.581366165204939 61.44623142150722,7.488404947085858 61.44110907830862)))"
21050006835000,98,54,44,45.1,"MULTIPOLYGON(((7.581366165204939 61.44623142150722,7.570714631623544 61.49074142610499,7.66384123435812 61.49580989662967,7.674362194509382 61.451290560608825,7.581366165204939 61.44623142150722)))"
21100006835000,37,20,17,61.4,"MULTIPOLYGON(((7.674362194509382 61.451290560608825,7.66384123435812 61.49580989662967,7.757002393555515 61.50081500341423,7.767392620819504 61.45628644965114,7.674362194509382 61.451290560608825)))"
21700006835000,4,2,2,0,"MULTIPOLYGON(((8.792878096109124 61.50705412725292,8.783935922449059 61.551676519115695,8.877478960848356 61.55591786081706,8.886288633967824 61.51128762993963,8.792878096109124 61.50705412725292)))"
22000006835000,39,19,20,58.4,"MULTIPOLYGON(((9.353766681908763 61.53149742432022,9.34562149678792 61.576165106427695,9.439332459252293 61.58002240224746,9.447344363340827 61.53534757978647,9.353766681908763 61.53149742432022)))"
22050006835000,152,82,70,44.9,"MULTIPOLYGON(((9.447344363340827 61.53534757978647,9.439332459252293 61.58002240224746,9.533069898553375 61.583815562715685,9.540948398369917 61.53913371689557,9.447344363340827 61.53534757978647)))"
22100006835000,76,36,40,46.1,"MULTIPOLYGON(((9.540948398369917 61.53913371689557,9.533069898553375 61.583815562715685,9.626833381016652 61.587544552868216,9.6345783552927 61.54285580083439,9.540948398369917 61.53913371689557)))"
22150006835000,427,229,198,42.9,"MULTIPOLYGON(((9.6345783552927 61.54285580083439,9.626833381016652 61.587544552868216,9.720622472206594 61.59120933831477,9.728233801650735 61.546513797361236,9.6345783552927 61.54285580083439)))"
22200006835000,865,445,420,46.7,"MULTIPOLYGON(((9.728233801650735 61.546513797361236,9.720622472206594 61.59120933831477,9.81443673693874 61.59480988524006,9.821914304242428 61.5501076728071,9.728233801650735 61.546513797361236)))"
22250006835000,931,465,466,43.5,"MULTIPOLYGON(((9.821914304242428 61.5501076728071,9.81443673693874 61.59480988524006,9.908275739291751 61.59834616040521,9.91561942913505 61.55363739407685,9.821914304242428 61.5501076728071)))"
22300006835000,699,346,353,49.4,"MULTIPOLYGON(((9.91561942913505 61.55363739407685,9.908275739291751 61.59834616040521,10.002139042619607 61.601818131148654,10.0093487416768 61.55710292865028,9.91561942913505 61.55363739407685)))"
22350006835000,148,83,65,41.3,"MULTIPOLYGON(((10.0093487416768 61.55710292865028,10.002139042619607 61.601818131148654,10.096026209563787 61.605225765387495,10.103101806508901 61.56050424458344,10.0093487416768 61.55710292865028)))"
22650006835000,5,3,2,60,"MULTIPOLYGON(((10.572208129518186 61.576546467075985,10.565804642656174 61.62129780675318,10.659825768421122 61.62431878076457,10.666094527508074 61.57956183274732,10.572208129518186 61.576546467075985)))"
22750006835000,2,2,0,0,"MULTIPOLYGON(((10.760001611510457 61.58251277239467,10.753867677379219 61.62727520998418,10.847929926917569 61.63016706699692,10.85392894095307 61.58539925872204,10.760001611510457 61.58251277239467)))"
22800006835000,29,19,10,43.8,"MULTIPOLYGON(((10.85392894095307 61.58539925872204,10.847929926917569 61.63016706699692,10.942012073822887 61.63299432497581,10.947876074667946 61.58822126501907,10.85392894095307 61.58539925872204)))"
22850006835000,17,7,10,35.2,"MULTIPOLYGON(((10.947876074667946 61.58822126501907,10.942012073822887 61.63299432497581,11.036113674294205 61.635756957682844,11.041842570904013 61.59097876516188,10.947876074667946 61.58822126501907)))"
22900006835000,6,3,3,28.5,"MULTIPOLYGON(((11.041842570904013 61.59097876516188,11.036113674294205 61.635756957682844,11.130234283955575 61.63845493947006,11.135827987339713 61.593671733613995,11.041842570904013 61.59097876516188)))"
22950006835000,1,0,1,0,"MULTIPOLYGON(((11.135827987339713 61.593671733613995,11.130234283955575 61.63845493947006,11.224373457868877 61.641088245280265,11.229831881095706 61.5963001454273,11.135827987339713 61.593671733613995)))"
23000006835000,1,1,0,0,"MULTIPOLYGON(((11.229831881095706 61.5963001454273,11.224373457868877 61.641088245280265,11.318530750546604 61.64365685064808,11.323853808747552 61.59886397624293,11.229831881095706 61.5963001454273)))"
23300006835000,1,0,1,0,"MULTIPOLYGON(((11.794218399044489 61.610713604148046,11.789573366506238 61.65552855609446,11.88382998739295 61.65770847828089,11.888339189246139 61.612889470544076,11.794218399044489 61.610713604148046)))"
23400006835000,81,43,38,48,"MULTIPOLYGON(((11.982474895186797 61.61500060199867,11.978101594333955 61.65982354540721,12.072387737912806 61.66187373777183,12.07662506954383 61.61704697889617,11.982474895186797 61.61500060199867)))"
19450006840000,29,15,14,35.5,"MULTIPOLYGON(((4.611349342202951 61.29539530588238,4.596566559160395 61.33954558498523,4.68849849981641 61.346627312128945,4.703156357489326 61.302464143727526,4.611349342202951 61.29539530588238)))"
19500006840000,123,66,57,50.6,"MULTIPOLYGON(((4.703156357489326 61.302464143727526,4.68849849981641 61.346627312128945,4.780477978504993 61.35364730746563,4.795010695455841 61.309471356380364,4.703156357489326 61.302464143727526)))"
19600006840000,115,64,51,44.6,"MULTIPOLYGON(((4.886911975711864 61.316416881623645,4.872504613259958 61.360605508517516,4.964578020818592 61.367501853298286,4.978859816579868 61.323300657729675,4.886911975711864 61.316416881623645)))"
19650006840000,424,207,217,45.1,"MULTIPOLYGON(((4.978859816579868 61.323300657729675,4.964578020818592 61.367501853298286,5.05669781663009 61.37433628031506,5.070853835103805 61.33012262346248,4.978859816579868 61.323300657729675)))"
19700006840000,707,344,363,46.1,"MULTIPOLYGON(((5.070853835103805 61.33012262346248,5.05669781663009 61.37433628031506,5.148863614864092 61.38110872857044,5.162893647057608 61.33688271807969,5.070853835103805 61.33012262346248)))"
19750006840000,387,196,191,43.8,"MULTIPOLYGON(((5.162893647057608 61.33688271807969,5.148863614864092 61.38110872857044,5.241075028419296 61.38781913756456,5.254978866953738 61.34358088133459,5.162893647057608 61.33688271807969)))"
19800006840000,119,65,54,42,"MULTIPOLYGON(((5.254978866953738 61.34358088133459,5.241075028419296 61.38781913756456,5.33333166893217 61.394467447297004,5.347109108051838 61.350217053478104,5.254978866953738 61.34358088133459)))"
19850006840000,1244,630,614,39.3,"MULTIPOLYGON(((5.347109108051838 61.350217053478104,5.33333166893217 61.394467447297004,5.425633146785722 61.40105359826885,5.439283982367456 61.356791175260796,5.347109108051838 61.350217053478104)))"
19900006840000,62,33,29,46.2,"MULTIPOLYGON(((5.439283982367456 61.356791175260796,5.425633146785722 61.40105359826885,5.517979071118359 61.40757753148468,5.531503100680843 61.36330318793475,5.439283982367456 61.356791175260796)))"
19950006840000,42,25,17,47.3,"MULTIPOLYGON(((5.531503100680843 61.36330318793475,5.517979071118359 61.40757753148468,5.610369049832867 61.41403918845443,5.623766072545894 61.36975303325554,5.531503100680843 61.36330318793475)))"
20000006840000,514,279,235,42.8,"MULTIPOLYGON(((5.623766072545894 61.36975303325554,5.610369049832867 61.41403918845443,5.702802689605422 61.420438511195464,5.716072506299058 61.37614065348427,5.623766072545894 61.36975303325554)))"
20050006840000,205,111,94,38.3,"MULTIPOLYGON(((5.716072506299058 61.37614065348427,5.702802689605422 61.420438511195464,5.795279595894716 61.42677544223435,5.808422009068446 61.38246599138935,5.716072506299058 61.37614065348427)))"
20100006840000,104,61,43,36,"MULTIPOLYGON(((5.808422009068446 61.38246599138935,5.795279595894716 61.42677544223435,5.887799372951154 61.43304992460895,5.900814186782958 61.38872899024843,5.808422009068446 61.38246599138935)))"
20150006840000,1211,652,559,34.3,"MULTIPOLYGON(((5.900814186782958 61.38872899024843,5.887799372951154 61.43304992460895,5.980361623826128 61.439261901870225,5.993248644181482 61.39492959385041,5.900814186782958 61.38872899024843)))"
20200006840000,137,73,64,36.9,"MULTIPOLYGON(((5.993248644181482 61.39492959385041,5.980361623826128 61.439261901870225,6.072965950381404 61.4454113180841,6.08572498482223 61.40106774649712,5.993248644181482 61.39492959385041)))"
20250006840000,185,103,82,43.1,"MULTIPOLYGON(((6.08572498482223 61.40106774649712,6.072965950381404 61.4454113180841,6.165611953298522 61.45149811783346,6.178242811092093 61.40714339300534,6.08572498482223 61.40106774649712)))"
20300006840000,7,5,2,32,"MULTIPOLYGON(((6.178242811092093 61.40714339300534,6.165611953298522 61.45149811783346,6.258299232088368 61.45752224621983,6.270801724216107 61.41315647870863,6.178242811092093 61.40714339300534)))"
20350006840000,4,2,2,0,"MULTIPOLYGON(((6.270801724216107 61.41315647870863,6.258299232088368 61.45752224621983,6.351027385100736 61.463483648865456,6.363401324266992 61.41910694945906,6.270801724216107 61.41315647870863)))"
20400006840000,29,15,14,44.5,"MULTIPOLYGON(((6.363401324266992 61.41910694945906,6.351027385100736 61.463483648865456,6.443796009534035 61.46938227191494,6.456041210174785 61.424994751629136,6.363401324266992 61.41910694945906)))"
20600006840000,12,6,6,48.5,"MULTIPOLYGON(((6.734198555403556 61.44228161822619,6.722340666278291 61.48670093280692,6.815267125694874 61.49234790942965,6.826995551526284 61.44791822027081,6.734198555403556 61.44228161822619)))"
20700006840000,35,20,15,38.4,"MULTIPOLYGON(((6.919830811357673 61.45349189346628,6.908232025597942 61.497931845078774,7.001234956485272 61.50345268907107,7.012703927177888 61.459002587344855,6.919830811357673 61.45349189346628)))"
20750006840000,85,39,46,43.6,"MULTIPOLYGON(((7.012703927177888 61.459002587344855,7.001234956485272 61.50345268907107,7.094275507773211 61.50891039125822,7.10561449019387 61.46445025197156,7.012703927177888 61.459002587344855)))"
20850006840000,28,15,13,44,"MULTIPOLYGON(((7.198562090549589 61.46983483794582,7.187353267806957 61.5143049020284,7.280467823870969 61.519636172308026,7.29154631733632 61.47515629640314,7.198562090549589 61.46983483794582)))"
20900006840000,12,8,4,40.7,"MULTIPOLYGON(((7.29154631733632 61.47515629640314,7.280467823870969 61.519636172308026,7.373618762199379 61.52490415356343,7.384566758603041 61.48041457901679,7.29154631733632 61.47515629640314)))"
20950006840000,5,3,2,36.2,"MULTIPOLYGON(((7.384566758603041 61.48041457901679,7.373618762199379 61.52490415356343,7.466805667986532 61.53010879780258,7.477623001366858 61.485609637999495,7.384566758603041 61.48041457901679)))"
21050006840000,173,89,84,42,"MULTIPOLYGON(((7.570714631623544 61.49074142610499,7.560028125397576 61.5352500575766,7.653285717579134 61.54032788598147,7.66384123435812 61.49580989662967,7.570714631623544 61.49074142610499)))"
21100006840000,75,41,34,42.7,"MULTIPOLYGON(((7.66384123435812 61.49580989662967,7.653285717579134 61.54032788598147,7.746578026670028 61.54534223665967,7.757002393555515 61.50081500341423,7.66384123435812 61.49580989662967)))"
22050006840000,3,2,1,0,"MULTIPOLYGON(((9.439332459252293 61.58002240224746,9.431294078198212 61.62469632137734,9.525165355447802 61.62849652534153,9.533069898553375 61.583815562715685,9.439332459252293 61.58002240224746)))"
22150006840000,244,124,120,38.2,"MULTIPOLYGON(((9.626833381016652 61.587544552868216,9.619062797889095 61.63223244151812,9.712985969097447 61.63590403536728,9.720622472206594 61.59120933831477,9.626833381016652 61.587544552868216)))"
22200006840000,2435,1188,1247,44.8,"MULTIPOLYGON(((9.720622472206594 61.59120933831477,9.712985969097447 61.63590403536728,9.806934431893396 61.639511272926676,9.81443673693874 61.59480988524006,9.720622472206594 61.59120933831477)))"
22250006840000,7,3,4,48.3,"MULTIPOLYGON(((9.81443673693874 61.59480988524006,9.806934431893396 61.639511272926676,9.90090774835486 61.64305412081273,9.908275739291751 61.59834616040521,9.81443673693874 61.59480988524006)))"
22300006840000,66,41,25,48.3,"MULTIPOLYGON(((9.908275739291751 61.59834616040521,9.90090774835486 61.64305412081273,9.994905479829383 61.6465325462217,10.002139042619607 61.601818131148654,9.908275739291751 61.59834616040521)))"
22350006840000,28,13,15,49.8,"MULTIPOLYGON(((10.002139042619607 61.601818131148654,9.994905479829383 61.6465325462217,10.088927186946439 61.649946516930896,10.096026209563787 61.605225765387495,10.002139042619607 61.601818131148654)))"
22400006840000,23,12,11,42.9,"MULTIPOLYGON(((10.096026209563787 61.605225765387495,10.088927186946439 61.649946516930896,10.182972429629777 61.65329600129984,10.189936802065544 61.60856903161856,10.096026209563787 61.605225765387495)))"
22800006840000,32,19,13,44.4,"MULTIPOLYGON(((10.847929926917569 61.63016706699692,10.841911015417143 61.67493423932199,10.936128619316007 61.67776676413435,10.942012073822887 61.63299432497581,10.847929926917569 61.63016706699692)))"
22950006840000,52,26,26,57.9,"MULTIPOLYGON(((11.130234283955575 61.63845493947006,11.12462201622794 61.68323755381511,11.218896915788196 61.685875767756386,11.224373457868877 61.641088245280265,11.130234283955575 61.63845493947006)))"
23000006840000,23,9,14,50.8,"MULTIPOLYGON(((11.224373457868877 61.641088245280265,11.218896915788196 61.685875767756386,11.313190019517975 61.68844916147014,11.318530750546604 61.64365685064808,11.224373457868877 61.641088245280265)))"
23150006840000,1,1,0,0,"MULTIPOLYGON(((11.50689790757566 61.64859986515904,11.501829046541657 61.693401392901734,11.596174072056984 61.695780184453874,11.601106878321021 61.650974228337994,11.50689790757566 61.64859986515904)))"
23250006840000,18,10,8,56.2,"MULTIPOLYGON(((11.695332180644794 61.65328379914777,11.690535506210802 61.69809406344874,11.784912898866285 61.700343008298155,11.789573366506238 61.65552855609446,11.695332180644794 61.65328379914777)))"
23300006840000,7,4,3,47,"MULTIPOLYGON(((11.789573366506238 61.65552855609446,11.784912898866285 61.700343008298155,11.879305799411222 61.70252699801319,11.88382998739295 61.65770847828089,11.789573366506238 61.65552855609446)))"
23400006840000,88,44,44,47.1,"MULTIPOLYGON(((11.978101594333955 61.65982354540721,11.973713756771206 61.70464601220494,12.068136319422834 61.70670003108525,12.072387737912806 61.66187373777183,11.978101594333955 61.65982354540721)))"
19650006845000,64,32,32,44.8,"MULTIPOLYGON(((4.964578020818592 61.367501853298286,4.950249836591199 61.41170080716585,5.042495795522047 61.418547730122654,5.05669781663009 61.37433628031506,4.964578020818592 61.367501853298286)))"
19700006845000,26,10,16,52,"MULTIPOLYGON(((5.05669781663009 61.37433628031506,5.042495795522047 61.418547730122654,5.134787967138998 61.4253325664025,5.148863614864092 61.38110872857044,5.05669781663009 61.37433628031506)))"
19750006845000,58,29,29,41.8,"MULTIPOLYGON(((5.148863614864092 61.38110872857044,5.134787967138998 61.4253325664025,5.227125962718278 61.432055255250916,5.241075028419296 61.38781913756456,5.148863614864092 61.38110872857044)))"
19800006845000,6,3,3,74,"MULTIPOLYGON(((5.241075028419296 61.38781913756456,5.227125962718278 61.432055255250916,5.319509392264404 61.438715736414665,5.33333166893217 61.394467447297004,5.241075028419296 61.38781913756456)))"
19850006845000,1,1,0,0,"MULTIPOLYGON(((5.33333166893217 61.394467447297004,5.319509392264404 61.438715736414665,5.41193786451896 61.445313950143984,5.425633146785722 61.40105359826885,5.33333166893217 61.394467447297004)))"
19900006845000,38,21,17,48.9,"MULTIPOLYGON(((5.425633146785722 61.40105359826885,5.41193786451896 61.445313950143984,5.504410986969566 61.45184983719442,5.517979071118359 61.40757753148468,5.425633146785722 61.40105359826885)))"
19950006845000,29,14,15,42.1,"MULTIPOLYGON(((5.517979071118359 61.40757753148468,5.504410986969566 61.45184983719442,5.596928365858878 61.458323338828855,5.610369049832867 61.41403918845443,5.517979071118359 61.40757753148468)))"
20000006845000,136,67,69,43.4,"MULTIPOLYGON(((5.610369049832867 61.41403918845443,5.596928365858878 61.458323338828855,5.689489606193669 61.46473439681946,5.702802689605422 61.420438511195464,5.610369049832867 61.41403918845443)))"
20050006845000,24,12,12,48.5,"MULTIPOLYGON(((5.702802689605422 61.420438511195464,5.689489606193669 61.46473439681946,5.782094311754013 61.471082953449645,5.795279595894716 61.42677544223435,5.702802689605422 61.420438511195464)))"
20100006845000,6754,3383,3371,40.3,"MULTIPOLYGON(((5.795279595894716 61.42677544223435,5.782094311754013 61.471082953449645,5.874742085102537 61.47736895151598,5.887799372951154 61.43304992460895,5.795279595894716 61.42677544223435)))"
20150006845000,3892,1919,1973,37.1,"MULTIPOLYGON(((5.887799372951154 61.43304992460895,5.874742085102537 61.47736895151598,5.967432527593782 61.48359233433016,5.980361623826128 61.439261901870225,5.887799372951154 61.43304992460895)))"
20200006845000,442,233,209,36.1,"MULTIPOLYGON(((5.980361623826128 61.439261901870225,5.967432527593782 61.48359233433016,6.06016523938361 61.48975304572081,6.072965950381404 61.4454113180841,5.980361623826128 61.439261901870225)))"
20250006845000,871,461,410,39.9,"MULTIPOLYGON(((6.072965950381404 61.4454113180841,6.06016523938361 61.48975304572081,6.152939819438717 61.495851030035475,6.165611953298522 61.45149811783346,6.072965950381404 61.4454113180841)))"
20500006845000,12,5,7,55.3,"MULTIPOLYGON(((6.53660470144505 61.47521806203708,6.524448760563917 61.51961460175052,6.617426625500444 61.52539813418959,6.629453055758762 61.48099096642683,6.53660470144505 61.47521806203708)))"
20550006845000,5,2,3,44,"MULTIPOLYGON(((6.629453055758762 61.48099096642683,6.617426625500444 61.52539813418959,6.710443928072343 61.53111861663835,6.722340666278291 61.48670093280692,6.629453055758762 61.48099096642683)))"
20700006845000,5,2,3,42.8,"MULTIPOLYGON(((6.908232025597942 61.497931845078774,6.89659520867371 61.54237022422408,6.989728365213532 61.54790124702589,7.001234956485272 61.50345268907107,6.908232025597942 61.497931845078774)))"
20850006845000,22,12,10,58.8,"MULTIPOLYGON(((7.187353267806957 61.5143049020284,7.176107648859013 61.55877347883436,7.269352947967918 61.56411458873279,7.280467823870969 61.519636172308026,7.187353267806957 61.5143049020284)))"
20900006845000,75,38,37,49.1,"MULTIPOLYGON(((7.280467823870969 61.519636172308026,7.269352947967918 61.56411458873279,7.362634798165438 61.569392296124235,7.373618762199379 61.52490415356343,7.280467823870969 61.519636172308026)))"
21050006845000,7,3,4,59.6,"MULTIPOLYGON(((7.560028125397576 61.5352500575766,7.549306484233136 61.579757311139296,7.642695483724652 61.58484452400466,7.653285717579134 61.54032788598147,7.560028125397576 61.5352500575766)))"
21150006845000,4,3,1,0,"MULTIPOLYGON(((7.746578026670028 61.54534223665967,7.736119361569018 61.58986814484976,7.829577697043454 61.59482812766797,7.8399046338121 61.55029306380174,7.746578026670028 61.54534223665967)))"
21800006845000,4,2,2,0,"MULTIPOLYGON(((8.962345390326789 61.604732233906994,8.953610951818312 61.64936816692255,9.047478513824927 61.653496921986765,9.056079322513174 61.608853338585256,8.962345390326789 61.604732233906994)))"
21900006845000,20,10,10,47.2,"MULTIPOLYGON(((9.149841590269418 61.61291033679439,9.141374544112315 61.65756145357044,9.235298608240505 61.66156172410234,9.243631761125892 61.616903191125694,9.149841590269418 61.61291033679439)))"
21950006845000,1,1,0,0,"MULTIPOLYGON(((9.243631761125892 61.616903191125694,9.235298608240505 61.66156172410234,9.329250270948219 61.66549769658491,9.337449401798022 61.62083186474166,9.243631761125892 61.616903191125694)))"
22100006845000,133,67,66,44.7,"MULTIPOLYGON(((9.525165355447802 61.62849652534153,9.5172346470227 61.67317660228741,9.611266485868686 61.67691946439195,9.619062797889095 61.63223244151812,9.525165355447802 61.62849652534153)))"
22150006845000,863,435,428,45.7,"MULTIPOLYGON(((9.619062797889095 61.63223244151812,9.611266485868686 61.67691946439195,9.705324174276935 61.68059788621874,9.712985969097447 61.63590403536728,9.619062797889095 61.63223244151812)))"
22200006845000,165,83,82,45.9,"MULTIPOLYGON(((9.712985969097447 61.63590403536728,9.705324174276935 61.68059788621874,9.79940727306081 61.68421183365751,9.806934431893396 61.639511272926676,9.712985969097447 61.63590403536728)))"
22300006845000,27,15,12,48.4,"MULTIPOLYGON(((9.90090774835486 61.64305412081273,9.893515342285227 61.68776127317907,9.987647941279008 61.691246171836625,9.994905479829383 61.6465325462217,9.90090774835486 61.64305412081273)))"
22400006845000,14,8,6,45.4,"MULTIPOLYGON(((10.088927186946439 61.649946516930896,10.081804628647255 61.694666497266894,10.175984962283813 61.69802221769125,10.182972429629777 61.65329600129984,10.088927186946439 61.649946516930896)))"
22650006845000,5,3,2,76.4,"MULTIPOLYGON(((10.559379930496874 61.666048463002014,10.552933893197315 61.710798434282914,10.647225802566757 61.71383067353945,10.653536226038849 61.66907506151622,10.559379930496874 61.666048463002014)))"
22800006845000,16,9,7,63.9,"MULTIPOLYGON(((10.841911015417143 61.67493423932199,10.83587211276862 61.71970077438331,10.930225619526768 61.722538581252806,10.936128619316007 61.67776676413435,10.841911015417143 61.67493423932199)))"
22950006845000,244,124,120,49.6,"MULTIPOLYGON(((11.12462201622794 61.68323755381511,11.118991096675073 61.72801957554664,11.213402169447868 61.73066271182056,11.218896915788196 61.685875767756386,11.12462201622794 61.68323755381511)))"
23000006845000,61,31,30,53.7,"MULTIPOLYGON(((11.218896915788196 61.685875767756386,11.213402169447868 61.73066271182056,11.307831532336035 61.733240907739734,11.313190019517975 61.68844916147014,11.218896915788196 61.685875767756386)))"
23050006845000,3,2,1,0,"MULTIPOLYGON(((11.313190019517975 61.68844916147014,11.307831532336035 61.733240907739734,11.402278735142254 61.73575413922158,11.407500879313103 61.69095771097903,11.313190019517975 61.68844916147014)))"
23250006845000,7,5,2,58.1,"MULTIPOLYGON(((11.690535506210802 61.69809406344874,11.685722873195914 61.7429038152021,11.780236923259842 61.74515696009418,11.784912898866285 61.700343008298155,11.690535506210802 61.69809406344874)))"
23350006845000,5,2,3,29.8,"MULTIPOLYGON(((11.879305799411222 61.70252699801319,11.874766554539626 61.74734502913213,11.969311313844196 61.749468001837364,11.973713756771206 61.70464601220494,11.879305799411222 61.70252699801319)))"
23400006845000,35,16,19,54.1,"MULTIPOLYGON(((11.973713756771206 61.70464601220494,11.969311313844196 61.749468001837364,12.063870747529947 61.751525858334794,12.068136319422834 61.70670003108525,11.973713756771206 61.70464601220494)))"
19650006850000,7,3,4,65.4,"MULTIPOLYGON(((4.950249836591199 61.41170080716585,4.935875052019574 61.455897510544254,5.028247561514484 61.46275696425455,5.042495795522047 61.418547730122654,4.950249836591199 61.41170080716585)))"
19700006850000,46,22,24,53.5,"MULTIPOLYGON(((5.042495795522047 61.418547730122654,5.028247561514484 61.46275696425455,5.120666495239595 61.46955422310158,5.134787967138998 61.4253325664025,5.042495795522047 61.418547730122654)))"
19750006850000,67,31,36,44.9,"MULTIPOLYGON(((5.134787967138998 61.4253325664025,5.120666495239595 61.46955422310158,5.213131462839934 61.476289226074655,5.227125962718278 61.432055255250916,5.134787967138998 61.4253325664025)))"
19800006850000,73,44,29,48.5,"MULTIPOLYGON(((5.227125962718278 61.432055255250916,5.213131462839934 61.476289226074655,5.305642072679195 61.4829619126664,5.319509392264404 61.438715736414665,5.227125962718278 61.432055255250916)))"
19850006850000,97,47,50,37.6,"MULTIPOLYGON(((5.319509392264404 61.438715736414665,5.305642072679195 61.4829619126664,5.398197931848642 61.4895722228746,5.41193786451896 61.445313950143984,5.319509392264404 61.438715736414665)))"
19900006850000,175,93,82,43.9,"MULTIPOLYGON(((5.41193786451896 61.445313950143984,5.398197931848642 61.4895722228746,5.490798646176085 61.4961200972044,5.504410986969566 61.45184983719442,5.41193786451896 61.445313950143984)))"
19950006850000,124,65,59,46.5,"MULTIPOLYGON(((5.504410986969566 61.45184983719442,5.490798646176085 61.4961200972044,5.583443820234954 61.50260547667016,5.596928365858878 61.458323338828855,5.504410986969566 61.45184983719442)))"
20000006850000,109,54,55,42.8,"MULTIPOLYGON(((5.596928365858878 61.458323338828855,5.583443820234954 61.50260547667016,5.676133057353446 61.50902830279745,5.689489606193669 61.46473439681946,5.596928365858878 61.458323338828855)))"
20050006850000,721,378,343,42.2,"MULTIPOLYGON(((5.689489606193669 61.46473439681946,5.676133057353446 61.50902830279745,5.768865959623758 61.51538851762507,5.782094311754013 61.471082953449645,5.689489606193669 61.46473439681946)))"
20100006850000,320,170,150,39,"MULTIPOLYGON(((5.782094311754013 61.471082953449645,5.768865959623758 61.51538851762507,5.861642127911409 61.521686063706944,5.874742085102537 61.47736895151598,5.782094311754013 61.471082953449645)))"
20150006850000,33,14,19,36.2,"MULTIPOLYGON(((5.874742085102537 61.47736895151598,5.861642127911409 61.521686063706944,5.954461161864651 61.527920884114025,5.967432527593782 61.48359233433016,5.874742085102537 61.47736895151598)))"
20200006850000,267,155,112,37,"MULTIPOLYGON(((5.967432527593782 61.48359233433016,5.954461161864651 61.527920884114025,6.047322659923946 61.53409292243625,6.06016523938361 61.48975304572081,5.967432527593782 61.48359233433016)))"
20250006850000,212,106,106,36.8,"MULTIPOLYGON(((6.06016523938361 61.48975304572081,6.047322659923946 61.53409292243625,6.140226219331534 61.540202122784535,6.152939819438717 61.495851030035475,6.06016523938361 61.48975304572081)))"
20300006850000,176,95,81,42.3,"MULTIPOLYGON(((6.152939819438717 61.495851030035475,6.140226219331534 61.540202122784535,6.233171436141092 61.54624842979245,6.245755865546205 61.50188623214248,6.152939819438717 61.495851030035475)))"
20350006850000,213,116,97,42.4,"MULTIPOLYGON(((6.245755865546205 61.50188623214248,6.233171436141092 61.54624842979245,6.326157905227466 61.55223178861827,6.33861297432327 61.507858597432666,6.245755865546205 61.50188623214248)))"
20400006850000,119,63,56,45.7,"MULTIPOLYGON(((6.33861297432327 61.507858597432666,6.326157905227466 61.55223178861827,6.419185220296474 61.55815214494682,6.431510741226943 61.513768071821474,6.33861297432327 61.507858597432666)))"
20450006850000,91,49,42,41.6,"MULTIPOLYGON(((6.431510741226943 61.513768071821474,6.419185220296474 61.55815214494682,6.512252973894814 61.5640094449912,6.524448760563917 61.51961460175052,6.431510741226943 61.513768071821474)))"
20900006850000,67,38,29,44,"MULTIPOLYGON(((7.269352947967918 61.56411458873279,7.258201520801616 61.608591540484035,7.351614699509035 61.61387900163368,7.362634798165438 61.569392296124235,7.269352947967918 61.56411458873279)))"
21500006850000,4,3,1,0,"MULTIPOLYGON(((8.39102763583226 61.623249119373895,8.381462829324713 61.66783554864962,8.475283726804443 61.67235719644419,8.484715312404838 61.62776239437167,8.39102763583226 61.623249119373895)))"
21900006850000,34,19,15,56,"MULTIPOLYGON(((9.141374544112315 61.65756145357044,9.132879463977519 61.70221159888648,9.226937856640692 61.706219306929306,9.235298608240505 61.66156172410234,9.141374544112315 61.65756145357044)))"
22000006850000,7,4,3,59.9,"MULTIPOLYGON(((9.329250270948219 61.66549769658491,9.321023977456585 61.71016259926212,9.415137388359584 61.71404143930354,9.423229096164897 61.6693693345954,9.329250270948219 61.66549769658491)))"
22050006850000,200,104,96,49.2,"MULTIPOLYGON(((9.423229096164897 61.6693693345954,9.415137388359584 61.71404143930354,9.509277650480593 61.717855791050916,9.5172346470227 61.67317660228741,9.423229096164897 61.6693693345954)))"
22100006850000,255,142,113,43,"MULTIPOLYGON(((9.5172346470227 61.67317660228741,9.509277650480593 61.717855791050916,9.603444324159213 61.72160561908146,9.611266485868686 61.67691946439195,9.5172346470227 61.67317660228741)))"
22150006850000,41,20,21,46,"MULTIPOLYGON(((9.611266485868686 61.67691946439195,9.603444324159213 61.72160561908146,9.697636968956047 61.72529088855357,9.705324174276935 61.68059788621874,9.611266485868686 61.67691946439195)))"
22200006850000,8,3,5,38.5,"MULTIPOLYGON(((9.705324174276935 61.68059788621874,9.697636968956047 61.72529088855357,9.79185514366499 61.72891156520806,9.79940727306081 61.68421183365751,9.705324174276935 61.68059788621874)))"
22700006850000,2,1,1,0,"MULTIPOLYGON(((10.647225802566757 61.71383067353945,10.640894399592485 61.75858561536103,10.735343447333673 61.76155860855734,10.74153869133459 61.71679812945807,10.647225802566757 61.71383067353945)))"
22750006850000,81,48,33,57.1,"MULTIPOLYGON(((10.74153869133459 61.71679812945807,10.735343447333673 61.76155860855734,10.829813124696473 61.76446667085745,10.83587211276862 61.71970077438331,10.74153869133459 61.71679812945807)))"
22800006850000,22,13,9,51.1,"MULTIPOLYGON(((10.83587211276862 61.71970077438331,10.829813124696473 61.76446667085745,10.924302982255135 61.76730977508032,10.930225619526768 61.722538581252806,10.83587211276862 61.71970077438331)))"
22950006850000,378,179,199,53.2,"MULTIPOLYGON(((11.118991096675073 61.72801957554664,11.113341437261505 61.77280100355407,11.20788913290132 61.775449076429865,11.213402169447868 61.73066271182056,11.118991096675073 61.72801957554664)))"
23000006850000,34,19,15,52,"MULTIPOLYGON(((11.213402169447868 61.73066271182056,11.20788913290132 61.775449076429865,11.30245520514739 61.77803208848007,11.307831532336035 61.733240907739734,11.213402169447868 61.73066271182056)))"
23250006850000,19,10,9,67.5,"MULTIPOLYGON(((11.685722873195914 61.7429038152021,11.68089420616011 61.78771305367952,11.7755453663599 61.789970410812245,11.780236923259842 61.74515696009418,11.685722873195914 61.7429038152021)))"
23350006850000,173,89,84,48,"MULTIPOLYGON(((11.874766554539626 61.74734502913213,11.870212181567808 61.79216257102381,11.964894196462799 61.79428951374547,11.969311313844196 61.749468001837364,11.874766554539626 61.74734502913213)))"
23400006850000,8,4,4,67.6,"MULTIPOLYGON(((11.969311313844196 61.749468001837364,11.964894196462799 61.79428951374547,12.059590955267709 61.79635121901447,12.063870747529947 61.751525858334794,11.969311313844196 61.749468001837364)))"
19650006855000,32,17,15,44.5,"MULTIPOLYGON(((4.935875052019574 61.455897510544254,4.921453453936437 61.50009195459016,5.013952903061697 61.506963974025815,5.028247561514484 61.46275696425455,4.935875052019574 61.455897510544254)))"
19700006855000,12,7,5,57.4,"MULTIPOLYGON(((5.028247561514484 61.46275696425455,5.013952903061697 61.506963974025815,5.106498989251418 61.51377369014001,5.120666495239595 61.46955422310158,5.028247561514484 61.46275696425455)))"
19750006855000,57,29,28,51.2,"MULTIPOLYGON(((5.120666495239595 61.46955422310158,5.106498989251418 61.51377369014001,5.199091320510593 61.52052104166443,5.213131462839934 61.476289226074655,5.120666495239595 61.46955422310158)))"
19800006855000,112,56,56,49.9,"MULTIPOLYGON(((5.213131462839934 61.476289226074655,5.199091320510593 61.52052104166443,5.291729503553225 61.52720596783591,5.305642072679195 61.4829619126664,5.213131462839934 61.476289226074655)))"
19850006855000,91,48,43,49.1,"MULTIPOLYGON(((5.305642072679195 61.4829619126664,5.291729503553225 61.52720596783591,5.384413143811262 61.5338284083985,5.398197931848642 61.4895722228746,5.305642072679195 61.4829619126664)))"
19900006855000,49,21,28,43.5,"MULTIPOLYGON(((5.398197931848642 61.4895722228746,5.384413143811262 61.5338284083985,5.47714184544364 61.540388303605376,5.490798646176085 61.4961200972044,5.398197931848642 61.4895722228746)))"
19950006855000,15,8,7,52.5,"MULTIPOLYGON(((5.490798646176085 61.4961200972044,5.47714184544364 61.540388303605376,5.569915211345414 61.546885594220946,5.583443820234954 61.50260547667016,5.490798646176085 61.4961200972044)))"
20050006855000,902,477,425,39,"MULTIPOLYGON(((5.676133057353446 61.50902830279745,5.66273284315696 61.55332022152276,5.755594341273285 61.559692127303535,5.768865959623758 61.51538851762507,5.676133057353446 61.50902830279745)))"
20100006855000,319,167,152,40.9,"MULTIPOLYGON(((5.768865959623758 61.51538851762507,5.755594341273285 61.559692127303535,5.848499304853394 61.56600125387311,5.861642127911409 61.521686063706944,5.768865959623758 61.51538851762507)))"
20200006855000,15,6,9,46.9,"MULTIPOLYGON(((5.954461161864651 61.527920884114025,5.941447331829763 61.572247544060346,6.034438018917887 61.57843094121511,6.047322659923946 61.53409292243625,5.954461161864651 61.527920884114025)))"
20250006855000,16,6,10,33.2,"MULTIPOLYGON(((6.047322659923946 61.53409292243625,6.034438018917887 61.57843094121511,6.127470961625902 61.58455138921014,6.140226219331534 61.540202122784535,6.047322659923946 61.53409292243625)))"
20350006855000,5,3,2,64.8,"MULTIPOLYGON(((6.233171436141092 61.54624842979245,6.220545754264333 61.590608832443074,6.313661989955839 61.596603215838115,6.326157905227466 61.55223178861827,6.233171436141092 61.54624842979245)))"
20400006855000,132,64,68,50.5,"MULTIPOLYGON(((6.326157905227466 61.55223178861827,6.313661989955839 61.596603215838115,6.406819260645152 61.60253448484815,6.419185220296474 61.55815214494682,6.326157905227466 61.55223178861827)))"
20450006855000,601,302,299,41.3,"MULTIPOLYGON(((6.419185220296474 61.55815214494682,6.406819260645152 61.60253448484815,6.500017157108991 61.608402585456396,6.512252973894814 61.5640094449912,6.419185220296474 61.55815214494682)))"
20500006855000,88,43,45,45.1,"MULTIPOLYGON(((6.512252973894814 61.5640094449912,6.500017157108991 61.608402585456396,6.593255268966125 61.61420746417841,6.605360757420024 61.56980363549473,6.512252973894814 61.5640094449912)))"
20550006855000,71,39,32,42.9,"MULTIPOLYGON(((6.605360757420024 61.56980363549473,6.593255268966125 61.61420746417841,6.686533184687505 61.61994906806378,6.698508161130552 61.57553466373274,6.605360757420024 61.56980363549473)))"
20600006855000,40,19,21,44.3,"MULTIPOLYGON(((6.698508161130552 61.57553466373274,6.686533184687505 61.61994906806378,6.779850491606439 61.62562734469807,6.791694774155866 61.58120247751434,6.698508161130552 61.57553466373274)))"
20850006855000,47,21,26,44.9,"MULTIPOLYGON(((7.164825063054831 61.60324056304106,7.153505338685085 61.64770614929148,7.247013372498701 61.65306702233465,7.258201520801616 61.608591540484035,7.164825063054831 61.60324056304106)))"
20900006855000,108,56,52,47.1,"MULTIPOLYGON(((7.258201520801616 61.608591540484035,7.247013372498701 61.65306702233465,7.340558298200856 61.658364264993345,7.351614699509035 61.61387900163368,7.258201520801616 61.608591540484035)))"
21400006855000,20,9,11,51.8,"MULTIPOLYGON(((8.193916361542353 61.65860011337664,8.184053066276077 61.70316824255566,8.27794362213486 61.70782659887624,8.287673564446491 61.66324984019597,8.193916361542353 61.65860011337664)))"
21450006855000,4,2,2,0,"MULTIPOLYGON(((8.287673564446491 61.66324984019597,8.27794362213486 61.70782659887624,8.371866390061957 61.71242082057057,8.381462829324713 61.66783554864962,8.287673564446491 61.66324984019597)))"
21850006855000,57,25,32,43,"MULTIPOLYGON(((9.038849236717036 61.69813951229224,9.030191357644254 61.742781106486035,9.124356218302081 61.74686076982903,9.132879463977519 61.70221159888648,9.038849236717036 61.69813951229224)))"
21900006855000,141,77,64,48.9,"MULTIPOLYGON(((9.132879463977519 61.70221159888648,9.124356218302081 61.74686076982903,9.218549376752224 61.75087593679388,9.226937856640692 61.706219306929306,9.132879463977519 61.70221159888648)))"
21950006855000,145,77,68,45.9,"MULTIPOLYGON(((9.226937856640692 61.706219306929306,9.218549376752224 61.75087593679388,9.312770393743925 61.75482657005986,9.321023977456585 61.71016259926212,9.226937856640692 61.706219306929306)))"
22000006855000,279,137,142,42.7,"MULTIPOLYGON(((9.321023977456585 61.71016259926212,9.312770393743925 61.75482657005986,9.40701882920439 61.75871263288603,9.415137388359584 61.71404143930354,9.321023977456585 61.71016259926212)))"
22050006855000,22,13,9,41,"MULTIPOLYGON(((9.415137388359584 61.71404143930354,9.40701882920439 61.75871263288603,9.501294242251028 61.762534089112535,9.509277650480593 61.717855791050916,9.415137388359584 61.71404143930354)))"
22100006855000,492,248,244,43.3,"MULTIPOLYGON(((9.509277650480593 61.717855791050916,9.501294242251028 61.762534089112535,9.59559619120375 61.76629090316188,9.603444324159213 61.72160561908146,9.509277650480593 61.717855791050916)))"
22200006855000,27,13,14,49.2,"MULTIPOLYGON(((9.697636968956047 61.72529088855357,9.689924233597335 61.7699830400402,9.784277926193836 61.77361046533852,9.79185514366499 61.72891156520806,9.697636968956047 61.72529088855357)))"
22450006855000,3,0,3,0,"MULTIPOLYGON(((10.16897429136008 61.74274767891764,10.161940307504786 61.787472383090666,10.256415576377544 61.79077575490948,10.263313471573158 61.74604489806434,10.16897429136008 61.74274767891764)))"
22500006855000,5,4,1,49.6,"MULTIPOLYGON(((10.263313471573158 61.74604489806434,10.256415576377544 61.79077575490948,10.350913820500672 61.79401422104403,10.357675519058098 61.74927733113552,10.263313471573158 61.74604489806434)))"
22550006855000,27,14,13,47.6,"MULTIPOLYGON(((10.357675519058098 61.74927733113552,10.350913820500672 61.79401422104403,10.445434591579462 61.797187751212626,10.45205998759154 61.752444947981786,10.357675519058098 61.74927733113552)))"
22600006855000,30,16,14,62.7,"MULTIPOLYGON(((10.45205998759154 61.752444947981786,10.445434591579462 61.797187751212626,10.539977440647773 61.80029631572777,10.546466430283967 61.75554771904535,10.45205998759154 61.752444947981786)))"
22650006855000,20,13,7,46.3,"MULTIPOLYGON(((10.546466430283967 61.75554771904535,10.539977440647773 61.80029631572777,10.634541918080938 61.80333988549713,10.640894399592485 61.75858561536103,10.546466430283967 61.75554771904535)))"
22700006855000,8,2,6,36,"MULTIPOLYGON(((10.640894399592485 61.75858561536103,10.634541918080938 61.80333988549713,10.729127573608691 61.8063184320246,10.735343447333673 61.76155860855734,10.640894399592485 61.75858561536103)))"
22800006855000,3,2,1,0,"MULTIPOLYGON(((10.829813124696473 61.76446667085745,10.823733956328176 61.809231927411346,10.918360614716988 61.81208034435675,10.924302982255135 61.76730977508032,10.829813124696473 61.76446667085745)))"
22950006855000,131,70,61,52.2,"MULTIPOLYGON(((11.113341437261505 61.77280100355407,11.107672949393688 61.81758183671843,11.20235771965696 61.82023486053357,11.20788913290132 61.775449076429865,11.113341437261505 61.77280100355407)))"
23250006855000,48,29,19,46.4,"MULTIPOLYGON(((11.68089420616011 61.78771305367952,11.676049429184216 61.83252177814673,11.770838154373577 61.83478335977651,11.7755453663599 61.789970410812245,11.68089420616011 61.78771305367952)))"
23300006855000,4,2,2,0,"MULTIPOLYGON(((11.7755453663599 61.789970410812245,11.770838154373577 61.83478335977651,11.865642608832887 61.8369796230692,11.870212181567808 61.79216257102381,11.7755453663599 61.789970410812245)))"
23350006855000,51,25,26,51.4,"MULTIPOLYGON(((11.870212181567808 61.79216257102381,11.865642608832887 61.8369796230692,11.960462335097716 61.8391105473652,11.964894196462799 61.79428951374547,11.870212181567808 61.79216257102381)))"
23400006855000,1,1,0,0,"MULTIPOLYGON(((11.964894196462799 61.79428951374547,11.960462335097716 61.8391105473652,12.05529687524387 61.84117611261376,12.059590955267709 61.79635121901447,11.964894196462799 61.79428951374547)))"
19650006860000,56,31,25,48.3,"MULTIPOLYGON(((4.921453453936437 61.50009195459016,4.906984827875603 61.54428413040477,4.999611607327804 61.55116875069699,5.013952903061697 61.506963974025815,4.921453453936437 61.50009195459016)))"
19750006860000,94,50,44,49,"MULTIPOLYGON(((5.106498989251418 61.51377369014001,5.092285237978615 61.55799095893656,5.185005326184123 61.56475069359608,5.199091320510593 61.52052104166443,5.106498989251418 61.51377369014001)))"
19800006860000,10,5,5,54.5,"MULTIPOLYGON(((5.199091320510593 61.52052104166443,5.185005326184123 61.56475069359608,5.277771476999691 61.571447893655204,5.291729503553225 61.52720596783591,5.199091320510593 61.52052104166443)))"
19850006860000,103,60,43,44.7,"MULTIPOLYGON(((5.291729503553225 61.52720596783591,5.277771476999691 61.571447893655204,5.370583294188897 61.578082498602605,5.384413143811262 61.5338284083985,5.291729503553225 61.52720596783591)))"
19900006860000,250,124,126,37.1,"MULTIPOLYGON(((5.384413143811262 61.5338284083985,5.370583294188897 61.578082498602605,5.463440380232686 61.58465444843815,5.47714184544364 61.540388303605376,5.384413143811262 61.5338284083985)))"
19950006860000,147,81,66,47.1,"MULTIPOLYGON(((5.47714184544364 61.540388303605376,5.463440380232686 61.58465444843815,5.556342336338533 61.59116368367475,5.569915211345414 61.546885594220946,5.47714184544364 61.540388303605376)))"
20000006860000,75,31,44,40.3,"MULTIPOLYGON(((5.569915211345414 61.546885594220946,5.556342336338533 61.59116368367475,5.649288762449698 61.59761014534051,5.66273284315696 61.55332022152276,5.569915211345414 61.546885594220946)))"
20050006860000,20,12,8,51.3,"MULTIPOLYGON(((5.66273284315696 61.55332022152276,5.649288762449698 61.59761014534051,5.74227925725461 61.60399377498063,5.755594341273285 61.559692127303535,5.66273284315696 61.55332022152276)))"
20100006860000,200,100,100,41.2,"MULTIPOLYGON(((5.755594341273285 61.559692127303535,5.74227925725461 61.60399377498063,5.835313418196295 61.61031451465942,5.848499304853394 61.56600125387311,5.755594341273285 61.559692127303535)))"
20150006860000,126,65,61,45.6,"MULTIPOLYGON(((5.848499304853394 61.56600125387311,5.835313418196295 61.61031451465942,5.9283908414819 61.616572306962205,5.941447331829763 61.572247544060346,5.848499304853394 61.56600125387311)))"
20200006860000,103,56,47,45,"MULTIPOLYGON(((5.941447331829763 61.572247544060346,5.9283908414819 61.616572306962205,6.021511122092327 61.62276709499738,6.034438018917887 61.57843094121511,5.941447331829763 61.572247544060346)))"
20450006860000,19,7,12,46.5,"MULTIPOLYGON(((6.406819260645152 61.60253448484815,6.39441267502631 61.64691508504143,6.487741124738564 61.65279401680305,6.500017157108991 61.608402585456396,6.406819260645152 61.60253448484815)))"
20500006860000,15,7,8,37.3,"MULTIPOLYGON(((6.500017157108991 61.608402585456396,6.487741124738564 61.65279401680305,6.581109976458384 61.658609614037225,6.593255268966125 61.61420746417841,6.500017157108991 61.608402585456396)))"
20550006860000,21,8,13,38.4,"MULTIPOLYGON(((6.593255268966125 61.61420746417841,6.581109976458384 61.658609614037225,6.674518816859013 61.66436182356658,6.686533184687505 61.61994906806378,6.593255268966125 61.61420746417841)))"
20650006860000,3,1,2,0,"MULTIPOLYGON(((6.779850491606439 61.62562734469807,6.767967231467321 61.67005059275171,6.861454804674166 61.67567586949304,6.8732067759289 61.631242242204465,6.779850491606439 61.62562734469807)))"
20900006860000,36,21,15,38.8,"MULTIPOLYGON(((7.247013372498701 61.65306702233465,7.235788332129912 61.697541029023846,7.329465425166423 61.70284808107193,7.340558298200856 61.658364264993345,7.247013372498701 61.65306702233465)))"
21400006860000,9,5,4,47.4,"MULTIPOLYGON(((8.184053066276077 61.70316824255566,8.174157128411924 61.747735161398,8.268181467598081 61.75240217197209,8.27794362213486 61.70782659887624,8.184053066276077 61.70316824255566)))"
21450006860000,145,82,63,48.1,"MULTIPOLYGON(((8.27794362213486 61.70782659887624,8.268181467598081 61.75240217197209,8.362238169887801 61.75700493134025,8.371866390061957 61.71242082057057,8.27794362213486 61.70782659887624)))"
21500006860000,37,21,16,48.9,"MULTIPOLYGON(((8.371866390061957 61.71242082057057,8.362238169887801 61.75700493134025,8.456326802018424 61.761543396840935,8.465820938745559 61.71695086516178,8.371866390061957 61.71242082057057)))"
21850006860000,7,4,3,37.9,"MULTIPOLYGON(((9.030191357644254 61.742781106486035,9.021504742221554 61.78742170153233,9.115804674695287 61.79150896346515,9.124356218302081 61.74686076982903,9.030191357644254 61.742781106486035)))"
21900006860000,3,1,2,0,"MULTIPOLYGON(((9.124356218302081 61.74686076982903,9.115804674695287 61.79150896346515,9.210133038185193 61.795531610864394,9.218549376752224 61.75087593679388,9.124356218302081 61.74686076982903)))"
21950006860000,385,185,200,49.2,"MULTIPOLYGON(((9.218549376752224 61.75087593679388,9.210133038185193 61.795531610864394,9.304489391427538 61.79948960624632,9.312770393743925 61.75482657005986,9.218549376752224 61.75087593679388)))"
22000006860000,44,28,16,49.1,"MULTIPOLYGON(((9.312770393743925 61.75482657005986,9.304489391427538 61.79948960624632,9.398873292330109 61.8033829127094,9.40701882920439 61.75871263288603,9.312770393743925 61.75482657005986)))"
22050006860000,669,345,324,43.7,"MULTIPOLYGON(((9.40701882920439 61.75871263288603,9.398873292330109 61.8033829127094,9.493284297984522 61.80721149393566,9.501294242251028 61.762534089112535,9.40701882920439 61.75871263288603)))"
22100006860000,2023,970,1053,46,"MULTIPOLYGON(((9.501294242251028 61.762534089112535,9.493284297984522 61.80721149393566,9.587721964678638 61.81097531419196,9.59559619120375 61.76629090316188,9.501294242251028 61.762534089112535)))"
22150006860000,29,8,21,34.5,"MULTIPOLYGON(((9.59559619120375 61.76629090316188,9.587721964678638 61.81097531419196,9.682185847908999 61.814674338331194,9.689924233597335 61.7699830400402,9.59559619120375 61.76629090316188)))"
22450006860000,14,9,5,41.9,"MULTIPOLYGON(((10.161940307504786 61.787472383090666,10.154882900672503 61.83219632830898,10.249494705817508 61.83550587063545,10.256415576377544 61.79077575490948,10.161940307504786 61.787472383090666)))"
22800006860000,26,15,11,50.7,"MULTIPOLYGON(((10.823733956328176 61.809231927411346,10.817634512189487 61.85399654270218,10.912398423539518 61.856850287812776,10.918360614716988 61.81208034435675,10.823733956328176 61.809231927411346)))"
22900006860000,1,1,0,0,"MULTIPOLYGON(((11.013007096646232 61.81486365615949,11.00718225239537 61.859638806954926,11.10198554391556 61.86236207391247,11.107672949393688 61.81758183671843,11.013007096646232 61.81486365615949)))"
22950006860000,14,7,7,49,"MULTIPOLYGON(((11.107672949393688 61.81758183671843,11.10198554391556 61.86236207391247,11.196807842673845 61.865020063072976,11.20235771965696 61.82023486053357,11.107672949393688 61.81758183671843)))"
23250006860000,16,8,8,42.8,"MULTIPOLYGON(((11.676049429184216 61.83252177814673,11.671188465866098 61.8773299878636,11.766115213038422 61.8795958063056,11.770838154373577 61.83478335977651,11.676049429184216 61.83252177814673)))"
23300006860000,13,9,4,56.3,"MULTIPOLYGON(((11.770838154373577 61.83478335977651,11.766115213038422 61.8795958063056,11.861057764215822 61.88179618464397,11.865642608832887 61.8369796230692,11.770838154373577 61.83478335977651)))"
23350006860000,5,1,4,53.2,"MULTIPOLYGON(((11.865642608832887 61.8369796230692,11.861057764215822 61.88179618464397,11.95601565977694 61.88393110212782,11.960462335097716 61.8391105473652,11.865642608832887 61.8369796230692)))"
23400006860000,276,129,147,44.2,"MULTIPOLYGON(((11.960462335097716 61.8391105473652,11.95601565977694 61.88393110212782,12.050988439636994 61.88600053861769,12.05529687524387 61.84117611261376,11.960462335097716 61.8391105473652)))"
23450006860000,18,6,12,46.6,"MULTIPOLYGON(((12.05529687524387 61.84117611261376,12.050988439636994 61.88600053861769,12.145975643261464 61.8880044745861,12.150145770900966 61.84317629937335,12.05529687524387 61.84117611261376)))"
23500006860000,26,16,10,52.2,"MULTIPOLYGON(((12.150145770900966 61.84317629937335,12.145975643261464 61.8880044745861,12.240976809679784 61.88994289111837,12.24500856326602 61.84511108881259,12.150145770900966 61.84317629937335)))"
19550006865000,51,34,17,54.8,"MULTIPOLYGON(((4.721873390585305 61.53032790229495,4.707102728359848 61.57449220266412,4.799761916571925 61.58151431383031,4.814405291956201 61.53733716009232,4.721873390585305 61.53032790229495)))"
19600006865000,27,13,14,57.3,"MULTIPOLYGON(((4.814405291956201 61.53733716009232,4.799761916571925 61.58151431383031,4.892468958062201 61.58847402903334,4.906984827875603 61.54428413040477,4.814405291956201 61.53733716009232)))"
19650006865000,39,20,19,32.2,"MULTIPOLYGON(((4.906984827875603 61.54428413040477,4.892468958062201 61.58847402903334,4.985223460177031 61.5953712854735,4.999611607327804 61.55116875069699,4.906984827875603 61.54428413040477)))"
19700006865000,6310,3192,3118,39.7,"MULTIPOLYGON(((4.999611607327804 61.55116875069699,4.985223460177031 61.5953712854735,5.078025028934304 61.60220602085588,5.092285237978615 61.55799095893656,4.999611607327804 61.55116875069699)))"
19750006865000,1241,637,604,37.8,"MULTIPOLYGON(((5.092285237978615 61.55799095893656,5.078025028934304 61.60220602085588,5.170873269032306 61.608978173392416,5.185005326184123 61.56475069359608,5.092285237978615 61.55799095893656)))"
19800006865000,115,60,55,40.8,"MULTIPOLYGON(((5.185005326184123 61.56475069359608,5.170873269032306 61.608978173392416,5.263767783858724 61.61568768180405,5.277771476999691 61.571447893655204,5.185005326184123 61.56475069359608)))"
19850006865000,77,37,40,48.8,"MULTIPOLYGON(((5.277771476999691 61.571447893655204,5.263767783858724 61.61568768180405,5.356708175499697 61.62233448532265,5.370583294188897 61.578082498602605,5.277771476999691 61.571447893655204)))"
19900006865000,315,157,158,43.1,"MULTIPOLYGON(((5.370583294188897 61.578082498602605,5.356708175499697 61.62233448532265,5.44969404474898 61.62891852369318,5.463440380232686 61.58465444843815,5.370583294188897 61.578082498602605)))"
19950006865000,108,58,50,40.2,"MULTIPOLYGON(((5.463440380232686 61.58465444843815,5.44969404474898 61.62891852369318,5.542724991117187 61.635439737175695,5.556342336338533 61.59116368367475,5.463440380232686 61.58465444843815)))"
20000006865000,42,25,17,41.7,"MULTIPOLYGON(((5.556342336338533 61.59116368367475,5.542724991117187 61.635439737175695,5.635800612841115 61.64189806654735,5.649288762449698 61.59761014534051,5.556342336338533 61.59116368367475)))"
20050006865000,50,24,26,38.8,"MULTIPOLYGON(((5.649288762449698 61.59761014534051,5.635800612841115 61.64189806654735,5.728920506893178 61.648293453104365,5.74227925725461 61.60399377498063,5.649288762449698 61.59761014534051)))"
20100006865000,34,20,14,42.5,"MULTIPOLYGON(((5.74227925725461 61.60399377498063,5.728920506893178 61.648293453104365,5.822084268990885 61.65462583866407,5.835313418196295 61.61031451465942,5.74227925725461 61.60399377498063)))"
20200006865000,35,18,17,40.6,"MULTIPOLYGON(((5.9283908414819 61.616572306962205,5.915291493606454 61.66089516556685,6.008541773976481 61.66710137667815,6.021511122092327 61.62276709499738,5.9283908414819 61.616572306962205)))"
20400006865000,49,22,27,43.5,"MULTIPOLYGON(((6.301125039491747 61.640972872466016,6.288546863650517 61.685340751833394,6.381965275035308 61.69129393900114,6.39441267502631 61.64691508504143,6.301125039491747 61.640972872466016)))"
20450006865000,48,28,20,39.1,"MULTIPOLYGON(((6.39441267502631 61.64691508504143,6.381965275035308 61.69129393900114,6.475424690167788 61.697183732647396,6.487741124738564 61.65279401680305,6.39441267502631 61.64691508504143)))"
20500006865000,56,32,24,42,"MULTIPOLYGON(((6.487741124738564 61.65279401680305,6.475424690167788 61.697183732647396,6.568924695078768 61.70301007882805,6.581109976458384 61.658609614037225,6.487741124738564 61.65279401680305)))"
20650006865000,99,49,50,43.5,"MULTIPOLYGON(((6.767967231467321 61.67005059275171,6.756044812542067 61.71447221570944,6.849664091369772 61.7201079012209,6.861454804674166 61.67567586949304,6.767967231467321 61.67005059275171)))"
21500006865000,37,16,21,34.7,"MULTIPOLYGON(((8.362238169887801 61.75700493134025,8.35257801971662 61.80158787713704,8.446801169495533 61.80613478777374,8.456326802018424 61.761543396840935,8.362238169887801 61.75700493134025)))"
21550006865000,9,5,4,50.4,"MULTIPOLYGON(((8.456326802018424 61.761543396840935,8.446801169495533 61.80613478777374,8.541055962967265 61.81061724518167,8.55044692979065 61.76601752638221,8.456326802018424 61.761543396840935)))"
21750006865000,2,1,1,0,"MULTIPOLYGON(((8.832991931161496 61.77905348690414,8.82400582993738 61.8236774838898,8.918382818025302 61.82790171711984,8.927233681186959 61.783269863130606,8.832991931161496 61.77905348690414)))"
21800006865000,56,30,26,47.1,"MULTIPOLYGON(((8.927233681186959 61.783269863130606,8.918382818025302 61.82790171711984,9.01278925521755 61.83206129437497,9.021504742221554 61.78742170153233,8.927233681186959 61.783269863130606)))"
21850006865000,2,1,1,0,"MULTIPOLYGON(((9.021504742221554 61.78742170153233,9.01278925521755 61.83206129437497,9.107224699932196 61.836156176842096,9.115804674695287 61.79150896346515,9.021504742221554 61.78742170153233)))"
21900006865000,1,1,0,0,"MULTIPOLYGON(((9.115804674695287 61.79150896346515,9.107224699932196 61.836156176842096,9.201688709727634 61.84018632629012,9.210133038185193 61.795531610864394,9.115804674695287 61.79150896346515)))"
21950006865000,558,292,266,42.4,"MULTIPOLYGON(((9.210133038185193 61.795531610864394,9.201688709727634 61.84018632629012,9.296180841314898 61.84415170507125,9.304489391427538 61.79948960624632,9.210133038185193 61.795531610864394)))"
22000006865000,88,46,42,46,"MULTIPOLYGON(((9.304489391427538 61.79948960624632,9.296180841314898 61.84415170507125,9.390700650570015 61.8480522761224,9.398873292330109 61.8033829127094,9.304489391427538 61.79948960624632)))"
22050006865000,470,227,243,48.1,"MULTIPOLYGON(((9.398873292330109 61.8033829127094,9.390700650570015 61.8480522761224,9.485247692546423 61.85188800296651,9.493284297984522 61.80721149393566,9.398873292330109 61.8033829127094)))"
22100006865000,69,35,34,41.1,"MULTIPOLYGON(((9.493284297984522 61.80721149393566,9.485247692546423 61.85188800296651,9.579821521487473 61.85565884971381,9.587721964678638 61.81097531419196,9.493284297984522 61.80721149393566)))"
22450006865000,49,27,22,41.6,"MULTIPOLYGON(((10.154882900672503 61.83219632830898,10.147801960120713 61.87691951265782,10.24255075122935 61.88023524341261,10.249494705817508 61.83550587063545,10.154882900672503 61.83219632830898)))"
22500006865000,4,3,1,0,"MULTIPOLYGON(((10.249494705817508 61.83550587063545,10.24255075122935 61.88023524341261,10.337322735603648 61.883485828245504,10.34412959487568 61.83875038732939,10.249494705817508 61.83550587063545)))"
22550006865000,4,3,1,0,"MULTIPOLYGON(((10.34412959487568 61.83875038732939,10.337322735603648 61.883485828245504,10.432117460767525 61.886671236607945,10.438787117468108 61.84192984797608,10.34412959487568 61.83875038732939)))"
22800006865000,12,6,6,59.8,"MULTIPOLYGON(((10.817634512189487 61.85399654270218,10.811514696199652 61.898760515377504,10.906416314756543 61.90161960416984,10.912398423539518 61.856850287812776,10.817634512189487 61.85399654270218)))"
22900006865000,326,172,154,47.2,"MULTIPOLYGON(((11.00718225239537 61.859638806954926,11.001337945382701 61.90441334582148,11.096279131104103 61.907141714000545,11.10198554391556 61.86236207391247,11.00718225239537 61.859638806954926)))"
22950006865000,30,16,14,46.5,"MULTIPOLYGON(((11.10198554391556 61.86236207391247,11.096279131104103 61.907141714000545,11.19123941435732 61.90980468298149,11.196807842673845 61.865020063072976,11.10198554391556 61.86236207391247)))"
23250006865000,9,3,6,61.6,"MULTIPOLYGON(((11.671188465866098 61.8773299878636,11.666311239316821 61.92213768208403,11.761376467618682 61.924407749712614,11.766115213038422 61.8795958063056,11.671188465866098 61.8773299878636)))"
23300006865000,2,1,1,0,"MULTIPOLYGON(((11.766115213038422 61.8795958063056,11.761376467618682 61.924407749712614,11.856457575137803 61.926612255118734,11.861057764215822 61.88179618464397,11.766115213038422 61.8795958063056)))"
23350006865000,12,8,4,59.8,"MULTIPOLYGON(((11.861057764215822 61.88179618464397,11.856457575137803 61.926612255118734,11.951554100082262 61.928751177459695,11.95601565977694 61.88393110212782,11.861057764215822 61.88179618464397)))"
23400006865000,178,91,87,43.9,"MULTIPOLYGON(((11.95601565977694 61.88393110212782,11.951554100082262 61.928751177459695,12.046665580193029 61.93082449650679,12.050988439636994 61.88600053861769,11.95601565977694 61.88393110212782)))"
19550006870000,2,1,1,0,"MULTIPOLYGON(((4.707102728359848 61.57449220266412,4.692283821315497 61.61865414511169,4.785070687686567 61.62568914564488,4.799761916571925 61.58151431383031,4.707102728359848 61.57449220266412)))"
19600006870000,71,38,33,53.5,"MULTIPOLYGON(((4.799761916571925 61.58151431383031,4.785070687686567 61.62568914564488,4.877905627402828 61.63266164146467,4.892468958062201 61.58847402903334,4.799761916571925 61.58151431383031)))"
19650006870000,15,7,8,45.8,"MULTIPOLYGON(((4.892468958062201 61.58847402903334,4.877905627402828 61.63266164146467,4.970788246163886 61.63957156950541,4.985223460177031 61.5953712854735,4.892468958062201 61.58847402903334)))"
19700006870000,2191,1115,1076,41.4,"MULTIPOLYGON(((4.985223460177031 61.5953712854735,4.970788246163886 61.63957156950541,5.063718148330829 61.64641886720813,5.078025028934304 61.60220602085588,4.985223460177031 61.5953712854735)))"
19750006870000,51,29,22,48.5,"MULTIPOLYGON(((5.078025028934304 61.60220602085588,5.063718148330829 61.64641886720813,5.156694936935151 61.653203472522605,5.170873269032306 61.608978173392416,5.078025028934304 61.60220602085588)))"
19800006870000,28,13,15,41,"MULTIPOLYGON(((5.170873269032306 61.608978173392416,5.156694936935151 61.653203472522605,5.249718213687805 61.659925323909526,5.263767783858724 61.61568768180405,5.170873269032306 61.608978173392416)))"
19850006870000,4,2,2,0,"MULTIPOLYGON(((5.263767783858724 61.61568768180405,5.249718213687805 61.659925323909526,5.34278757898833 61.66658436034249,5.356708175499697 61.62233448532265,5.263767783858724 61.61568768180405)))"
19900006870000,39,18,21,48.9,"MULTIPOLYGON(((5.356708175499697 61.62233448532265,5.34278757898833 61.66658436034249,5.435902631934044 61.67318052131009,5.44969404474898 61.62891852369318,5.356708175499697 61.62233448532265)))"
19950006870000,88,47,41,49.8,"MULTIPOLYGON(((5.44969404474898 61.62891852369318,5.435902631934044 61.67318052131009,5.529062970329388 61.67971374681797,5.542724991117187 61.635439737175695,5.44969404474898 61.62891852369318)))"
20000006870000,12,7,5,47,"MULTIPOLYGON(((5.542724991117187 61.635439737175695,5.529062970329388 61.67971374681797,5.622268190695261 61.68618397739087,5.635800612841115 61.64189806654735,5.542724991117187 61.635439737175695)))"
20100006870000,20,12,8,51,"MULTIPOLYGON(((5.728920506893178 61.648293453104365,5.715517888278552 61.69259115407458,5.808811657061672 61.69893521843803,5.822084268990885 61.65462583866407,5.728920506893178 61.648293453104365)))"
20150006870000,37,21,16,44.2,"MULTIPOLYGON(((5.822084268990885 61.65462583866407,5.808811657061672 61.69893521843803,5.90214908977224 61.7052161125752,5.915291493606454 61.66089516556685,5.822084268990885 61.65462583866407)))"
20200006870000,41,18,23,39.5,"MULTIPOLYGON(((5.915291493606454 61.66089516556685,5.90214908977224 61.7052161125752,5.995529777892782 61.711433779107146,6.008541773976481 61.66710137667815,5.915291493606454 61.66089516556685)))"
20400006870000,20,12,8,48.4,"MULTIPOLYGON(((6.288546863650517 61.685340751833394,6.275927271070515 61.72970684722897,6.369476871100636 61.73567104015988,6.381965275035308 61.69129393900114,6.288546863650517 61.685340751833394)))"
20450006870000,179,95,84,48.1,"MULTIPOLYGON(((6.381965275035308 61.69129393900114,6.369476871100636 61.73567104015988,6.463067665624268 61.74157172656471,6.475424690167788 61.697183732647396,6.381965275035308 61.69129393900114)))"
20500006870000,535,256,279,41.7,"MULTIPOLYGON(((6.475424690167788 61.697183732647396,6.463067665624268 61.74157172656471,6.556699238862867 61.74740885226747,6.568924695078768 61.70301007882805,6.475424690167788 61.697183732647396)))"
20550006870000,77,42,35,46.4,"MULTIPOLYGON(((6.568924695078768 61.70301007882805,6.556699238862867 61.74740885226747,6.650371173863368 61.753182363632625,6.662464874633502 61.70877292413727,6.568924695078768 61.70301007882805)))"
20650006870000,67,35,32,42,"MULTIPOLYGON(((6.756044812542067 61.71447221570944,6.744083052508628 61.75889220756695,6.837834455527909 61.764538331521315,6.849664091369772 61.7201079012209,6.756044812542067 61.71447221570944)))"
21150006870000,4,2,2,0,"MULTIPOLYGON(((7.693938512453855 61.76795843526723,7.683305942581907 61.812477649075774,7.77742928332585 61.817483804021165,7.787927997329509 61.77295530287721,7.693938512453855 61.76795843526723)))"
21550006870000,133,72,61,51.6,"MULTIPOLYGON(((8.446801169495533 61.80613478777374,8.437243893124473 61.85072503422769,8.531633789398974 61.85521584351897,8.541055962967265 61.81061724518167,8.446801169495533 61.80613478777374)))"
21600006870000,1019,495,524,44.8,"MULTIPOLYGON(((8.541055962967265 61.81061724518167,8.531633789398974 61.85521584351897,8.626055039259365 61.85964204010391,8.635341963030521 61.81503520765893,8.541055962967265 61.81061724518167)))"
21650006870000,95,52,43,45.4,"MULTIPOLYGON(((8.635341963030521 61.81503520765893,8.626055039259365 61.85964204010391,8.720507202687925 61.864003582675856,8.729658731663807 61.81938863407853,8.635341963030521 61.81503520765893)))"
21700006870000,307,154,153,45.2,"MULTIPOLYGON(((8.729658731663807 61.81938863407853,8.720507202687925 61.864003582675856,8.814989838751572 61.868300430506935,8.82400582993738 61.8236774838898,8.729658731663807 61.81938863407853)))"
21750006870000,136,72,64,44.8,"MULTIPOLYGON(((8.82400582993738 61.8236774838898,8.814989838751572 61.868300430506935,8.909502505614 61.8725325434494,8.918382818025302 61.82790171711984,8.82400582993738 61.8236774838898)))"
21800006870000,239,138,101,42.9,"MULTIPOLYGON(((8.918382818025302 61.82790171711984,8.909502505614 61.8725325434494,9.004044760547872 61.8766998819372,9.01278925521755 61.83206129437497,8.918382818025302 61.82790171711984)))"
21850006870000,959,461,498,46.3,"MULTIPOLYGON(((9.01278925521755 61.83206129437497,9.004044760547872 61.8766998819372,9.098616159947078 61.88080240698727,9.107224699932196 61.836156176842096,9.01278925521755 61.83206129437497)))"
21900006870000,905,455,450,44.7,"MULTIPOLYGON(((9.107224699932196 61.836156176842096,9.098616159947078 61.88080240698727,9.193216259339083 61.884840080201066,9.201688709727634 61.84018632629012,9.107224699932196 61.836156176842096)))"
21950006870000,211,107,104,45.5,"MULTIPOLYGON(((9.201688709727634 61.84018632629012,9.193216259339083 61.884840080201066,9.287844613397317 61.88881286376573,9.296180841314898 61.84415170507125,9.201688709727634 61.84018632629012)))"
22000006870000,3,1,2,0,"MULTIPOLYGON(((9.296180841314898 61.84415170507125,9.287844613397317 61.88881286376573,9.382500775953615 61.89272072045569,9.390700650570015 61.8480522761224,9.296180841314898 61.84415170507125)))"
22050006870000,192,99,93,43.9,"MULTIPOLYGON(((9.390700650570015 61.8480522761224,9.382500775953615 61.89272072045569,9.477184300010757 61.89656361363378,9.485247692546423 61.85188800296651,9.390700650570015 61.8480522761224)))"
22100006870000,11,6,5,58.9,"MULTIPOLYGON(((9.485247692546423 61.85188800296651,9.477184300010757 61.89656361363378,9.571894737755041 61.90034150725266,9.579821521487473 61.85565884971381,9.485247692546423 61.85188800296651)))"
22150006870000,3,2,1,0,"MULTIPOLYGON(((9.579821521487473 61.85565884971381,9.571894737755041 61.90034150725266,9.666631640568921 61.904054365856105,9.674421690838969 61.859364781063086,9.579821521487473 61.85565884971381)))"
22400006870000,7,3,4,59.9,"MULTIPOLYGON(((10.05307681405866 61.87353866712791,10.045834902747853 61.91825476174993,10.140697374404319 61.92164193420911,10.147801960120713 61.87691951265782,10.05307681405866 61.87353866712791)))"
22900006870000,129,68,61,45.5,"MULTIPOLYGON(((11.001337945382701 61.90441334582148,10.99547408317655 61.94918727154383,11.090553620664826 61.95192075583844,11.096279131104103 61.907141714000545,11.001337945382701 61.90441334582148)))"
23300006870000,3,1,2,0,"MULTIPOLYGON(((11.761376467618682 61.924407749712614,11.756621842901533 61.96921918930487,11.851841968556588 61.9714278338587,11.856457575137803 61.926612255118734,11.761376467618682 61.924407749712614)))"
23350006870000,28,16,12,40.9,"MULTIPOLYGON(((11.856457575137803 61.926612255118734,11.851841968556588 61.9714278338587,11.947077585145728 61.97357077278219,11.951554100082262 61.928751177459695,11.856457575137803 61.926612255118734)))"
23400006870000,4,2,2,0,"MULTIPOLYGON(((11.951554100082262 61.928751177459695,11.947077585145728 61.97357077278219,12.042328228221873 61.97564798575689,12.046665580193029 61.93082449650679,11.951554100082262 61.928751177459695)))"
19600006875000,2,1,1,0,"MULTIPOLYGON(((4.785070687686567 61.62568914564488,4.770331385231449 61.66986164630481,4.863294617475564 61.67684695863076,4.877905627402828 61.63266164146467,4.785070687686567 61.62568914564488)))"
19650006875000,15,9,6,67.1,"MULTIPOLYGON(((4.877905627402828 61.63266164146467,4.863294617475564 61.67684695863076,4.956305748523257 61.68376959388688,4.970788246163886 61.63957156950541,4.877905627402828 61.63266164146467)))"
19700006875000,8,6,2,53.1,"MULTIPOLYGON(((4.970788246163886 61.63957156950541,4.956305748523257 61.68376959388688,5.049364381069874 61.69062948924853,5.063718148330829 61.64641886720813,4.970788246163886 61.63957156950541)))"
20000006875000,1,1,0,0,"MULTIPOLYGON(((5.529062970329388 61.67971374681797,5.515356067358705 61.72398570464558,5.608691291121238 61.730467870069425,5.622268190695261 61.68618397739087,5.529062970329388 61.67971374681797)))"
20150006875000,36,18,18,44.4,"MULTIPOLYGON(((5.808811657061672 61.69893521843803,5.795495380997507 61.74324264648489,5.888963430322168 61.749535140641626,5.90214908977224 61.7052161125752,5.808811657061672 61.69893521843803)))"
20200006875000,156,87,69,46.3,"MULTIPOLYGON(((5.90214908977224 61.7052161125752,5.888963430322168 61.749535140641626,5.982474935947577 61.75576429508833,5.995529777892782 61.711433779107146,5.90214908977224 61.7052161125752)))"
20300006875000,90,43,47,43.8,"MULTIPOLYGON(((6.088953311670586 61.71758816118392,6.076029486347682 61.761930052731294,6.169626668761675 61.768032357009886,6.182419280127625 61.72367920248655,6.088953311670586 61.71758816118392)))"
20350006875000,1693,851,842,41.5,"MULTIPOLYGON(((6.182419280127625 61.72367920248655,6.169626668761675 61.768032357009886,6.263266069204098 61.7740711518984,6.275927271070515 61.72970684722897,6.182419280127625 61.72367920248655)))"
20400006875000,34,20,14,42.9,"MULTIPOLYGON(((6.275927271070515 61.72970684722897,6.263266069204098 61.7740711518984,6.356947272474975 61.78004638190807,6.369476871100636 61.73567104015988,6.275927271070515 61.72970684722897)))"
20450006875000,434,219,215,41.3,"MULTIPOLYGON(((6.369476871100636 61.73567104015988,6.356947272474975 61.78004638190807,6.450669862170031 61.78595799208895,6.463067665624268 61.74157172656471,6.369476871100636 61.73567104015988)))"
20500006875000,62,34,28,45.7,"MULTIPOLYGON(((6.463067665624268 61.74157172656471,6.450669862170031 61.78595799208895,6.544433420691036 61.7918059280318,6.556699238862867 61.74740885226747,6.463067665624268 61.74157172656471)))"
20650006875000,75,38,37,43.8,"MULTIPOLYGON(((6.744083052508628 61.75889220756695,6.732081767910667 61.8033105622812,6.825965715537055 61.808967154489714,6.837834455527909 61.764538331521315,6.744083052508628 61.75889220756695)))"
20700006875000,7,4,3,39.4,"MULTIPOLYGON(((6.837834455527909 61.764538331521315,6.825965715537055 61.808967154489714,6.919888949866142 61.81455986026772,6.931624962507448 61.77012068349263,6.837834455527909 61.764538331521315)))"
20750006875000,12,4,8,39.6,"MULTIPOLYGON(((6.931624962507448 61.77012068349263,6.919888949866142 61.81455986026772,7.013851047487586 61.82008862793746,7.025454151901132 61.775639212025474,6.931624962507448 61.77012068349263)))"
21400006875000,4,3,1,0,"MULTIPOLYGON(((8.154266712010042 61.83686535183269,8.144271924624894 61.88142861523809,8.238700215522927 61.88612173825567,8.248559916754832 61.841549745637685,8.154266712010042 61.83686535183269)))"
21450006875000,821,416,405,46.8,"MULTIPOLYGON(((8.248559916754832 61.841549745637685,8.238700215522927 61.88612173825567,8.333161328350071 61.890750258398775,8.342885789526141 61.84616965411401,8.248559916754832 61.841549745637685)))"
21500006875000,460,235,225,46.2,"MULTIPOLYGON(((8.342885789526141 61.84616965411401,8.333161328350071 61.890750258398775,8.427654823920662 61.8953141324455,8.437243893124473 61.85072503422769,8.342885789526141 61.84616965411401)))"
21550006875000,161,91,70,45.9,"MULTIPOLYGON(((8.437243893124473 61.85072503422769,8.427654823920662 61.8953141324455,8.522180262090222 61.89981331775048,8.531633789398974 61.85521584351897,8.437243893124473 61.85072503422769)))"
21600006875000,21,11,10,41.7,"MULTIPOLYGON(((8.531633789398974 61.85521584351897,8.522180262090222 61.89981331775048,8.616737201767467 61.90424777224664,8.626055039259365 61.85964204010391,8.531633789398974 61.85521584351897)))"
21650006875000,189,98,91,44.2,"MULTIPOLYGON(((8.626055039259365 61.85964204010391,8.616737201767467 61.90424777224664,8.711325200926405 61.90861745444659,8.720507202687925 61.864003582675856,8.626055039259365 61.85964204010391)))"
21700006875000,57,34,23,51.5,"MULTIPOLYGON(((8.720507202687925 61.864003582675856,8.711325200926405 61.90861745444659,8.805943816618477 61.9129223234441,8.814989838751572 61.868300430506935,8.720507202687925 61.864003582675856)))"
21800006875000,26,12,14,61.3,"MULTIPOLYGON(((8.909502505614 61.8725325434494,8.9005926049848 61.917162338915595,8.995271121268448 61.92133746112156,9.004044760547872 61.8766998819372,8.909502505614 61.8725325434494)))"
21850006875000,257,135,122,43.8,"MULTIPOLYGON(((9.004044760547872 61.8766998819372,8.995271121268448 61.92133746112156,9.08997891982682 61.925447650908,9.098616159947078 61.88080240698727,9.004044760547872 61.8766998819372)))"
21900006875000,98,48,50,48,"MULTIPOLYGON(((9.098616159947078 61.88080240698727,9.08997891982682 61.925447650908,9.184715554144043 61.929492869707786,9.193216259339083 61.884840080201066,9.098616159947078 61.88080240698727)))"
22000006875000,182,94,88,47.9,"MULTIPOLYGON(((9.287844613397317 61.88881286376573,9.279480576843483 61.93347307954212,9.374273539700281 61.93738824302182,9.382500775953615 61.89272072045569,9.287844613397317 61.88881286376573)))"
22050006875000,11,6,5,57.3,"MULTIPOLYGON(((9.382500775953615 61.89272072045569,9.374273539700281 61.93738824302182,9.46909399365397 61.9412383233487,9.477184300010757 61.89656361363378,9.382500775953615 61.89272072045569)))"
22350006875000,7,4,3,40.6,"MULTIPOLYGON(((9.950996641462162 61.91480238590447,9.943592855869168 61.95951123128901,10.038568780945141 61.96297007319694,10.045834902747853 61.91825476174993,9.950996641462162 61.91480238590447)))"
22400006875000,9,4,5,29.6,"MULTIPOLYGON(((10.045834902747853 61.91825476174993,10.038568780945141 61.96297007319694,10.133569031370065 61.966363591021185,10.140697374404319 61.92164193420911,10.045834902747853 61.91825476174993)))"
22800006875000,3,2,1,0,"MULTIPOLYGON(((10.805374411666643 61.94352384407486,10.799213561282281 61.988286527421984,10.894391965514375 61.991156350425385,10.900414193803844 61.94638829213986,10.805374411666643 61.94352384407486)))"
22850006875000,2,2,0,0,"MULTIPOLYGON(((10.900414193803844 61.94638829213986,10.894391965514375 61.991156350425385,10.989590572755809 61.99396058289772,10.99547408317655 61.94918727154383,10.900414193803844 61.94638829213986)))"
22900006875000,3,2,1,0,"MULTIPOLYGON(((10.99547408317655 61.94918727154383,10.989590572755809 61.99396058289772,11.084808921727248 61.99669919827349,11.090553620664826 61.95192075583844,10.99547408317655 61.94918727154383)))"
22950006875000,122,69,53,45.1,"MULTIPOLYGON(((11.090553620664826 61.95192075583844,11.084808921727248 61.99669919827349,11.180046550550532 61.99937217059888,11.18565234655464 61.95458871918439,11.090553620664826 61.95192075583844)))"
23350006875000,2,2,0,0,"MULTIPOLYGON(((11.851841968556588 61.9714278338587,11.847210870962822 62.01624292022379,11.942586043646026 62.01838988751177,11.947077585145728 61.97357077278219,11.851841968556588 61.9714278338587)))"
23400006875000,1,1,0,0,"MULTIPOLYGON(((11.947077585145728 61.97357077278219,11.942586043646026 62.01838988751177,12.037976314593896 62.02047100583932,12.042328228221873 61.97564798575689,11.947077585145728 61.97357077278219)))"
23450006875000,1,1,0,0,"MULTIPOLYGON(((12.042328228221873 61.97564798575689,12.037976314593896 62.02047100583932,12.13338121669683 62.02248625541786,12.137593432881 61.97765945308181,12.042328228221873 61.97564798575689)))"
19650006880000,6,2,4,73.2,"MULTIPOLYGON(((4.863294617475564 61.67684695863076,4.848635708519941 61.721029971406324,4.941775749160438 61.72796534965569,4.956305748523257 61.68376959388688,4.863294617475564 61.67684695863076)))"
19700006880000,43,20,23,37.9,"MULTIPOLYGON(((4.956305748523257 61.68376959388688,4.941775749160438 61.72796534965569,5.034963510732574 61.73483787817694,5.049364381069874 61.69062948924853,4.956305748523257 61.68376959388688)))"
19750006880000,20,10,10,57.3,"MULTIPOLYGON(((5.049364381069874 61.69062948924853,5.034963510732574 61.73483787817694,5.128198592907095 61.74164749439097,5.142470116471081 61.69742658240187,5.049364381069874 61.69062948924853)))"
19800006880000,139,68,71,48,"MULTIPOLYGON(((5.142470116471081 61.69742658240187,5.128198592907095 61.74164749439097,5.221480594014067 61.74839413623337,5.235622554751977 61.70416081154578,5.142470116471081 61.69742658240187)))"
20250006880000,7,5,2,58.1,"MULTIPOLYGON(((5.982474935947577 61.75576429508833,5.969377049021903 61.80009291737963,6.06306302880677 61.80627008293976,6.076029486347682 61.761930052731294,5.982474935947577 61.75576429508833)))"
20300006880000,575,295,280,43.4,"MULTIPOLYGON(((6.076029486347682 61.761930052731294,6.06306302880677 61.80627008293976,6.156791839164876 61.8123836822501,6.169626668761675 61.768032357009886,6.076029486347682 61.761930052731294)))"
20350006880000,1323,673,650,42.5,"MULTIPOLYGON(((6.169626668761675 61.768032357009886,6.156791839164876 61.8123836822501,6.250563064308524 61.81843365904397,6.263266069204098 61.7740711518984,6.169626668761675 61.768032357009886)))"
20450006880000,39,20,19,47.5,"MULTIPOLYGON(((6.356947272474975 61.78004638190807,6.344376287226138 61.82441995759365,6.438231089692575 61.83034252271241,6.450669862170031 61.78595799208895,6.356947272474975 61.78004638190807)))"
20500006880000,269,124,145,46.9,"MULTIPOLYGON(((6.450669862170031 61.78595799208895,6.438231089692575 61.83034252271241,6.532127052279533 61.83620129975639,6.544433420691036 61.7918059280318,6.450669862170031 61.78595799208895)))"
20550006880000,44,24,20,51.8,"MULTIPOLYGON(((6.544433420691036 61.7918059280318,6.532127052279533 61.83620129975639,6.626063754365993 61.84199623462644,6.638237529256202 61.79759013586993,6.544433420691036 61.7918059280318)))"
20600006880000,8,5,3,44.1,"MULTIPOLYGON(((6.638237529256202 61.79759013586993,6.626063754365993 61.84199623462644,6.720040774148803 61.84772727377004,6.732081767910667 61.8033105622812,6.638237529256202 61.79759013586993)))"
20650006880000,540,278,262,43.4,"MULTIPOLYGON(((6.732081767910667 61.8033105622812,6.720040774148803 61.84772727377004,6.814057688653315 61.853394364183174,6.825965715537055 61.808967154489714,6.732081767910667 61.8033105622812)))"
20700006880000,150,76,74,45.9,"MULTIPOLYGON(((6.825965715537055 61.808967154489714,6.814057688653315 61.853394364183174,6.908114073744098 61.858997453412165,6.919888949866142 61.81455986026772,6.825965715537055 61.808967154489714)))"
20750006880000,30,15,15,43.2,"MULTIPOLYGON(((6.919888949866142 61.81455986026772,6.908114073744098 61.858997453412165,7.002209504135768 61.8645364895555,7.013851047487586 61.82008862793746,6.919888949866142 61.81455986026772)))"
20850006880000,6,3,3,53.3,"MULTIPOLYGON(((7.107851583860732 61.82555340637289,7.096343553403867 61.87001142126561,7.190515793995814 61.87542219775078,7.201890133325518 61.83095414500154,7.107851583860732 61.82555340637289)))"
21200006880000,9,3,6,41.7,"MULTIPOLYGON(((7.766895729811113 61.86201097896032,7.756327173065459 61.90653682307134,7.850754689032696 61.911497137866974,7.861188360729282 61.86696206977636,7.766895729811113 61.86201097896032)))"
21250006880000,55,26,29,49.4,"MULTIPOLYGON(((7.861188360729282 61.86696206977636,7.850754689032696 61.911497137866974,7.945216936634354 61.916392911321395,7.955515560493062 61.871848736341725,7.861188360729282 61.86696206977636)))"
21300006880000,23,12,11,37.6,"MULTIPOLYGON(((7.955515560493062 61.871848736341725,7.945216936634354 61.916392911321395,8.039713478671707 61.92122409772287,8.04987689387086 61.876670933143195,7.955515560493062 61.871848736341725)))"
21350006880000,230,123,107,47.1,"MULTIPOLYGON(((8.04987689387086 61.876670933143195,8.039713478671707 61.92122409772287,8.134243876931974 61.92599065193237,8.144271924624894 61.88142861523809,8.04987689387086 61.876670933143195)))"
21400006880000,221,109,112,50.1,"MULTIPOLYGON(((8.144271924624894 61.88142861523809,8.134243876931974 61.92599065193237,8.22880769220012 61.93069252938538,8.238700215522927 61.88612173825567,8.144271924624894 61.88142861523809)))"
21450006880000,171,78,93,45,"MULTIPOLYGON(((8.238700215522927 61.88612173825567,8.22880769220012 61.93069252938538,8.323404484270748 61.935329686093205,8.333161328350071 61.890750258398775,8.238700215522927 61.88612173825567)))"
21500006880000,7,5,2,42.1,"MULTIPOLYGON(((8.333161328350071 61.890750258398775,8.323404484270748 61.935329686093205,8.418033811960086 61.93990207864482,8.427654823920662 61.8953141324455,8.333161328350071 61.890750258398775)))"
21800006880000,50,28,22,48.8,"MULTIPOLYGON(((8.9005926049848 61.917162338915595,8.891652976290654 61.961791100293176,8.986468199568762 61.96597402880977,8.995271121268448 61.92133746112156,8.9005926049848 61.917162338915595)))"
21850006880000,12,4,8,55,"MULTIPOLYGON(((8.995271121268448 61.92133746112156,8.986468199568762 61.96597402880977,9.081312843804241 61.970091905591346,9.08997891982682 61.925447650908,8.995271121268448 61.92133746112156)))"
21950006880000,124,62,62,47.6,"MULTIPOLYGON(((9.184715554144043 61.929492869707786,9.176186460425416 61.9741446919013,9.271088599993027 61.978132349593714,9.279480576843483 61.93347307954212,9.184715554144043 61.929492869707786)))"
22000006880000,58,30,28,44.4,"MULTIPOLYGON(((9.279480576843483 61.93347307954212,9.271088599993027 61.978132349593714,9.366018812212905 61.98205484111493,9.374273539700281 61.93738824302182,9.279480576843483 61.93347307954212)))"
22350006880000,30,16,14,42.3,"MULTIPOLYGON(((9.943592855869168 61.95951123128901,9.936164290251504 62.00421927258676,10.031278333671384 62.00768459942542,10.038568780945141 61.96297007319694,9.943592855869168 61.95951123128901)))"
22750006880000,50,27,23,41.3,"MULTIPOLYGON(((10.70405582072643 61.98535114106368,10.697735322351818 62.030107664897805,10.793032047117345 62.03304856403646,10.799213561282281 61.988286527421984,10.70405582072643 61.98535114106368)))"
22800006880000,31,13,18,37.3,"MULTIPOLYGON(((10.799213561282281 61.988286527421984,10.793032047117345 62.03304856403646,10.888349534113493 62.03592377771936,10.894391965514375 61.991156350425385,10.799213561282281 61.988286527421984)))"
22850006880000,10,4,6,52.8,"MULTIPOLYGON(((10.894391965514375 61.991156350425385,10.888349534113493 62.03592377771936,10.983687320505249 62.03873327864976,10.989590572755809 61.99396058289772,10.894391965514375 61.991156350425385)))"
22900006880000,4,2,2,0,"MULTIPOLYGON(((10.989590572755809 61.99396058289772,10.983687320505249 62.03873327864976,11.079044942840298 62.04147704014429,11.084808921727248 61.99669919827349,10.989590572755809 61.99396058289772)))"
22950006880000,36,18,18,45.5,"MULTIPOLYGON(((11.084808921727248 61.99669919827349,11.079044942840298 62.04147704014429,11.174421937062698 62.044155036133915,11.180046550550532 61.99937217059888,11.084808921727248 61.99669919827349)))"
23250006880000,22,15,7,40,"MULTIPOLYGON(((11.65650768651181 62.01175152102101,11.651581204009208 62.05655766421501,11.747064652315558 62.05884055424632,11.751851263193288 62.014030124384156,11.65650768651181 62.01175152102101)))"
23450006880000,5,3,2,44.8,"MULTIPOLYGON(((12.037976314593896 62.02047100583932,12.033609769736431 62.06529355622067,12.1291548368417 62.06731259917423,12.13338121669683 62.02248625541786,12.037976314593896 62.02047100583932)))"
19600006885000,1,0,1,0,"MULTIPOLYGON(((4.755543787790489 61.714031806520595,4.740707672589976 61.75819961694407,4.833928679426771 61.76521067060833,4.848635708519941 61.721029971406324,4.755543787790489 61.714031806520595)))"
19650006885000,336,171,165,43.8,"MULTIPOLYGON(((4.848635708519941 61.721029971406324,4.833928679426771 61.76521067060833,4.927198028640994 61.77215882779295,4.941775749160438 61.72796534965569,4.848635708519941 61.721029971406324)))"
19700006885000,6,4,2,60.3,"MULTIPOLYGON(((4.941775749160438 61.72796534965569,4.927198028640994 61.77215882779295,5.020515319569425 61.77904402513746,5.034963510732574 61.73483787817694,4.941775749160438 61.72796534965569)))"
19750006885000,9,5,4,49.8,"MULTIPOLYGON(((5.034963510732574 61.73483787817694,5.020515319569425 61.77904402513746,5.11388015018874 61.78586619979592,5.128198592907095 61.74164749439097,5.034963510732574 61.73483787817694)))"
19800006885000,32,16,16,54,"MULTIPOLYGON(((5.128198592907095 61.74164749439097,5.11388015018874 61.78586619979592,5.207292117124725 61.7926252894391,5.221480594014067 61.74839413623337,5.128198592907095 61.74164749439097)))"
19850006885000,1123,562,561,44.1,"MULTIPOLYGON(((5.221480594014067 61.74839413623337,5.207292117124725 61.7926252894391,5.300750815661566 61.79932123225653,5.314809111052095 61.75507774215657,5.221480594014067 61.74839413623337)))"
20050006885000,16,8,8,47.6,"MULTIPOLYGON(((5.595069707963678 61.7747497367316,5.581403233793036 61.81902956947592,5.675044785073944 61.82547231733517,5.688580232411769 61.781180593911856,5.595069707963678 61.7747497367316)))"
20250006885000,107,58,49,40.5,"MULTIPOLYGON(((5.969377049021903 61.80009291737963,5.956235916761987 61.84441963869261,6.050053740486923 61.850608244671086,6.06306302880677 61.80627008293976,5.969377049021903 61.80009291737963)))"
20300006885000,129,68,61,38,"MULTIPOLYGON(((6.06306302880677 61.80627008293976,6.050053740486923 61.850608244671086,6.143914594578552 61.856733171218,6.156791839164876 61.8123836822501,6.06306302880677 61.80627008293976)))"
20350006885000,116,58,58,39.4,"MULTIPOLYGON(((6.156791839164876 61.8123836822501,6.143914594578552 61.856733171218,6.237818061436709 61.8627943618242,6.250563064308524 61.81843365904397,6.156791839164876 61.8123836822501)))"
20400006885000,78,47,31,48.1,"MULTIPOLYGON(((6.250563064308524 61.81843365904397,6.237818061436709 61.8627943618242,6.331763722227934 61.86879176052165,6.344376287226138 61.82441995759365,6.250563064308524 61.81843365904397)))"
20450006885000,54,30,24,46.5,"MULTIPOLYGON(((6.344376287226138 61.82441995759365,6.331763722227934 61.86879176052165,6.425751156895818 61.87472531188545,6.438231089692575 61.83034252271241,6.344376287226138 61.82441995759365)))"
20500006885000,257,125,132,43,"MULTIPOLYGON(((6.438231089692575 61.83034252271241,6.425751156895818 61.87472531188545,6.519779944171498 61.88059496103564,6.532127052279533 61.83620129975639,6.438231089692575 61.83034252271241)))"
20550006885000,513,250,263,44.9,"MULTIPOLYGON(((6.532127052279533 61.83620129975639,6.519779944171498 61.88059496103564,6.613849661584176 61.88640065363922,6.626063754365993 61.84199623462644,6.532127052279533 61.83620129975639)))"
20600006885000,265,138,127,36.7,"MULTIPOLYGON(((6.626063754365993 61.84199623462644,6.613849661584176 61.88640065363922,6.707959885471773 61.89214233591199,6.720040774148803 61.84772727377004,6.626063754365993 61.84199623462644)))"
20650006885000,190,95,95,43.8,"MULTIPOLYGON(((6.720040774148803 61.84772727377004,6.707959885471773 61.89214233591199,6.80211019099163 61.89781995462039,6.814057688653315 61.853394364183174,6.720040774148803 61.84772727377004)))"
20700006885000,602,344,258,40.2,"MULTIPOLYGON(((6.814057688653315 61.853394364183174,6.80211019099163 61.89781995462039,6.896300152131313 61.90343345708349,6.908114073744098 61.858997453412165,6.814057688653315 61.853394364183174)))"
20800006885000,69,32,37,46.6,"MULTIPOLYGON(((7.002209504135768 61.8645364895555,6.990529341719506 61.908982791174616,7.084797331436953 61.91446790532346,7.096343553403867 61.87001142126561,7.002209504135768 61.8645364895555)))"
20850006885000,124,72,52,43.3,"MULTIPOLYGON(((7.096343553403867 61.87001142126561,7.084797331436953 61.91446790532346,7.179103691827543 61.9198887485176,7.190515793995814 61.87542219775078,7.096343553403867 61.87001142126561)))"
20900006885000,5,4,1,29.6,"MULTIPOLYGON(((7.190515793995814 61.87542219775078,7.179103691827543 61.9198887485176,7.273447992309405 61.925245270304494,7.284725797242005 61.88076876877676,7.190515793995814 61.87542219775078)))"
21250006885000,1,1,0,0,"MULTIPOLYGON(((7.850754689032696 61.911497137866974,7.840286285530717 61.956030897111695,7.934884018170927 61.96093580376952,7.945216936634354 61.916392911321395,7.850754689032696 61.911497137866974)))"
21300006885000,10,6,4,53.6,"MULTIPOLYGON(((7.945216936634354 61.916392911321395,7.934884018170927 61.96093580376952,8.029516207082596 61.96577600576247,8.039713478671707 61.92122409772287,7.945216936634354 61.916392911321395)))"
21950006885000,586,295,291,49.7,"MULTIPOLYGON(((9.176186460425416 61.9741446919013,9.167628843617852 62.01879554385287,9.262668550349929 62.02279067109486,9.271088599993027 61.978132349593714,9.176186460425416 61.9741446919013)))"
22000006885000,20,9,11,49.2,"MULTIPOLYGON(((9.271088599993027 61.978132349593714,9.262668550349929 62.02279067109486,9.357736463071403 62.02672051201085,9.366018812212905 61.98205484111493,9.271088599993027 61.978132349593714)))"
22350006885000,44,25,19,46.8,"MULTIPOLYGON(((9.936164290251504 62.00421927258676,9.92871082677802 62.048926507649426,10.02396344521488 62.05239833837752,10.031278333671384 62.00768459942542,9.936164290251504 62.00421927258676)))"
22750006885000,56,28,28,39.5,"MULTIPOLYGON(((10.697735322351818 62.030107664897805,10.691393599435113 62.07486352443768,10.78682977061663 62.07780995252587,10.793032047117345 62.03304856403646,10.697735322351818 62.030107664897805)))"
22800006885000,12,3,9,24.9,"MULTIPOLYGON(((10.793032047117345 62.03304856403646,10.78682977061663 62.07780995252587,10.88228680321411 62.08069057270514,10.888349534113493 62.03592377771936,10.793032047117345 62.03304856403646)))"
22900006885000,6,3,3,61.3,"MULTIPOLYGON(((10.983687320505249 62.03873327864976,10.977764232210795 62.083505357557435,11.073261591967675 62.0862542802808,11.079044942840298 62.04147704014429,10.983687320505249 62.03873327864976)))"
23250006885000,31,19,12,49.2,"MULTIPOLYGON(((11.651581204009208 62.05655766421501,11.646638145773768 62.101363288867404,11.742261933601363 62.1036504781816,11.747064652315558 62.05884055424632,11.651581204009208 62.05655766421501)))"
23450006885000,24,11,13,51,"MULTIPOLYGON(((12.033609769736431 62.06529355622067,12.02922852363021 62.110115636362835,12.124914225519554 62.11213848386667,12.1291548368417 62.06731259917423,12.033609769736431 62.06529355622067)))"
23500006885000,11,5,6,39.3,"MULTIPOLYGON(((12.1291548368417 62.06731259917423,12.124914225519554 62.11213848386667,12.220614227034698 62.11409519600534,12.224714135341316 62.069265630667466,12.1291548368417 62.06731259917423)))"
19650006890000,180,92,88,44.3,"MULTIPOLYGON(((4.833928679426771 61.76521067060833,4.819173307727976 61.80938904699557,4.912572366180665 61.816350019222504,4.927198028640994 61.77215882779295,4.833928679426771 61.76521067060833)))"
19700006890000,75,37,38,45.9,"MULTIPOLYGON(((4.927198028640994 61.77215882779295,4.912572366180665 61.816350019222504,5.00601958849025 61.82324792121787,5.020515319569425 61.77904402513746,4.927198028640994 61.77215882779295)))"
19750006890000,3,1,2,0,"MULTIPOLYGON(((5.020515319569425 61.77904402513746,5.00601958849025 61.82324792121787,5.099514570930129 61.83008268986736,5.11388015018874 61.78586619979592,5.020515319569425 61.77904402513746)))"
19800006890000,31,15,16,61.9,"MULTIPOLYGON(((5.11388015018874 61.78586619979592,5.099514570930129 61.83008268986736,5.19305690841251 61.83685426257534,5.207292117124725 61.7926252894391,5.11388015018874 61.78586619979592)))"
19850006890000,3,2,1,0,"MULTIPOLYGON(((5.207292117124725 61.7926252894391,5.19305690841251 61.83685426257534,5.286646194497744 61.84356257726696,5.300750815661566 61.79932123225653,5.207292117124725 61.7926252894391)))"
19950006890000,6,4,2,51,"MULTIPOLYGON(((5.394255839751237 61.80595396695868,5.38028202140382 61.850207572390126,5.473963980015888 61.8567891869179,5.487806782023017 61.81252343277899,5.394255839751237 61.80595396695868)))"
20050006890000,68,33,35,42.9,"MULTIPOLYGON(((5.581403233793036 61.81902956947592,5.567691659895889 61.86330736035035,5.661464649292316 61.86976203271668,5.675044785073944 61.82547231733517,5.581403233793036 61.81902956947592)))"
20100006890000,97,49,48,39.9,"MULTIPOLYGON(((5.675044785073944 61.82547231733517,5.661464649292316 61.86976203271668,5.755282535150002 61.87615314457734,5.768731024584678 61.83185161717148,5.675044785073944 61.82547231733517)))"
20150006890000,17,10,7,52.6,"MULTIPOLYGON(((5.768731024584678 61.83185161717148,5.755282535150002 61.87615314457734,5.849144903120057 61.88248063702606,5.862461539760316 61.838167410330875,5.768731024584678 61.83185161717148)))"
20200006890000,12,4,8,54.9,"MULTIPOLYGON(((5.862461539760316 61.838167410330875,5.849144903120057 61.88248063702606,5.943051337569853 61.888744451691856,5.956235916761987 61.84441963869261,5.862461539760316 61.838167410330875)))"
20250006890000,1,1,0,0,"MULTIPOLYGON(((5.956235916761987 61.84441963869261,5.943051337569853 61.888744451691856,6.037001421593126 61.89494453074104,6.050053740486923 61.850608244671086,5.956235916761987 61.84441963869261)))"
20300006890000,84,44,40,46.1,"MULTIPOLYGON(((6.050053740486923 61.850608244671086,6.037001421593126 61.89494453074104,6.130994737020149 61.90108081687928,6.143914594578552 61.856733171218,6.050053740486923 61.850608244671086)))"
20350006890000,22,13,9,37.1,"MULTIPOLYGON(((6.143914594578552 61.856733171218,6.130994737020149 61.90108081687928,6.225030864428017 61.9071532533535,6.237818061436709 61.8627943618242,6.143914594578552 61.856733171218)))"
20400006890000,60,28,32,40.8,"MULTIPOLYGON(((6.237818061436709 61.8627943618242,6.225030864428017 61.9071532533535,6.319109383150993 61.91316178395393,6.331763722227934 61.86879176052165,6.237818061436709 61.8627943618242)))"
20550006890000,145,81,64,44.3,"MULTIPOLYGON(((6.519779944171498 61.88059496103564,6.507391905727912 61.92498690542241,6.60159506213068 61.93080338660475,6.613849661584176 61.88640065363922,6.519779944171498 61.88059496103564)))"
20600006890000,537,279,258,36.8,"MULTIPOLYGON(((6.613849661584176 61.88640065363922,6.60159506213068 61.93080338660475,6.695838914967522 61.9365557425458,6.707959885471773 61.89214233591199,6.613849661584176 61.88640065363922)))"
20650006890000,2508,1242,1266,40,"MULTIPOLYGON(((6.707959885471773 61.89214233591199,6.695838914967522 61.9365557425458,6.790123037516971 61.94224391978111,6.80211019099163 61.89781995462039,6.707959885471773 61.89214233591199)))"
20700006890000,167,95,72,42,"MULTIPOLYGON(((6.80211019099163 61.89781995462039,6.790123037516971 61.94224391978111,6.884447001878704 61.94786786540106,6.896300152131313 61.90343345708349,6.80211019099163 61.89781995462039)))"
20750006890000,86,48,38,42,"MULTIPOLYGON(((6.896300152131313 61.90343345708349,6.884447001878704 61.94786786540106,6.978810378984502 61.9534275270526,6.990529341719506 61.908982791174616,6.896300152131313 61.90343345708349)))"
20800006890000,128,67,61,37,"MULTIPOLYGON(((6.990529341719506 61.908982791174616,6.978810378984502 61.9534275270526,7.073212738609285 61.95892285294116,7.084797331436953 61.91446790532346,6.990529341719506 61.908982791174616)))"
20850006890000,52,29,23,45.5,"MULTIPOLYGON(((7.084797331436953 61.91446790532346,7.073212738609285 61.95892285294116,7.167653649382246 61.96435379183243,7.179103691827543 61.9198887485176,7.084797331436953 61.91446790532346)))"
20900006890000,38,19,19,47.6,"MULTIPOLYGON(((7.179103691827543 61.9198887485176,7.167653649382246 61.96435379183243,7.262132678798065 61.96972029305422,7.273447992309405 61.925245270304494,7.179103691827543 61.9198887485176)))"
21250006890000,2,2,0,0,"MULTIPOLYGON(((7.840286285530717 61.956030897111695,7.829782986407375 62.00056334295212,7.924516643265706 62.0054774092522,7.934884018170927 61.96093580376952,7.840286285530717 61.956030897111695)))"
21900006890000,158,81,77,45.5,"MULTIPOLYGON(((9.072617795251373 62.01473516800408,9.063893636672663 62.05937743509226,9.159042568301082 62.0634454226138,9.167628843617852 62.01879554385287,9.072617795251373 62.01473516800408)))"
21950006890000,76,37,39,47.4,"MULTIPOLYGON(((9.167628843617852 62.01879554385287,9.159042568301082 62.0634454226138,9.254220294575955 62.067448041200514,9.262668550349929 62.02279067109486,9.167628843617852 62.01879554385287)))"
22350006890000,16,9,7,43.3,"MULTIPOLYGON(((9.92871082677802 62.048926507649426,9.92123234686601 62.0936329343137,10.01662399912556 62.09711128798095,10.02396344521488 62.05239833837752,9.92871082677802 62.048926507649426)))"
22400006890000,1,1,0,0,"MULTIPOLYGON(((10.02396344521488 62.05239833837752,10.01662399912556 62.09711128798095,10.112040326087236 62.10052395340092,10.119240621160522 62.05580460259302,10.02396344521488 62.05239833837752)))"
22650006890000,93,50,43,44.2,"MULTIPOLYGON(((10.50058569819331 62.068773357280705,10.493943135994108 62.1135170927327,10.589475896441364 62.116600842359574,10.595978754050323 62.0718513164736,10.50058569819331 62.068773357280705)))"
22700006890000,1134,565,569,42.6,"MULTIPOLYGON(((10.595978754050323 62.0718513164736,10.589475896441364 62.116600842359574,10.685030550613398 62.119618718202666,10.691393599435113 62.07486352443768,10.595978754050323 62.0718513164736)))"
22750006890000,11,6,5,32.3,"MULTIPOLYGON(((10.691393599435113 62.07486352443768,10.685030550613398 62.119618718202666,10.780606632593944 62.122570691487475,10.78682977061663 62.07780995252587,10.691393599435113 62.07486352443768)))"
22800006890000,178,90,88,45.1,"MULTIPOLYGON(((10.78682977061663 62.07780995252587,10.780606632593944 62.122570691487475,10.876203675811812 62.12545673405626,10.88228680321411 62.08069057270514,10.78682977061663 62.07780995252587)))"
22900006890000,46,23,23,44.1,"MULTIPOLYGON(((10.977764232210795 62.083505357557435,10.971821213054737 62.1282768183689,11.067458776483214 62.131030917504106,11.073261591967675 62.0862542802808,10.977764232210795 62.083505357557435)))"
23200006890000,12,8,4,34.2,"MULTIPOLYGON(((11.551031012975644 62.09901006713956,11.545930569877394 62.14381073670709,11.641678432423763 62.146168394201396,11.646638145773768 62.101363288867404,11.551031012975644 62.09901006713956)))"
23250006890000,15,7,8,50.9,"MULTIPOLYGON(((11.646638145773768 62.101363288867404,11.641678432423763 62.146168394201396,11.737443029891237 62.148459895474204,11.742261933601363 62.1036504781816,11.646638145773768 62.101363288867404)))"
19650006895000,13,8,5,51.2,"MULTIPOLYGON(((4.819173307727976 61.80938904699557,4.804369369586195 61.8535650912682,4.897898539635014 61.860538914810576,4.912572366180665 61.816350019222504,4.819173307727976 61.80938904699557)))"
19700006895000,589,311,278,47.1,"MULTIPOLYGON(((4.912572366180665 61.816350019222504,4.897898539635014 61.860538914810576,4.991476097053904 61.867449557449376,5.00601958849025 61.82324792121787,4.912572366180665 61.816350019222504)))"
19750006895000,131,66,65,45,"MULTIPOLYGON(((5.00601958849025 61.82324792121787,4.991476097053904 61.867449557449376,5.085101636403712 61.874296955800375,5.099514570930129 61.83008268986736,5.00601958849025 61.82324792121787)))"
19800006895000,48,25,23,51.5,"MULTIPOLYGON(((5.099514570930129 61.83008268986736,5.085101636403712 61.874296955800375,5.178774750873695 61.881081046999924,5.19305690841251 61.83685426257534,5.099514570930129 61.83008268986736)))"
19850006895000,28,17,11,55.9,"MULTIPOLYGON(((5.19305690841251 61.83685426257534,5.178774750873695 61.881081046999924,5.27249503229094 61.887801768707156,5.286646194497744 61.84356257726696,5.19305690841251 61.83685426257534)))"
19900006895000,166,80,86,46.3,"MULTIPOLYGON(((5.286646194497744 61.84356257726696,5.27249503229094 61.887801768707156,5.366262071129875 61.894459059106055,5.38028202140382 61.850207572390126,5.286646194497744 61.84356257726696)))"
19950006895000,10,6,4,33,"MULTIPOLYGON(((5.38028202140382 61.850207572390126,5.366262071129875 61.894459059106055,5.460075456521899 61.901052856907626,5.473963980015888 61.8567891869179,5.38028202140382 61.850207572390126)))"
20000006895000,207,108,99,48.9,"MULTIPOLYGON(((5.473963980015888 61.8567891869179,5.460075456521899 61.901052856907626,5.55393477626504 61.907583101351975,5.567691659895889 61.86330736035035,5.473963980015888 61.8567891869179)))"
20050006895000,33,18,15,52.4,"MULTIPOLYGON(((5.567691659895889 61.86330736035035,5.55393477626504 61.907583101351975,5.647839616833799 61.91404973221045,5.661464649292316 61.86976203271668,5.567691659895889 61.86330736035035)))"
20100006895000,86,46,40,45.9,"MULTIPOLYGON(((5.661464649292316 61.86976203271668,5.647839616833799 61.91404973221045,5.741789563388997 61.920452689787574,5.755282535150002 61.87615314457734,5.661464649292316 61.86976203271668)))"
20150006895000,483,251,232,40.5,"MULTIPOLYGON(((5.755282535150002 61.87615314457734,5.741789563388997 61.920452689787574,5.835784199787775 61.926791914923335,5.849144903120057 61.88248063702606,5.755282535150002 61.87615314457734)))"
20200006895000,592,313,279,40.8,"MULTIPOLYGON(((5.849144903120057 61.88248063702606,5.835784199787775 61.926791914923335,5.929823108593657 61.933067348994996,5.943051337569853 61.888744451691856,5.849144903120057 61.88248063702606)))"
20250006895000,3328,1669,1659,40.8,"MULTIPOLYGON(((5.943051337569853 61.888744451691856,5.929823108593657 61.933067348994996,6.0239058710867 61.93927893391931,6.037001421593126 61.89494453074104,5.943051337569853 61.888744451691856)))"
20300006895000,672,348,324,38.3,"MULTIPOLYGON(((6.037001421593126 61.89494453074104,6.0239058710867 61.93927893391931,6.118032067273758 61.94542661215441,6.130994737020149 61.90108081687928,6.037001421593126 61.89494453074104)))"
20350006895000,45,22,23,48,"MULTIPOLYGON(((6.130994737020149 61.90108081687928,6.118032067273758 61.94542661215441,6.212201275898815 61.951510326701936,6.225030864428017 61.9071532533535,6.130994737020149 61.90108081687928)))"
20400006895000,78,38,40,44.7,"MULTIPOLYGON(((6.225030864428017 61.9071532533535,6.212201275898815 61.951510326701936,6.306413074453424 61.95753002110884,6.319109383150993 61.91316178395393,6.225030864428017 61.9071532533535)))"
20450006895000,7,3,4,49.1,"MULTIPOLYGON(((6.319109383150993 61.91316178395393,6.306413074453424 61.95753002110884,6.400667039187198 61.96348563946955,6.413229871290948 61.919106353016026,6.319109383150993 61.91316178395393)))"
20500006895000,87,47,40,47.2,"MULTIPOLYGON(((6.413229871290948 61.919106353016026,6.400667039187198 61.96348563946955,6.494962745118433 61.96937712642783,6.507391905727912 61.92498690542241,6.413229871290948 61.919106353016026)))"
20550006895000,379,190,189,44.8,"MULTIPOLYGON(((6.507391905727912 61.92498690542241,6.494962745118433 61.96937712642783,6.589299766044819 61.975204427178674,6.60159506213068 61.93080338660475,6.507391905727912 61.92498690542241)))"
21100006895000,2,1,1,0,"MULTIPOLYGON(((7.545794137069269 61.985432672449335,7.534847684621842 62.02993553414077,7.629610703004222 62.03505332903557,7.640421293709723 61.99054092757508,7.545794137069269 61.985432672449335)))"
21150006895000,7,4,3,53.3,"MULTIPOLYGON(((7.640421293709723 61.99054092757508,7.629610703004222 62.03505332903557,7.724409830754112 62.040106323745135,7.735084389846603 61.995584500163574,7.640421293709723 61.99054092757508)))"
21200006895000,1,1,0,0,"MULTIPOLYGON(((7.735084389846603 61.995584500163574,7.724409830754112 62.040106323745135,7.819244626812813 62.04509447079973,7.829782986407375 62.00056334295212,7.735084389846603 61.995584500163574)))"
21800006895000,24,11,13,50.6,"MULTIPOLYGON(((8.873683970883867 62.0510455077727,8.864654310020626 62.09567114731482,8.959882348702266 62.099877631397355,8.968773953293207 62.05524411711897,8.873683970883867 62.0510455077727)))"
21850006895000,182,99,83,42.2,"MULTIPOLYGON(((8.968773953293207 62.05524411711897,8.959882348702266 62.099877631397355,9.055140229698091 62.104018703781385,9.063893636672663 62.05937743509226,8.968773953293207 62.05524411711897)))"
21900006895000,1374,681,693,45.6,"MULTIPOLYGON(((9.063893636672663 62.05937743509226,9.055140229698091 62.104018703781385,9.150427498193107 62.108094325215404,9.159042568301082 62.0634454226138,9.063893636672663 62.05937743509226)))"
21950006895000,1,0,1,0,"MULTIPOLYGON(((9.159042568301082 62.0634454226138,9.150427498193107 62.108094325215404,9.245743698483952 62.112104457046286,9.254220294575955 62.067448041200514,9.159042568301082 62.0634454226138)))"
22300006895000,2,1,1,0,"MULTIPOLYGON(((9.825865830257984 62.090088925459646,9.818222839895665 62.134787877529874,9.913728731175205 62.138338550401244,9.92123234686601 62.0936329343137,9.825865830257984 62.090088925459646)))"
22350006895000,523,252,271,50.6,"MULTIPOLYGON(((9.92123234686601 62.0936329343137,9.913728731175205 62.138338550401244,10.009259878209082 62.14182344614895,10.01662399912556 62.09711128798095,9.92123234686601 62.0936329343137)))"
22400006895000,258,127,131,45.8,"MULTIPOLYGON(((10.01662399912556 62.09711128798095,10.009259878209082 62.14182344614895,10.104815817888607 62.145242531565714,10.112040326087236 62.10052395340092,10.01662399912556 62.09711128798095)))"
22450006895000,21,12,9,44.5,"MULTIPOLYGON(((10.112040326087236 62.10052395340092,10.104815817888607 62.145242531565714,10.200396086348922 62.148595774055686,10.207480866051469 62.10387089812198,10.112040326087236 62.10052395340092)))"
22650006895000,520,279,241,37.5,"MULTIPOLYGON(((10.493943135994108 62.1135170927327,10.48727821470879 62.15826012720359,10.582951144996166 62.16134968429891,10.589475896441364 62.116600842359574,10.493943135994108 62.1135170927327)))"
22700006895000,307,159,148,44.2,"MULTIPOLYGON(((10.589475896441364 62.116600842359574,10.582951144996166 62.16134968429891,10.67864607387402 62.164373244701395,10.685030550613398 62.119618718202666,10.589475896441364 62.116600842359574)))"
22800006895000,188,91,97,41.2,"MULTIPOLYGON(((10.780606632593944 62.122570691487475,10.774362533227078 62.16733077950835,10.870100054279924 62.170222260436525,10.876203675811812 62.12545673405626,10.780606632593944 62.122570691487475)))"
22900006895000,3,1,2,0,"MULTIPOLYGON(((10.971821213054737 62.1282768183689,10.965858167610904 62.173047659823055,11.061636403166116 62.175806950626516,11.067458776483214 62.131030917504106,10.971821213054737 62.1282768183689)))"
23200006895000,11,8,3,30.5,"MULTIPOLYGON(((11.545930569877394 62.14381073670709,11.540812919931893 62.188610873074126,11.63670198406687 62.19097297943394,11.641678432423763 62.146168394201396,11.545930569877394 62.14381073670709)))"
23300006895000,3,1,2,0,"MULTIPOLYGON(((11.737443029891237 62.148459895474204,11.732607863529271 62.19326880540256,11.828530083715778 62.195498328944296,11.83322388992715 62.150685218587924,11.737443029891237 62.148459895474204)))"
23350006895000,2,2,0,0,"MULTIPOLYGON(((11.83322388992715 62.150685218587924,11.828530083715778 62.195498328944296,11.924468169518633 62.19766152865304,11.929020539678412 62.15284434223183,11.83322388992715 62.150685218587924)))"
23400006895000,35,16,19,54.8,"MULTIPOLYGON(((11.929020539678412 62.15284434223183,11.924468169518633 62.19766152865304,12.020421645340036 62.199758383753206,12.024832505805817 62.15493724572288,11.929020539678412 62.15284434223183)))"
23550006895000,4,2,2,0,"MULTIPOLYGON(((12.21650049148765 62.15892431265694,12.212372862283866 62.20375298018193,12.308369649890745 62.20565068311821,12.312355562062244 62.160818437878916,12.21650049148765 62.15892431265694)))"
19750006900000,23,10,13,50.3,"MULTIPOLYGON(((4.991476097053904 61.867449557449376,4.976884623458041 61.91164892480605,5.070641126530088 61.91850898873381,5.085101636403712 61.874296955800375,4.991476097053904 61.867449557449376)))"
19800006900000,539,277,262,40.6,"MULTIPOLYGON(((5.085101636403712 61.874296955800375,5.070641126530088 61.91850898873381,5.164445426162174 61.92530563401536,5.178774750873695 61.881081046999924,5.085101636403712 61.874296955800375)))"
19850006900000,293,158,135,39.1,"MULTIPOLYGON(((5.178774750873695 61.881081046999924,5.164445426162174 61.92530563401536,5.258297112438597 61.93203879804224,5.27249503229094 61.887801768707156,5.178774750873695 61.881081046999924)))"
19900006900000,6,2,4,73.8,"MULTIPOLYGON(((5.27249503229094 61.887801768707156,5.258297112438597 61.93203879804224,5.352195774080624 61.93870841873292,5.366262071129875 61.894459059106055,5.27249503229094 61.887801768707156)))"
19950006900000,321,168,153,45.7,"MULTIPOLYGON(((5.366262071129875 61.894459059106055,5.352195774080624 61.93870841873292,5.446140998456189 61.94531443453484,5.460075456521899 61.901052856907626,5.366262071129875 61.894459059106055)))"
20000006900000,211,112,99,45,"MULTIPOLYGON(((5.460075456521899 61.901052856907626,5.446140998456189 61.94531443453484,5.540132371589629 61.95185678442661,5.55393477626504 61.907583101351975,5.460075456521899 61.901052856907626)))"
20050006900000,298,153,145,39.5,"MULTIPOLYGON(((5.55393477626504 61.907583101351975,5.540132371589629 61.95185678442661,5.634169478171557 61.95833540792009,5.647839616833799 61.91404973221045,5.55393477626504 61.907583101351975)))"
20100006900000,119,59,60,41.4,"MULTIPOLYGON(((5.647839616833799 61.91404973221045,5.634169478171557 61.95833540792009,5.728251901568804 61.96475024506249,5.741789563388997 61.920452689787574,5.647839616833799 61.91404973221045)))"
20150006900000,101,51,50,46,"MULTIPOLYGON(((5.741789563388997 61.920452689787574,5.728251901568804 61.96475024506249,5.82237922383448 61.97110123643841,5.835784199787775 61.926791914923335,5.741789563388997 61.920452689787574)))"
20200006900000,211,105,106,41.1,"MULTIPOLYGON(((5.835784199787775 61.926791914923335,5.82237922383448 61.97110123643841,5.916551025718091 61.977388323171965,5.929823108593657 61.933067348994996,5.835784199787775 61.926791914923335)))"
20250006900000,1,1,0,0,"MULTIPOLYGON(((5.929823108593657 61.933067348994996,5.916551025718091 61.977388323171965,6.010766886675773 61.98361144692881,6.0239058710867 61.93927893391931,5.929823108593657 61.933067348994996)))"
20350006900000,1,1,0,0,"MULTIPOLYGON(((6.118032067273758 61.94542661215441,6.105026384880625 61.98977054991813,6.199329097233084 61.99586557489467,6.212201275898815 61.951510326701936,6.118032067273758 61.94542661215441)))"
20450006900000,29,15,14,35.3,"MULTIPOLYGON(((6.306413074453424 61.95753002110884,6.293674599371466 62.001896465160804,6.388062465682533 62.007863164568434,6.400667039187198 61.96348563946955,6.306413074453424 61.95753002110884)))"
20500006900000,11,8,3,41.6,"MULTIPOLYGON(((6.400667039187198 61.96348563946955,6.388062465682533 62.007863164568434,6.482492269312166 62.013765617520974,6.494962745118433 61.96937712642783,6.400667039187198 61.96348563946955)))"
20550006900000,529,276,253,40.9,"MULTIPOLYGON(((6.494962745118433 61.96937712642783,6.482492269312166 62.013765617520974,6.57696358217615 62.01960376897537,6.589299766044819 61.975204427178674,6.494962745118433 61.96937712642783)))"
20600006900000,162,87,75,43,"MULTIPOLYGON(((6.589299766044819 61.975204427178674,6.57696358217615 62.01960376897537,6.671475974971002 62.0253775644439,6.68367767455418 61.98096748747029,6.589299766044819 61.975204427178674)))"
20650006900000,58,35,23,41.7,"MULTIPOLYGON(((6.68367767455418 61.98096748747029,6.671475974971002 62.0253775644439,6.766029017184952 62.03108694999623,6.778096042035371 61.986666253606,6.68367767455418 61.98096748747029)))"
20750006900000,12,8,4,53.5,"MULTIPOLYGON(((6.872554438689218 61.992300672446135,6.860622277108932 62.03673187226124,6.955255321847705 62.04231227842894,6.967052433539559 61.99787069140983,6.872554438689218 61.992300672446135)))"
20800006900000,71,36,35,41.6,"MULTIPOLYGON(((6.967052433539559 61.99787069140983,6.955255321847705 62.04231227842894,7.049927717331081 62.04782811625231,7.061589594444341 62.003376258477005,6.967052433539559 61.99787069140983)))"
21700006900000,158,95,63,43,"MULTIPOLYGON(((8.674289574341051 62.087062104043405,8.664953031847922 62.13167053956217,8.760258244480038 62.13601586546346,8.769456567566962 62.09139929138221,8.674289574341051 62.087062104043405)))"
21750006900000,394,184,210,45.7,"MULTIPOLYGON(((8.769456567566962 62.09139929138221,8.760258244480038 62.13601586546346,8.855594352777066 62.14029573964831,8.864654310020626 62.09567114731482,8.769456567566962 62.09139929138221)))"
21800006900000,276,145,131,44.9,"MULTIPOLYGON(((8.864654310020626 62.09567114731482,8.855594352777066 62.14029573964831,8.95096090164693 62.14451012149403,8.959882348702266 62.099877631397355,8.864654310020626 62.09567114731482)))"
21850006900000,27,15,12,49.4,"MULTIPOLYGON(((8.959882348702266 62.099877631397355,8.95096090164693 62.14451012149403,9.046357435076278 62.1486589709759,9.055140229698091 62.104018703781385,8.959882348702266 62.099877631397355)))"
22000006900000,5,4,1,29,"MULTIPOLYGON(((9.245743698483952 62.112104457046286,9.23723862703114 62.15675991574816,9.332722369040033 62.16071193399221,9.341088373991873 62.11604906122058,9.245743698483952 62.112104457046286)))"
22050006900000,5,3,2,31.6,"MULTIPOLYGON(((9.341088373991873 62.11604906122058,9.332722369040033 62.16071193399221,9.428234262601306 62.16459826578251,9.436461067275694 62.11992810028607,9.341088373991873 62.11604906122058)))"
22250006900000,22,13,9,52.7,"MULTIPOLYGON(((9.722742666709529 62.13117146135237,9.714934244149593 62.17586277533234,9.810554131309434 62.17948599724648,9.818222839895665 62.134787877529874,9.722742666709529 62.13117146135237)))"
22300006900000,141,79,62,49,"MULTIPOLYGON(((9.818222839895665 62.134787877529874,9.810554131309434 62.17948599724648,9.90619985960178 62.18304335371835,9.913728731175205 62.138338550401244,9.818222839895665 62.134787877529874)))"
22350006900000,120,60,60,48.4,"MULTIPOLYGON(((9.913728731175205 62.138338550401244,9.90619985960178 62.18304335371835,10.001870964520938 62.186534810780024,10.009259878209082 62.14182344614895,9.913728731175205 62.138338550401244)))"
22400006900000,5,2,3,75.6,"MULTIPOLYGON(((10.009259878209082 62.14182344614895,10.001870964520938 62.186534810780024,10.097566980785416 62.18996033507646,10.104815817888607 62.145242531565714,10.009259878209082 62.14182344614895)))"
22450006900000,117,55,62,43.4,"MULTIPOLYGON(((10.104815817888607 62.145242531565714,10.097566980785416 62.18996033507646,10.193287442351533 62.19331989386671,10.200396086348922 62.148595774055686,10.104815817888607 62.145242531565714)))"
22500006900000,64,30,34,45.5,"MULTIPOLYGON(((10.200396086348922 62.148595774055686,10.193287442351533 62.19331989386671,10.289031882427063 62.19661345502522,10.296000218982579 62.1518831416357,10.200396086348922 62.148595774055686)))"
22550006900000,14,5,9,31.7,"MULTIPOLYGON(((10.296000218982579 62.1518831416357,10.289031882427063 62.19661345502522,10.384799833484958 62.19984098704286,10.391627750453125 62.15510460293647,10.296000218982579 62.1518831416357)))"
22600006900000,22,14,8,36.4,"MULTIPOLYGON(((10.391627750453125 62.15510460293647,10.384799833484958 62.19984098704286,10.480590827277107 62.20300245902821,10.48727821470879 62.15826012720359,10.391627750453125 62.15510460293647)))"
22650006900000,42,20,22,41.2,"MULTIPOLYGON(((10.48727821470879 62.15826012720359,10.480590827277107 62.20300245902821,10.57640439484816 62.206097840708665,10.582951144996166 62.16134968429891,10.48727821470879 62.15826012720359)))"
22700006900000,162,79,83,47.6,"MULTIPOLYGON(((10.582951144996166 62.16134968429891,10.57640439484816 62.206097840708665,10.672240066549412 62.20912710243152,10.67864607387402 62.164373244701395,10.582951144996166 62.16134968429891)))"
22800006900000,9,4,5,53.6,"MULTIPOLYGON(((10.774362533227078 62.16733077950835,10.768097372052727 62.21209021516513,10.863975840364521 62.214987150499866,10.870100054279924 62.170222260436525,10.774362533227078 62.16733077950835)))"
22900006900000,76,40,36,47.5,"MULTIPOLYGON(((10.965858167610904 62.173047659823055,10.959874999839798 62.21781788064938,11.055794378196225 62.220582378451375,11.061636403166116 62.175806950626516,10.965858167610904 62.173047659823055)))"
23100006900000,26,18,8,45.6,"MULTIPOLYGON(((11.349087133449084 62.18368791046703,11.343669094466286 62.22847821553353,11.439664613273036 62.2309775248414,11.444941145208846 62.186182508987656,11.349087133449084 62.18368791046703)))"
23150006900000,29,17,12,64.6,"MULTIPOLYGON(((11.444941145208846 62.186182508987656,11.439664613273036 62.2309775248414,11.535677980485604 62.23341047538771,11.540812919931893 62.188610873074126,11.444941145208846 62.186182508987656)))"
23300006900000,15,8,7,47.5,"MULTIPOLYGON(((11.732607863529271 62.19326880540256,11.727756356359121 62.238077207239066,11.82382041180639 62.24031094364364,11.828530083715778 62.195498328944296,11.732607863529271 62.19326880540256)))"
23350006900000,4,2,2,0,"MULTIPOLYGON(((11.828530083715778 62.195498328944296,11.82382041180639 62.24031094364364,11.919900409261038 62.2424782314873,11.924468169518633 62.19766152865304,11.828530083715778 62.195498328944296)))"
23400006900000,3,2,1,0,"MULTIPOLYGON(((11.924468169518633 62.19766152865304,11.919900409261038 62.2424782314873,12.015995870852237 62.24457904990125,12.020421645340036 62.199758383753206,11.924468169518633 62.19766152865304)))"
19750006905000,240,122,118,44.3,"MULTIPOLYGON(((4.976884623458041 61.91164892480605,4.962244944528684 61.955846014204354,5.056132819867662 61.962718779749935,5.070641126530088 61.91850898873381,4.976884623458041 61.91164892480605)))"
19800006905000,3002,1525,1477,41.9,"MULTIPOLYGON(((5.070641126530088 61.91850898873381,5.056132819867662 61.962718779749935,5.150068714579151 61.9695280148686,5.164445426162174 61.92530563401536,5.070641126530088 61.91850898873381)))"
19850006905000,281,130,151,41.1,"MULTIPOLYGON(((5.164445426162174 61.92530563401536,5.150068714579151 61.9695280148686,5.244052216995084 61.97627365668272,5.258297112438597 61.93203879804224,5.164445426162174 61.92530563401536)))"
19900006905000,118,66,52,48.6,"MULTIPOLYGON(((5.258297112438597 61.93203879804224,5.244052216995084 61.97627365668272,5.33808291407391 61.9829556428436,5.352195774080624 61.93870841873292,5.258297112438597 61.93203879804224)))"
19950006905000,30,13,17,49.6,"MULTIPOLYGON(((5.352195774080624 61.93870841873292,5.33808291407391 61.9829556428436,5.432160391410322 61.98957391153362,5.446140998456189 61.94531443453484,5.352195774080624 61.93870841873292)))"
20000006905000,44,25,19,59.2,"MULTIPOLYGON(((5.446140998456189 61.94531443453484,5.432160391410322 61.98957391153362,5.526284233245104 61.996128401468305,5.540132371589629 61.95185678442661,5.446140998456189 61.94531443453484)))"
20050006905000,15,9,6,58.3,"MULTIPOLYGON(((5.540132371589629 61.95185678442661,5.526284233245104 61.996128401468305,5.62045402247504 62.002619051898506,5.634169478171557 61.95833540792009,5.540132371589629 61.95185678442661)))"
20100006905000,27,16,11,39.2,"MULTIPOLYGON(((5.634169478171557 61.95833540792009,5.62045402247504 62.002619051898506,5.71466934066292 62.00904580261254,5.728251901568804 61.96475024506249,5.634169478171557 61.95833540792009)))"
20200006905000,62,31,31,55.7,"MULTIPOLYGON(((5.82237922383448 61.97110123643841,5.808929768047693 62.015408593938176,5.903234883554613 62.02170736674483,5.916551025718091 61.977388323171965,5.82237922383448 61.97110123643841)))"
20300006905000,119,58,61,46,"MULTIPOLYGON(((6.010766886675773 61.98361144692881,5.997584264805582 62.02794206244553,6.091977488129521 62.03411262299903,6.105026384880625 61.98977054991813,6.010766886675773 61.98361144692881)))"
20450006905000,2,2,0,0,"MULTIPOLYGON(((6.293674599371466 62.001896465160804,6.280893759910021 62.046261109240014,6.375415954654289 62.05223892159169,6.388062465682533 62.007863164568434,6.293674599371466 62.001896465160804)))"
20500006905000,67,33,34,46.2,"MULTIPOLYGON(((6.388062465682533 62.007863164568434,6.375415954654289 62.05223892159169,6.469980284068344 62.05815237212845,6.482492269312166 62.013765617520974,6.388062465682533 62.007863164568434)))"
20650006905000,5,3,2,17.8,"MULTIPOLYGON(((6.671475974971002 62.0253775644439,6.659233625769185 62.06978596718442,6.753921774426809 62.07550600281317,6.766029017184952 62.03108694999623,6.671475974971002 62.0253775644439)))"
20700006905000,79,40,39,45.2,"MULTIPOLYGON(((6.766029017184952 62.03108694999623,6.753921774426809 62.07550600281317,6.848650330518015 62.08116145885007,6.860622277108932 62.03673187226124,6.766029017184952 62.03108694999623)))"
20750006905000,80,41,39,43.6,"MULTIPOLYGON(((6.860622277108932 62.03673187226124,6.848650330518015 62.08116145885007,6.943418859217314 62.08675228225451,6.955255321847705 62.04231227842894,6.860622277108932 62.03673187226124)))"
20900006905000,229,105,124,41.8,"MULTIPOLYGON(((7.144639028325174 62.053279334049165,7.1330740892288 62.09773982183204,7.227959915014792 62.10313643475781,7.239388818443793 62.05866588070401,7.144639028325174 62.053279334049165)))"
20950006905000,15,7,8,39.5,"MULTIPOLYGON(((7.239388818443793 62.05866588070401,7.227959915014792 62.10313643475781,7.322883962379455 62.10846820856013,7.334176650159879 62.06398770566975,7.239388818443793 62.05866588070401)))"
21650006905000,38,21,17,37.7,"MULTIPOLYGON(((8.569679169038707 62.12725980316368,8.560172752467555 62.17185885799796,8.655585139374088 62.176277877242526,8.664953031847922 62.13167053956217,8.569679169038707 62.12725980316368)))"
21700006905000,135,78,57,44.6,"MULTIPOLYGON(((8.664953031847922 62.13167053956217,8.655585139374088 62.176277877242526,8.751029025572512 62.18063136552292,8.760258244480038 62.13601586546346,8.664953031847922 62.13167053956217)))"
22100006905000,2,1,1,0,"MULTIPOLYGON(((9.428234262601306 62.16459826578251,9.419979766658933 62.209267514416936,9.515659144537246 62.21309531503027,9.523773847290087 62.16841887410588,9.428234262601306 62.16459826578251)))"
22200006905000,13,4,9,43.8,"MULTIPOLYGON(((9.619340661838626 62.17217372255548,9.611365882606018 62.21685723375314,9.707099516606984 62.22055323462725,9.714934244149593 62.17586277533234,9.619340661838626 62.17217372255548)))"
22250006905000,90,48,42,50.5,"MULTIPOLYGON(((9.714934244149593 62.17586277533234,9.707099516606984 62.22055323462725,9.802859581459137 62.22418328230606,9.810554131309434 62.17948599724648,9.714934244149593 62.17586277533234)))"
22300006905000,15,10,5,49,"MULTIPOLYGON(((9.810554131309434 62.17948599724648,9.802859581459137 62.22418328230606,9.898645611272247 62.22774734205604,9.90619985960178 62.18304335371835,9.810554131309434 62.17948599724648)))"
22550006905000,18,10,8,48.7,"MULTIPOLYGON(((10.289031882427063 62.19661345502522,10.282040034769013 62.241343028623184,10.377948873664668 62.24457664926962,10.384799833484958 62.19984098704286,10.289031882427063 62.19661345502522)))"
22600006905000,8,4,4,69,"MULTIPOLYGON(((10.384799833484958 62.19984098704286,10.377948873664668 62.24457664926962,10.473880865950962 62.24774408652932,10.480590827277107 62.20300245902821,10.384799833484958 62.19984098704286)))"
22700006905000,149,77,72,39.6,"MULTIPOLYGON(((10.57640439484816 62.206097840708665,10.569835540456717 62.25084530999447,10.665812425311831 62.253880289879845,10.672240066549412 62.20912710243152,10.57640439484816 62.206097840708665)))"
22750006905000,38,21,17,48.1,"MULTIPOLYGON(((10.672240066549412 62.20912710243152,10.665812425311831 62.253880289879845,10.761811047961325 62.25684899702396,10.768097372052727 62.21209021516513,10.672240066549412 62.20912710243152)))"
22850006905000,1,0,1,0,"MULTIPOLYGON(((10.863975840364521 62.214987150499866,10.857830935179415 62.2597514028902,10.95387161308367 62.262587479567806,10.959874999839798 62.21781788064938,10.863975840364521 62.214987150499866)))"
22900006905000,3,2,1,0,"MULTIPOLYGON(((10.959874999839798 62.21781788064938,10.95387161308367 62.262587479567806,11.049932607149204 62.26535719977292,11.055794378196225 62.220582378451375,10.959874999839798 62.21781788064938)))"
23100006905000,19,11,8,47.9,"MULTIPOLYGON(((11.343669094466286 62.22847821553353,11.338232731727244 62.273267958140124,11.43437023283944 62.27577199219057,11.439664613273036 62.2309775248414,11.343669094466286 62.22847821553353)))"
23150006905000,1,1,0,0,"MULTIPOLYGON(((11.439664613273036 62.2309775248414,11.43437023283944 62.27577199219057,11.530525668351832 62.27820954278796,11.535677980485604 62.23341047538771,11.439664613273036 62.2309775248414)))"
23250006905000,1,0,1,0,"MULTIPOLYGON(((11.631708720296078 62.23577704377562,11.62669856018556 62.28058058643055,11.722888429719994 62.28288510025012,11.727756356359121 62.238077207239066,11.631708720296078 62.23577704377562)))"
23300006905000,34,19,15,50.7,"MULTIPOLYGON(((11.727756356359121 62.238077207239066,11.722888429719994 62.28288510025012,11.81909479780729 62.285123062012865,11.82382041180639 62.24031094364364,11.727756356359121 62.238077207239066)))"
19750006910000,28,14,14,44.5,"MULTIPOLYGON(((4.962244944528684 61.955846014204354,4.947556835709747 62.000040816502775,5.041576493602193 62.00692631987409,5.056132819867662 61.962718779749935,4.962244944528684 61.955846014204354)))"
19800006910000,748,394,354,45.5,"MULTIPOLYGON(((5.056132819867662 61.962718779749935,5.041576493602193 62.00692631987409,5.135644395062768 62.01374818075064,5.150068714579151 61.9695280148686,5.056132819867662 61.962718779749935)))"
19850006910000,376,191,185,43.2,"MULTIPOLYGON(((5.150068714579151 61.9695280148686,5.135644395062768 62.01374818075064,5.229760126661387 62.02050633598408,5.244052216995084 61.97627365668272,5.150068714579151 61.9695280148686)))"
19900006910000,87,42,45,48.8,"MULTIPOLYGON(((5.244052216995084 61.97627365668272,5.229760126661387 62.02050633598408,5.323923273583941 62.027200722956955,5.33808291407391 61.9829556428436,5.244052216995084 61.97627365668272)))"
19950006910000,166,76,90,50.1,"MULTIPOLYGON(((5.33808291407391 61.9829556428436,5.323923273583941 62.027200722956955,5.418133419642081 62.03383127958496,5.432160391410322 61.98957391153362,5.33808291407391 61.9829556428436)))"
20000006910000,107,56,51,51.4,"MULTIPOLYGON(((5.432160391410322 61.98957391153362,5.418133419642081 62.03383127958496,5.512390147283092 62.040397944319025,5.526284233245104 61.996128401468305,5.432160391410322 61.98957391153362)))"
20050006910000,356,187,169,46,"MULTIPOLYGON(((5.526284233245104 61.996128401468305,5.512390147283092 62.040397944319025,5.606693037599915 62.04690065614745,5.62045402247504 62.002619051898506,5.526284233245104 61.996128401468305)))"
20100006910000,46,23,23,52,"MULTIPOLYGON(((5.62045402247504 62.002619051898506,5.606693037599915 62.04690065614745,5.701041670341203 62.0533393545981,5.71466934066292 62.00904580261254,5.62045402247504 62.002619051898506)))"
20200006910000,9,2,7,48.3,"MULTIPOLYGON(((5.808929768047693 62.015408593938176,5.795435623921516 62.05971397974033,5.889874475431586 62.06602447218737,5.903234883554613 62.02170736674483,5.808929768047693 62.015408593938176)))"
20250006910000,65,34,31,53.2,"MULTIPOLYGON(((5.903234883554613 62.02170736674483,5.889874475431586 62.06602447218737,5.98435780064867 62.07227077309814,5.997584264805582 62.02794206244553,5.903234883554613 62.02170736674483)))"
20300006910000,94,50,44,49.4,"MULTIPOLYGON(((5.997584264805582 62.02794206244553,5.98435780064867 62.07227077309814,6.078885174047041 62.0784528241794,6.091977488129521 62.03411262299903,5.997584264805582 62.02794206244553)))"
20350006910000,15,11,4,52.4,"MULTIPOLYGON(((6.091977488129521 62.03411262299903,6.078885174047041 62.0784528241794,6.173456168808502 62.08457056768786,6.186414128572833 62.04021899091179,6.091977488129521 62.03411262299903)))"
20400006910000,76,43,33,50.5,"MULTIPOLYGON(((6.186414128572833 62.04021899091179,6.173456168808502 62.08457056768786,6.268070356833058 62.090623946432125,6.280893759910021 62.046261109240014,6.186414128572833 62.04021899091179)))"
20450006910000,149,80,69,46.9,"MULTIPOLYGON(((6.280893759910021 62.046261109240014,6.268070356833058 62.090623946432125,6.362727308749632 62.09661290377472,6.375415954654289 62.05223892159169,6.280893759910021 62.046261109240014)))"
20500006910000,26,11,15,46.7,"MULTIPOLYGON(((6.375415954654289 62.05223892159169,6.362727308749632 62.09661290377472,6.457426593926908 62.1025373836341,6.469980284068344 62.05815237212845,6.375415954654289 62.05223892159169)))"
20550006910000,62,30,32,37.9,"MULTIPOLYGON(((6.469980284068344 62.05815237212845,6.457426593926908 62.1025373836341,6.552167780484227 62.10839733048665,6.564586318175214 62.06400140556771,6.469980284068344 62.05815237212845)))"
20600006910000,12,3,9,64.6,"MULTIPOLYGON(((6.564586318175214 62.06400140556771,6.552167780484227 62.10839733048665,6.646950435302607 62.114192689368664,6.659233625769185 62.06978596718442,6.564586318175214 62.06400140556771)))"
20650006910000,8,2,6,42.4,"MULTIPOLYGON(((6.659233625769185 62.06978596718442,6.646950435302607 62.114192689368664,6.741774124035836 62.11992340587818,6.753921774426809 62.07550600281317,6.659233625769185 62.06978596718442)))"
20700006910000,27,16,11,41.9,"MULTIPOLYGON(((6.753921774426809 62.07550600281317,6.741774124035836 62.11992340587818,6.83663841112165 62.125589426177044,6.848650330518015 62.08116145885007,6.753921774426809 62.07550600281317)))"
20750006910000,248,131,117,47.1,"MULTIPOLYGON(((6.848650330518015 62.08116145885007,6.83663841112165 62.125589426177044,6.931542859793007 62.131190696992775,6.943418859217314 62.08675228225451,6.848650330518015 62.08116145885007)))"
20900006910000,21,9,12,42.1,"MULTIPOLYGON(((7.1330740892288 62.09773982183204,7.12147048886854 62.142198779924456,7.216492789817418 62.14760548834067,7.227959915014792 62.10313643475781,7.1330740892288 62.09773982183204)))"
21600006910000,122,60,62,45.9,"MULTIPOLYGON(((8.464792320154247 62.167374349788474,8.455115121954265 62.211963851192145,8.550634381141982 62.21645678713848,8.560172752467555 62.17185885799796,8.464792320154247 62.167374349788474)))"
21650006910000,48,22,26,34.9,"MULTIPOLYGON(((8.560172752467555 62.17185885799796,8.550634381141982 62.21645678713848,8.646185747449294 62.22088411349946,8.655585139374088 62.176277877242526,8.560172752467555 62.17185885799796)))"
22150006910000,14,5,9,49.1,"MULTIPOLYGON(((9.515659144537246 62.21309531503027,9.507517081454578 62.25777085755188,9.603364207304086 62.26153986737385,9.611365882606018 62.21685723375314,9.515659144537246 62.21309531503027)))"
22600006910000,5,4,1,34.6,"MULTIPOLYGON(((10.377948873664668 62.24457664926962,10.371074760334917 62.289311587842434,10.467148222288865 62.29248500801764,10.473880865950962 62.24774408652932,10.377948873664668 62.24457664926962)))"
22700006910000,208,96,112,43.2,"MULTIPOLYGON(((10.569835540456717 62.25084530999447,10.563244475601762 62.29559209055037,10.659363046168075 62.29863280552201,10.665812425311831 62.253880289879845,10.569835540456717 62.25084530999447)))"
22750006910000,847,434,413,40.3,"MULTIPOLYGON(((10.665812425311831 62.253880289879845,10.659363046168075 62.29863280552201,10.755503459191882 62.30160712364052,10.761811047961325 62.25684899702396,10.665812425311831 62.253880289879845)))"
22800006910000,3050,1491,1559,42.7,"MULTIPOLYGON(((10.761811047961325 62.25684899702396,10.755503459191882 62.30160712364052,10.851665239201063 62.304515016241396,10.857830935179415 62.2597514028902,10.761811047961325 62.25684899702396)))"
23100006910000,4,1,3,0,"MULTIPOLYGON(((11.338232731727244 62.273267958140124,11.332777956970308 62.31805713728614,11.429057917912932 62.32056591010234,11.43437023283944 62.27577199219057,11.338232731727244 62.273267958140124)))"
23250006910000,19,6,13,46.9,"MULTIPOLYGON(((11.62669856018556 62.28058058643055,11.621671422286461 62.32538360659649,11.718004004442566 62.327692483696055,11.722888429719994 62.28288510025012,11.62669856018556 62.28058058643055)))"
23300006910000,41,23,18,53.2,"MULTIPOLYGON(((11.722888429719994 62.28288510025012,11.718004004442566 62.327692483696055,11.814353164832786 62.32993468337316,11.81909479780729 62.285123062012865,11.722888429719994 62.28288510025012)))"
23400006910000,7,4,3,66.4,"MULTIPOLYGON(((11.915317184786993 62.287294450120186,11.91071842149842 62.33211018393205,12.007099291978754 62.3342189643159,12.011555110500671 62.28939924360958,11.915317184786993 62.287294450120186)))"
19750006915000,9,5,4,68.3,"MULTIPOLYGON(((4.947556835709747 62.000040816502775,4.932820071052456 62.04423332250129,5.026971923536308 62.05113160007406,5.041576493602193 62.00692631987409,4.947556835709747 62.000040816502775)))"
19800006915000,110,66,44,45.5,"MULTIPOLYGON(((5.041576493602193 62.00692631987409,5.026971923536308 62.05113160007406,5.121172245177659 62.05796612279593,5.135644395062768 62.01374818075064,5.041576493602193 62.00692631987409)))"
19900006915000,8,4,4,48.4,"MULTIPOLYGON(((5.229760126661387 62.02050633598408,5.215420620774712 62.06473682724625,5.309716633731003 62.071443650537255,5.323923273583941 62.027200722956955,5.229760126661387 62.02050633598408)))"
19950006915000,849,435,414,42.4,"MULTIPOLYGON(((5.323923273583941 62.027200722956955,5.309716633731003 62.071443650537255,5.404059866065232 62.078086530316334,5.418133419642081 62.03383127958496,5.323923273583941 62.027200722956955)))"
20000006915000,107,56,51,45.5,"MULTIPOLYGON(((5.418133419642081 62.03383127958496,5.404059866065232 62.078086530316334,5.498449898421217 62.08466540476823,5.512390147283092 62.040397944319025,5.418133419642081 62.03383127958496)))"
20050006915000,303,164,139,46.6,"MULTIPOLYGON(((5.512390147283092 62.040397944319025,5.498449898421217 62.08466540476823,5.592886310077972 62.091180212617104,5.606693037599915 62.04690065614745,5.512390147283092 62.040397944319025)))"
20100006915000,149,74,75,45.5,"MULTIPOLYGON(((5.606693037599915 62.04690065614745,5.592886310077972 62.091180212617104,5.687368678959819 62.09763089312882,5.701041670341203 62.0533393545981,5.606693037599915 62.04690065614745)))"
20150006915000,461,236,225,49.9,"MULTIPOLYGON(((5.701041670341203 62.0533393545981,5.687368678959819 62.09763089312882,5.781896581646673 62.10401738611287,5.795435623921516 62.05971397974033,5.701041670341203 62.0533393545981)))"
20200006915000,38,19,19,52.9,"MULTIPOLYGON(((5.795435623921516 62.05971397974033,5.781896581646673 62.10401738611287,5.876469593384363 62.110339631924646,5.889874475431586 62.06602447218737,5.795435623921516 62.05971397974033)))"
20250006915000,98,47,51,45.5,"MULTIPOLYGON(((5.889874475431586 62.06602447218737,5.876469593384363 62.110339631924646,5.971087288095065 62.11659757146748,5.98435780064867 62.07227077309814,5.889874475431586 62.06602447218737)))"
20300006915000,174,88,86,51.9,"MULTIPOLYGON(((5.98435780064867 62.07227077309814,5.971087288095065 62.11659757146748,6.065749238387831 62.122791146194665,6.078885174047041 62.0784528241794,5.98435780064867 62.07227077309814)))"
20350006915000,112,58,54,45.3,"MULTIPOLYGON(((6.078885174047041 62.0784528241794,6.065749238387831 62.122791146194665,6.160455015569226 62.12892029811158,6.173456168808502 62.08457056768786,6.078885174047041 62.0784528241794)))"
20400006915000,42,22,20,53.9,"MULTIPOLYGON(((6.173456168808502 62.08457056768786,6.160455015569226 62.12892029811158,6.255204189654036 62.13498496977777,6.268070356833058 62.090623946432125,6.173456168808502 62.08457056768786)))"
20450006915000,34,16,18,31.4,"MULTIPOLYGON(((6.268070356833058 62.090623946432125,6.255204189654036 62.13498496977777,6.349996329376057 62.14098510430887,6.362727308749632 62.09661290377472,6.268070356833058 62.090623946432125)))"
20550006915000,3,2,1,0,"MULTIPOLYGON(((6.457426593926908 62.1025373836341,6.444831002199038 62.146920645378636,6.539707774327636 62.152791537221034,6.552167780484227 62.10839733048665,6.457426593926908 62.1025373836341)))"
20600006915000,36,18,18,51.2,"MULTIPOLYGON(((6.552167780484227 62.10839733048665,6.539707774327636 62.152791537221034,6.634626210718506 62.15859772463214,6.646950435302607 62.114192689368664,6.552167780484227 62.10839733048665)))"
20900006915000,24,15,9,31.6,"MULTIPOLYGON(((7.12147048886854 62.142198779924456,7.109828044145366 62.18665620267512,7.204987261730772 62.19207303593985,7.216492789817418 62.14760548834067,7.12147048886854 62.142198779924456)))"
21050006915000,2,0,2,0,"MULTIPOLYGON(((7.406652157190561 62.15822398412046,7.39542100717776 62.20271142696139,7.490694644659694 62.207932884021794,7.501788337241844 62.16343567122857,7.406652157190561 62.15822398412046)))"
21400006915000,4,2,2,0,"MULTIPOLYGON(((8.073368270098037 62.193336876175806,8.063102952016445 62.23789020780848,8.158627876669948 62.24265408267776,8.168754546452572 62.19809181666293,8.073368270098037 62.193336876175806)))"
21450006915000,38,15,23,44.6,"MULTIPOLYGON(((8.168754546452572 62.19809181666293,8.158627876669948 62.24265408267776,8.254186890070454 62.247352402486634,8.264174749667907 62.202781322275776,8.168754546452572 62.19809181666293)))"
21500006915000,60,31,29,49.7,"MULTIPOLYGON(((8.264174749667907 62.202781322275776,8.254186890070454 62.247352402486634,8.349779536705263 62.251985122467644,8.359628426315625 62.2074053484443,8.264174749667907 62.202781322275776)))"
21550006915000,198,107,91,44.6,"MULTIPOLYGON(((8.359628426315625 62.2074053484443,8.349779536705263 62.251985122467644,8.445405360040592 62.256552198449704,8.455115121954265 62.211963851192145,8.359628426315625 62.2074053484443)))"
21600006915000,13,7,6,47.8,"MULTIPOLYGON(((8.455115121954265 62.211963851192145,8.445405360040592 62.256552198449704,8.541063902534336 62.261053586859624,8.550634381141982 62.21645678713848,8.455115121954265 62.211963851192145)))"
22650006915000,37,21,16,46.3,"MULTIPOLYGON(((10.467148222288865 62.29248500801764,10.460392787150388 62.337225221791655,10.55663109337832 62.340338180758685,10.563244475601762 62.29559209055037,10.467148222288865 62.29248500801764)))"
22700006915000,35,19,16,48.5,"MULTIPOLYGON(((10.563244475601762 62.29559209055037,10.55663109337832 62.340338180758685,10.652891824454128 62.34338464782255,10.659363046168075 62.29863280552201,10.563244475601762 62.29559209055037)))"
22750006915000,94,50,44,38.1,"MULTIPOLYGON(((10.659363046168075 62.29863280552201,10.652891824454128 62.34338464782255,10.749174503326744 62.34636459355975,10.755503459191882 62.30160712364052,10.659363046168075 62.29863280552201)))"
22800006915000,23,15,8,41.3,"MULTIPOLYGON(((10.755503459191882 62.30160712364052,10.749174503326744 62.34636459355975,10.845478652263454 62.34927798917714,10.851665239201063 62.304515016241396,10.755503459191882 62.30160712364052)))"
22850006915000,189,94,95,38.8,"MULTIPOLYGON(((10.851665239201063 62.304515016241396,10.845478652263454 62.34927798917714,10.941803792864267 62.35212480651293,10.947847910061558 62.307356455288755,10.851665239201063 62.304515016241396)))"
23000006915000,6,4,2,66.3,"MULTIPOLYGON(((11.140274016576475 62.31283986372893,11.13451513220845 62.357618596856135,11.230900370945491 62.36026551670644,11.2365164967821 62.31548178020253,11.140274016576475 62.31283986372893)))"
23150006915000,26,13,13,46.5,"MULTIPOLYGON(((11.429057917912932 62.32056591010234,11.423727581942085 62.36535927763649,11.520168590583447 62.367806069374886,11.525355899806422 62.32300807440824,11.429057917912932 62.32056591010234)))"
23200006915000,15,7,8,59.6,"MULTIPOLYGON(((11.525355899806422 62.32300807440824,11.520168590583447 62.367806069374886,11.616627224622714 62.370186103464576,11.621671422286461 62.32538360659649,11.525355899806422 62.32300807440824)))"
23250006915000,1,1,0,0,"MULTIPOLYGON(((11.621671422286461 62.32538360659649,11.616627224622714 62.370186103464576,11.713103000844894 62.37249935683107,11.718004004442566 62.327692483696055,11.621671422286461 62.32538360659649)))"
19850006920000,3,2,1,0,"MULTIPOLYGON(((5.121172245177659 62.05796612279593,5.106652041104384 62.10218183208205,5.20103347729799 62.10896512171333,5.215420620774712 62.06473682724625,5.121172245177659 62.05796612279593)))"
19900006920000,29,13,16,47.3,"MULTIPOLYGON(((5.215420620774712 62.06473682724625,5.20103347729799 62.10896512171333,5.295462774270982 62.1156844169939,5.309716633731003 62.071443650537255,5.215420620774712 62.06473682724625)))"
19950006920000,334,175,159,45.1,"MULTIPOLYGON(((5.309716633731003 62.071443650537255,5.295462774270982 62.1156844169939,5.389939512239154 62.12233965530124,5.404059866065232 62.078086530316334,5.309716633731003 62.071443650537255)))"
20000006920000,87,44,43,48,"MULTIPOLYGON(((5.404059866065232 62.078086530316334,5.389939512239154 62.12233965530124,5.484463270032801 62.12893077455235,5.498449898421217 62.08466540476823,5.404059866065232 62.078086530316334)))"
20050006920000,620,320,300,42.9,"MULTIPOLYGON(((5.498449898421217 62.08466540476823,5.484463270032801 62.12893077455235,5.579033625106859 62.13545771320565,5.592886310077972 62.091180212617104,5.498449898421217 62.08466540476823)))"
20100006920000,225,118,107,47.5,"MULTIPOLYGON(((5.592886310077972 62.091180212617104,5.579033625106859 62.13545771320565,5.673650153551077 62.14192041026344,5.687368678959819 62.09763089312882,5.592886310077972 62.091180212617104)))"
20150006920000,99,57,42,56.6,"MULTIPOLYGON(((5.687368678959819 62.09763089312882,5.673650153551077 62.14192041026344,5.768312430100386 62.14831880527375,5.781896581646673 62.10401738611287,5.687368678959819 62.09763089312882)))"
20250006920000,209,101,108,46.8,"MULTIPOLYGON(((5.876469593384363 62.110339631924646,5.86302002814528 62.15465283833265,5.957772519742302 62.16092245008628,5.971087288095065 62.11659757146748,5.876469593384363 62.110339631924646)))"
20300006920000,571,268,303,40.1,"MULTIPOLYGON(((5.971087288095065 62.11659757146748,5.957772519742302 62.16092245008628,6.052569475624694 62.167127581733006,6.065749238387831 62.122791146194665,5.971087288095065 62.11659757146748)))"
20350006920000,6925,3379,3546,38.5,"MULTIPOLYGON(((6.065749238387831 62.122791146194665,6.052569475624694 62.167127581733006,6.147410465213041 62.173268175025385,6.160455015569226 62.12892029811158,6.065749238387831 62.122791146194665)))"
20400006920000,379,196,183,41.8,"MULTIPOLYGON(((6.160455015569226 62.12892029811158,6.147410465213041 62.173268175025385,6.242295056626108 62.17934417227233,6.255204189654036 62.13498496977777,6.160455015569226 62.12892029811158)))"
20450006920000,206,113,93,39.4,"MULTIPOLYGON(((6.255204189654036 62.13498496977777,6.242295056626108 62.17934417227233,6.337222816691678 62.18535551634108,6.349996329376057 62.14098510430887,6.255204189654036 62.13498496977777)))"
20500006920000,151,83,68,42.9,"MULTIPOLYGON(((6.349996329376057 62.14098510430887,6.337222816691678 62.18535551634108,6.432193310957556 62.19130215065932,6.444831002199038 62.146920645378636,6.349996329376057 62.14098510430887)))"
20600006920000,2,1,1,0,"MULTIPOLYGON(((6.539707774327636 62.152791537221034,6.527206103702635 62.19718401921705,6.622260757948033 62.203001066568724,6.634626210718506 62.15859772463214,6.539707774327636 62.152791537221034)))"
20650006920000,51,28,23,45.5,"MULTIPOLYGON(((6.634626210718506 62.15859772463214,6.622260757948033 62.203001066568724,6.71735683546838 62.208753237835104,6.729585875091482 62.164339152972104,6.634626210718506 62.15859772463214)))"
20800006920000,18,9,9,52.1,"MULTIPOLYGON(((6.919627136546618 62.17562751671134,6.907671501267966 62.22006273543876,7.002889206966426 62.22561995486697,7.014707854986115 62.18117434566872,6.919627136546618 62.17562751671134)))"
20900006920000,74,43,31,47.6,"MULTIPOLYGON(((7.109828044145366 62.18665620267512,7.098146570801379 62.23111208439559,7.193443148486815 62.23653907200628,7.204987261730772 62.19207303593985,7.109828044145366 62.18665620267512)))"
20950006920000,18,7,11,44.7,"MULTIPOLYGON(((7.204987261730772 62.19207303593985,7.193443148486815 62.23653907200628,7.288778494559575 62.24190086625851,7.300185064280798 62.19742479424788,7.204987261730772 62.19207303593985)))"
21050006920000,82,44,38,51.9,"MULTIPOLYGON(((7.39542100717776 62.20271142696139,7.384152162391256 62.24719741629151,7.479563704200142 62.252428671825975,7.490694644659694 62.207932884021794,7.39542100717776 62.20271142696139)))"
21400006920000,6,3,3,59,"MULTIPOLYGON(((8.063102952016445 62.23789020780848,8.052803090534512 62.28244227865228,8.148467117968025 62.287215114103404,8.158627876669948 62.24265408267776,8.063102952016445 62.23789020780848)))"
21450006920000,92,46,46,44.3,"MULTIPOLYGON(((8.158627876669948 62.24265408267776,8.148467117968025 62.287215114103404,8.244165397068514 62.29192227397118,8.254186890070454 62.247352402486634,8.158627876669948 62.24265408267776)))"
22200006920000,1,0,1,0,"MULTIPOLYGON(((9.595335506939211 62.30622162088572,9.587279651688426 62.35090249173924,9.683436239996544 62.35461946015579,9.69135064175095 62.309931579480484,9.595335506939211 62.30622162088572)))"
22650006920000,7,3,4,59,"MULTIPOLYGON(((10.460392787150388 62.337225221791655,10.453614450690548 62.38196472613746,10.549995286191006 62.38508357898995,10.55663109337832 62.340338180758685,10.460392787150388 62.337225221791655)))"
22700006920000,48,24,24,46.2,"MULTIPOLYGON(((10.55663109337832 62.340338180758685,10.549995286191006 62.38508357898995,10.646398654829763 62.388135815234676,10.652891824454128 62.34338464782255,10.55663109337832 62.340338180758685)))"
22750006920000,27,16,11,42.4,"MULTIPOLYGON(((10.652891824454128 62.34338464782255,10.646398654829763 62.388135815234676,10.742824077286297 62.39112140531586,10.749174503326744 62.34636459355975,10.652891824454128 62.34338464782255)))"
22850006920000,54,30,24,38.5,"MULTIPOLYGON(((10.845478652263454 62.34927798917714,10.839271073552927 62.39404032031089,10.935739162949318 62.396892531931336,10.941803792864267 62.35212480651293,10.845478652263454 62.34927798917714)))"
22900006920000,59,32,27,39.1,"MULTIPOLYGON(((10.941803792864267 62.35212480651293,10.935739162949318 62.396892531931336,11.032227864136994 62.39967801252401,11.038149446076343 62.35490501803785,10.941803792864267 62.35212480651293)))"
23000006920000,53,28,25,49.7,"MULTIPOLYGON(((11.13451513220845 62.357618596856135,11.128736695133947 62.402396735072045,11.225265173329234 62.40504867319591,11.230900370945491 62.36026551670644,11.13451513220845 62.357618596856135)))"
23350006920000,1,1,0,0,"MULTIPOLYGON(((11.809595435499206 62.374745807039986,11.804821531920863 62.41955643232301,11.901473977664967 62.42174019458703,11.906104044313942 62.37692543229782,11.809595435499206 62.374745807039986)))"
19850006925000,18,10,8,56.3,"MULTIPOLYGON(((5.106652041104384 62.10218183208205,5.0920835576288 62.146395299629134,5.186598472809296 62.15319121057301,5.20103347729799 62.10896512171333,5.106652041104384 62.10218183208205)))"
19900006925000,13,8,5,42.8,"MULTIPOLYGON(((5.20103347729799 62.10896512171333,5.186598472809296 62.15319121057301,5.281161473584865 62.15992301368089,5.295462774270982 62.1156844169939,5.20103347729799 62.10896512171333)))"
19950006925000,396,194,202,41.6,"MULTIPOLYGON(((5.295462774270982 62.1156844169939,5.281161473584865 62.15992301368089,5.375772138358367 62.16659064605887,5.389939512239154 62.12233965530124,5.295462774270982 62.1156844169939)))"
20000006925000,107,58,49,50.9,"MULTIPOLYGON(((5.389939512239154 62.12233965530124,5.375772138358367 62.16659064605887,5.470430044136458 62.173194045354464,5.484463270032801 62.12893077455235,5.389939512239154 62.12233965530124)))"
20050006925000,33,21,12,52.1,"MULTIPOLYGON(((5.484463270032801 62.12893077455235,5.470430044136458 62.173194045354464,5.565134766539769 62.179733149758896,5.579033625106859 62.13545771320565,5.484463270032801 62.12893077455235)))"
20100006925000,47,25,22,61.1,"MULTIPOLYGON(((5.579033625106859 62.13545771320565,5.565134766539769 62.179733149758896,5.659885879813176 62.18620789800922,5.673650153551077 62.14192041026344,5.579033625106859 62.13545771320565)))"
20150006925000,143,73,70,50,"MULTIPOLYGON(((5.673650153551077 62.14192041026344,5.659885879813176 62.18620789800922,5.754682956836207 62.192618229390476,5.768312430100386 62.14831880527375,5.673650153551077 62.14192041026344)))"
20200006925000,101,50,51,53.4,"MULTIPOLYGON(((5.768312430100386 62.14831880527375,5.754682956836207 62.192618229390476,5.849525569133504 62.19896408373787,5.86302002814528 62.15465283833265,5.768312430100386 62.14831880527375)))"
20250006925000,220,107,113,44.3,"MULTIPOLYGON(((5.86302002814528 62.15465283833265,5.849525569133504 62.19896408373787,5.944413286885406 62.20524540143882,5.957772519742302 62.16092245008628,5.86302002814528 62.15465283833265)))"
20300006925000,467,247,220,37.9,"MULTIPOLYGON(((5.957772519742302 62.16092245008628,5.944413286885406 62.20524540143882,6.039345678938616 62.21146212343514,6.052569475624694 62.167127581733006,5.957772519742302 62.16092245008628)))"
20350006925000,5387,2678,2709,41.7,"MULTIPOLYGON(((6.052569475624694 62.167127581733006,6.039345678938616 62.21146212343514,6.134322312816984 62.217614191225074,6.147410465213041 62.173268175025385,6.052569475624694 62.167127581733006)))"
20400006925000,2712,1383,1329,38.5,"MULTIPOLYGON(((6.147410465213041 62.173268175025385,6.134322312816984 62.217614191225074,6.229342754732348 62.22370154686546,6.242295056626108 62.17934417227233,6.147410465213041 62.173268175025385)))"
20450006925000,115,64,51,43.4,"MULTIPOLYGON(((6.242295056626108 62.17934417227233,6.229342754732348 62.22370154686546,6.324406569595499 62.22972413297362,6.337222816691678 62.18535551634108,6.242295056626108 62.17934417227233)))"
20500006925000,95,47,48,40.4,"MULTIPOLYGON(((6.337222816691678 62.18535551634108,6.324406569595499 62.22972413297362,6.419513321027253 62.235681892729595,6.432193310957556 62.19130215065932,6.337222816691678 62.18535551634108)))"
20550006925000,309,160,149,46.5,"MULTIPOLYGON(((6.432193310957556 62.19130215065932,6.419513321027253 62.235681892729595,6.514662571369556 62.24157476987803,6.527206103702635 62.19718401921705,6.432193310957556 62.19130215065932)))"
20600006925000,60,29,31,51.1,"MULTIPOLYGON(((6.527206103702635 62.19718401921705,6.514662571369556 62.24157476987803,6.609853881696758 62.24740270873024,6.622260757948033 62.203001066568724,6.527206103702635 62.19718401921705)))"
20750006925000,101,56,45,45.5,"MULTIPOLYGON(((6.812493896803118 62.21444047870532,6.800360920333256 62.25886355163652,6.895675764555609 62.26449634716436,6.907671501267966 62.22006273543876,6.812493896803118 62.21444047870532)))"
20800006925000,74,35,39,48.1,"MULTIPOLYGON(((6.907671501267966 62.22006273543876,6.895675764555609 62.26449634716436,6.991030900612082 62.27006398734744,7.002889206966426 62.22561995486697,6.907671501267966 62.22006273543876)))"
20850006925000,7,5,2,53.6,"MULTIPOLYGON(((7.002889206966426 62.22561995486697,6.991030900612082 62.27006398734744,7.08642588341073 62.27556641935988,7.098146570801379 62.23111208439559,7.002889206966426 62.22561995486697)))"
20900006925000,226,116,110,48.5,"MULTIPOLYGON(((7.098146570801379 62.23111208439559,7.08642588341073 62.27556641935988,7.181860266661322 62.28100359095417,7.193443148486815 62.23653907200628,7.098146570801379 62.23111208439559)))"
20950006925000,124,66,58,43.4,"MULTIPOLYGON(((7.193443148486815 62.23653907200628,7.181860266661322 62.28100359095417,7.277333602887225 62.28637545046301,7.288778494559575 62.24190086625851,7.193443148486815 62.23653907200628)))"
21400006925000,19,10,9,46.9,"MULTIPOLYGON(((8.052803090534512 62.28244227865228,8.042468520642135 62.32699308431843,8.138272107425472 62.33177490667662,8.148467117968025 62.287215114103404,8.052803090534512 62.28244227865228)))"
22600006925000,23,12,11,52.4,"MULTIPOLYGON(((10.357256626947354 62.37877928686493,10.350312381987269 62.42351204370166,10.446813102354122 62.4267035193288,10.453614450690548 62.38196472613746,10.357256626947354 62.37877928686493)))"
22650006925000,12,6,6,36.2,"MULTIPOLYGON(((10.453614450690548 62.38196472613746,10.446813102354122 62.4267035193288,10.54333694574846 62.42982828360287,10.549995286191006 62.38508357898995,10.453614450690548 62.38196472613746)))"
22800006925000,35,15,20,40.5,"MULTIPOLYGON(((10.742824077286297 62.39112140531586,10.736452077323644 62.43587755743225,10.833042401602956 62.43880200824581,10.839271073552927 62.39404032031089,10.742824077286297 62.39112140531586)))"
22850006925000,350,178,172,39.8,"MULTIPOLYGON(((10.839271073552927 62.39404032031089,10.833042401602956 62.43880200824581,10.929653921135822 62.4416596302251,10.935739162949318 62.396892531931336,10.839271073552927 62.39404032031089)))"
22900006925000,820,421,399,43.1,"MULTIPOLYGON(((10.935739162949318 62.396892531931336,10.929653921135822 62.4416596302251,11.026286152283559 62.44445039559228,11.032227864136994 62.39967801252401,10.935739162949318 62.396892531931336)))"
22950006925000,51,27,24,45,"MULTIPOLYGON(((11.032227864136994 62.39967801252401,11.026286152283559 62.44445039559228,11.122938610758728 62.44717427720862,11.128736695133947 62.402396735072045,11.032227864136994 62.39967801252401)))"
23000006925000,2,1,1,0,"MULTIPOLYGON(((11.128736695133947 62.402396735072045,11.122938610758728 62.44717427720862,11.219610811639882 62.44983124857559,11.225265173329234 62.40504867319591,11.128736695133947 62.402396735072045)))"
23100006925000,79,45,34,42.5,"MULTIPOLYGON(((11.321812815497701 62.40763380115433,11.316302269386368 62.45242128383574,11.413012497853163 62.45494435777383,11.418379137814682 62.41015209384536,11.321812815497701 62.40763380115433)))"
23150006925000,2,1,1,0,"MULTIPOLYGON(((11.418379137814682 62.41015209384536,11.413012497853163 62.45494435777383,11.509741010305794 62.457400445817555,11.514963655870796 62.41260352680723,11.418379137814682 62.41015209384536)))"
23200006925000,1,1,0,0,"MULTIPOLYGON(((11.514963655870796 62.41260352680723,11.509741010305794 62.457400445817555,11.606487319435253 62.45978952403873,11.611565884686762 62.41498807621936,11.514963655870796 62.41260352680723)))"
23350006925000,6,4,2,65.8,"MULTIPOLYGON(((11.804821531920863 62.41955643232301,11.800031375705988 62.46436655852606,11.89682814549174 62.46655447016377,11.901473977664967 62.42174019458703,11.804821531920863 62.41955643232301)))"
19850006930000,159,89,70,38.7,"MULTIPOLYGON(((5.0920835576288 62.146395299629134,5.077466568131257 62.190606516399605,5.172115382491142 62.197415084956184,5.186598472809296 62.15319121057301,5.0920835576288 62.146395299629134)))"
19900006930000,40,24,16,52.8,"MULTIPOLYGON(((5.186598472809296 62.15319121057301,5.172115382491142 62.197415084956184,5.266812508668102 62.204159431896535,5.281161473584865 62.15992301368089,5.186598472809296 62.15319121057301)))"
19950006930000,8,4,4,31.1,"MULTIPOLYGON(((5.281161473584865 62.15992301368089,5.266812508668102 62.204159431896535,5.361557523241981 62.21083949405361,5.375772138358367 62.16659064605887,5.281161473584865 62.15992301368089)))"
20000006930000,231,124,107,46,"MULTIPOLYGON(((5.375772138358367 62.16659064605887,5.361557523241981 62.21083949405361,5.456350001385602 62.21745520880396,5.470430044136458 62.173194045354464,5.375772138358367 62.16659064605887)))"
20050006930000,90,49,41,47.1,"MULTIPOLYGON(((5.470430044136458 62.173194045354464,5.456350001385602 62.21745520880396,5.551189516875016 62.22400651406987,5.565134766539769 62.179733149758896,5.470430044136458 62.173194045354464)))"
20100006930000,1122,583,539,42.8,"MULTIPOLYGON(((5.565134766539769 62.179733149758896,5.551189516875016 62.22400651406987,5.64607564209983 62.23049334832169,5.659885879813176 62.18620789800922,5.565134766539769 62.179733149758896)))"
20150006930000,145,84,61,49.1,"MULTIPOLYGON(((5.659885879813176 62.18620789800922,5.64607564209983 62.23049334832169,5.741007948073701 62.2369156505798,5.754682956836207 62.192618229390476,5.659885879813176 62.18620789800922)))"
20200006930000,284,156,128,43.3,"MULTIPOLYGON(((5.754682956836207 62.192618229390476,5.741007948073701 62.2369156505798,5.835986004444843 62.24327336041701,5.849525569133504 62.19896408373787,5.754682956836207 62.192618229390476)))"
20250006930000,22,12,10,38.5,"MULTIPOLYGON(((5.849525569133504 62.19896408373787,5.835986004444843 62.24327336041701,5.931009379506714 62.249566417960416,5.944413286885406 62.20524540143882,5.849525569133504 62.19896408373787)))"
20300006930000,452,237,215,42.9,"MULTIPOLYGON(((5.944413286885406 62.20524540143882,5.931009379506714 62.249566417960416,6.026077640208722 62.255794763893824,6.039345678938616 62.21146212343514,5.944413286885406 62.20524540143882)))"
20350006930000,24,12,12,39.6,"MULTIPOLYGON(((6.039345678938616 62.21146212343514,6.026077640208722 62.255794763893824,6.121190352167083 62.26195833945958,6.134322312816984 62.217614191225074,6.039345678938616 62.21146212343514)))"
20450006930000,27,14,13,38.6,"MULTIPOLYGON(((6.229342754732348 62.22370154686546,6.216347079675789 62.26805708646084,6.31154738571758 62.274090947263645,6.324406569595499 62.22972413297362,6.229342754732348 62.22370154686546)))"
20550006930000,36,20,16,45.4,"MULTIPOLYGON(((6.419513321027253 62.235681892729595,6.406790831975118 62.28005986479878,6.502076978842192 62.2859637825641,6.514662571369556 62.24157476987803,6.419513321027253 62.235681892729595)))"
20650006930000,196,105,91,45.4,"MULTIPOLYGON(((6.609853881696758 62.24740270873024,6.597405385435037 62.29180264462631,6.69277560960374 62.29757639562309,6.705086811826925 62.253165654166196,6.609853881696758 62.24740270873024)))"
20750006930000,166,87,79,43.7,"MULTIPOLYGON(((6.800360920333256 62.25886355163652,6.788187207943744 62.303284980765106,6.88363973580744 62.3089283458379,6.895675764555609 62.26449634716436,6.800360920333256 62.25886355163652)))"
20800006930000,2485,1275,1210,44.3,"MULTIPOLYGON(((6.895675764555609 62.26449634716436,6.88363973580744 62.3089283458379,6.979132747315848 62.31450643720385,6.991030900612082 62.27006398734744,6.895675764555609 62.26449634716436)))"
20850006930000,126,66,60,48.9,"MULTIPOLYGON(((6.991030900612082 62.27006398734744,6.979132747315848 62.31450643720385,7.074665795370395 62.320019201804215,7.08642588341073 62.27556641935988,6.991030900612082 62.27006398734744)))"
20900006930000,47,26,21,46.7,"MULTIPOLYGON(((7.08642588341073 62.27556641935988,7.074665795370395 62.320019201804215,7.170238431664777 62.325466587160854,7.181860266661322 62.28100359095417,7.08642588341073 62.27556641935988)))"
20950006930000,480,228,252,48.6,"MULTIPOLYGON(((7.181860266661322 62.28100359095417,7.170238431664777 62.325466587160854,7.265850206696915 62.330848541378366,7.277333602887225 62.28637545046301,7.181860266661322 62.28100359095417)))"
21000006930000,406,206,200,43.9,"MULTIPOLYGON(((7.277333602887225 62.28637545046301,7.265850206696915 62.330848541378366,7.361500669780992 62.336165013145774,7.372845443437343 62.29168194680122,7.277333602887225 62.28637545046301)))"
21050006930000,61,34,27,43.6,"MULTIPOLYGON(((7.372845443437343 62.29168194680122,7.361500669780992 62.336165013145774,7.457189369059594 62.34141595173845,7.468395338498172 62.29692302946751,7.372845443437343 62.29168194680122)))"
21100006930000,30,17,13,41.9,"MULTIPOLYGON(((7.468395338498172 62.29692302946751,7.457189369059594 62.34141595173845,7.5529158515159 62.34660130701998,7.563982837105931 62.302098648546405,7.468395338498172 62.29692302946751)))"
21150006930000,5,3,2,54.4,"MULTIPOLYGON(((7.563982837105931 62.302098648546405,7.5529158515159 62.34660130701998,7.648679662986011 62.35172102944402,7.659607487158756 62.30720875471001,7.563982837105931 62.302098648546405)))"
21400006930000,45,22,23,62.5,"MULTIPOLYGON(((8.042468520642135 62.32699308431843,8.03209907627453 62.37154262038872,8.128042681078947 62.376333456105556,8.138272107425472 62.33177490667662,8.042468520642135 62.32699308431843)))"
22200006930000,12,6,6,44.2,"MULTIPOLYGON(((9.579196510892773 62.395582477367086,9.571085953050575 62.44026157518406,9.66752686557527 62.44399262566793,9.67549502436448 62.39930647637973,9.579196510892773 62.395582477367086)))"
22600006930000,35,19,16,52.2,"MULTIPOLYGON(((10.350312381987269 62.42351204370166,10.343344533701558 62.46824406965838,10.439988630869921 62.47144159962685,10.446813102354122 62.4267035193288,10.350312381987269 62.42351204370166)))"
22850006930000,20,11,9,36.1,"MULTIPOLYGON(((10.833042401602956 62.43880200824581,10.82679253428885 62.48356305157464,10.923547967599324 62.486426100065486,10.929653921135822 62.4416596302251,10.833042401602956 62.43880200824581)))"
22950006930000,2,1,1,0,"MULTIPOLYGON(((11.026286152283559 62.44445039559228,11.020324212997016 62.48922216599066,11.11712078387432 62.49195122208883,11.122938610758728 62.44717427720862,11.026286152283559 62.44445039559228)))"
23000006930000,105,50,55,42.7,"MULTIPOLYGON(((11.122938610758728 62.44717427720862,11.11712078387432 62.49195122208883,11.213937192984472 62.49461324174169,11.219610811639882 62.44983124857559,11.122938610758728 62.44717427720862)))"
23050006930000,389,193,196,43.8,"MULTIPOLYGON(((11.219610811639882 62.44983124857559,11.213937192984472 62.49461324174169,11.310772952456471 62.49720819897491,11.316302269386368 62.45242128383574,11.219610811639882 62.44983124857559)))"
23100006930000,4,2,2,0,"MULTIPOLYGON(((11.316302269386368 62.45242128383574,11.310772952456471 62.49720819897491,11.407627573810055 62.49973606845914,11.413012497853163 62.45494435777383,11.316302269386368 62.45242128383574)))"
23200006930000,6,3,3,50.3,"MULTIPOLYGON(((11.509741010305794 62.457400445817555,11.504500567970704 62.50219682551099,11.601391445284701 62.50459044609399,11.606487319435253 62.45978952403873,11.509741010305794 62.457400445817555)))"
23250006930000,5,2,3,59.8,"MULTIPOLYGON(((11.606487319435253 62.45978952403873,11.601391445284701 62.50459044609399,11.698299715534255 62.506916906819356,11.703250937373001 62.46211156915409,11.606487319435253 62.45978952403873)))"
23300006930000,11,6,5,54.6,"MULTIPOLYGON(((11.703250937373001 62.46211156915409,11.698299715534255 62.506916906819356,11.795224887952628 62.50917618494706,11.800031375705988 62.46436655852606,11.703250937373001 62.46211156915409)))"
23350006930000,1,1,0,0,"MULTIPOLYGON(((11.800031375705988 62.46436655852606,11.795224887952628 62.50917618494706,11.89216647123935 62.51136825838664,11.89682814549174 62.46655447016377,11.800031375705988 62.46436655852606)))"
19900006935000,4,2,2,0,"MULTIPOLYGON(((5.172115382491142 62.197415084956184,5.157583980119724 62.241636735936474,5.252415655119908 62.248393662882776,5.266812508668102 62.204159431896535,5.172115382491142 62.197415084956184)))"
20000006935000,61,35,26,49,"MULTIPOLYGON(((5.361557523241981 62.21083949405361,5.347295444323052 62.2550861906946,5.442222921057886 62.26171425647583,5.456350001385602 62.21745520880396,5.361557523241981 62.21083949405361)))"
20050006935000,192,103,89,52.2,"MULTIPOLYGON(((5.456350001385602 62.21745520880396,5.442222921057886 62.26171425647583,5.537197657245522 62.26827779787834,5.551189516875016 62.22400651406987,5.456350001385602 62.21745520880396)))"
20100006935000,629,342,287,44.6,"MULTIPOLYGON(((5.551189516875016 62.22400651406987,5.537197657245522 62.26827779787834,5.632219223409858 62.274776753104035,5.64607564209983 62.23049334832169,5.551189516875016 62.22400651406987)))"
20200006935000,1004,521,483,42.7,"MULTIPOLYGON(((5.741007948073701 62.2369156505798,5.727287188688118 62.28121106090716,5.822401120841455 62.28758066059642,5.835986004444843 62.24327336041701,5.741007948073701 62.2369156505798)))"
20250006935000,741,398,343,42.6,"MULTIPOLYGON(((5.835986004444843 62.24327336041701,5.822401120841455 62.28758066059642,5.917560586265684 62.29388549203715,5.931009379506714 62.249566417960416,5.835986004444843 62.24327336041701)))"
20300006935000,8,4,4,50.9,"MULTIPOLYGON(((5.931009379506714 62.249566417960416,5.917560586265684 62.29388549203715,6.012765150002078 62.30012549565346,6.026077640208722 62.255794763893824,5.931009379506714 62.249566417960416)))"
20350006935000,433,228,205,43.7,"MULTIPOLYGON(((6.026077640208722 62.255794763893824,6.012765150002078 62.30012549565346,6.10801437574831 62.30630061243034,6.121190352167083 62.26195833945958,6.026077640208722 62.255794763893824)))"
20400006935000,85,49,36,45.4,"MULTIPOLYGON(((6.121190352167083 62.26195833945958,6.10801437574831 62.30630061243034,6.203307825869458 62.312410783915745,6.216347079675789 62.26805708646084,6.121190352167083 62.26195833945958)))"
20550006935000,15,9,6,38.9,"MULTIPOLYGON(((6.406790831975118 62.28005986479878,6.394025642100519 62.32443606003164,6.489449126378033 62.33035105059172,6.502076978842192 62.2859637825641,6.406790831975118 62.28005986479878)))"
20600006935000,6,3,3,48.7,"MULTIPOLYGON(((6.502076978842192 62.2859637825641,6.489449126378033 62.33035105059172,6.584915071388346 62.336200867723775,6.597405385435037 62.29180264462631,6.502076978842192 62.2859637825641)))"
20650006935000,394,217,177,47.2,"MULTIPOLYGON(((6.597405385435037 62.29180264462631,6.584915071388346 62.336200867723775,6.680423033002082 62.341985455821664,6.69277560960374 62.29757639562309,6.597405385435037 62.29180264462631)))"
20700006935000,119,60,59,42.9,"MULTIPOLYGON(((6.69277560960374 62.29757639562309,6.680423033002082 62.341985455821664,6.775972565825311 62.34770475985461,6.788187207943744 62.303284980765106,6.69277560960374 62.29757639562309)))"
20800006935000,554,290,264,42.7,"MULTIPOLYGON(((6.88363973580744 62.3089283458379,6.871563223211297 62.35335872536909,6.967194557272183 62.35894729849079,6.979132747315848 62.31450643720385,6.88363973580744 62.3089283458379)))"
20850006935000,10,3,7,45.9,"MULTIPOLYGON(((6.979132747315848 62.31450643720385,6.967194557272183 62.35894729849079,7.062866118890921 62.36447042592657,7.074665795370395 62.320019201804215,6.979132747315848 62.31450643720385)))"
20900006935000,22,11,11,44.7,"MULTIPOLYGON(((7.074665795370395 62.320019201804215,7.062866118890921 62.36447042592657,7.158577457733181 62.36992805496635,7.170238431664777 62.325466587160854,7.074665795370395 62.320019201804215)))"
21000006935000,26,11,15,27.8,"MULTIPOLYGON(((7.265850206696915 62.330848541378366,7.254328122259392 62.37532013348516,7.350117659736891 62.380646609944854,7.361500669780992 62.336165013145774,7.265850206696915 62.330848541378366)))"
21050006935000,38,18,20,39,"MULTIPOLYGON(((7.361500669780992 62.336165013145774,7.350117659736891 62.380646609944854,7.445945616252121 62.385907433396106,7.457189369059594 62.34141595173845,7.361500669780992 62.336165013145774)))"
21150006935000,6,2,4,49,"MULTIPOLYGON(((7.5529158515159 62.34660130701998,7.541811536722939 62.391102553480245,7.637714964911018 62.39623192043107,7.648679662986011 62.35172102944402,7.5529158515159 62.34660130701998)))"
21400006935000,1,0,1,0,"MULTIPOLYGON(((8.03209907627453 62.37154262038872,8.021694590303838 62.4160908824152,8.11777867391484 62.420890758069454,8.128042681078947 62.376333456105556,8.03209907627453 62.37154262038872)))"
21550006935000,9,4,5,41.6,"MULTIPOLYGON(((8.320033170769227 62.38571732923582,8.310050617295301 62.43029234624519,8.406237548055671 62.43489396823517,8.416079130925462 62.39031027651966,8.320033170769227 62.38571732923582)))"
22150006935000,12,5,7,42.9,"MULTIPOLYGON(((9.47467258978085 62.43646399068691,9.466391740568765 62.48113500134058,9.562947845810694 62.48493978258691,9.571085953050575 62.44026157518406,9.47467258978085 62.43646399068691)))"
22200006935000,26,12,14,56.5,"MULTIPOLYGON(((9.571085953050575 62.44026157518406,9.562947845810694 62.48493978258691,9.659531633513899 62.488677905518514,9.66752686557527 62.44399262566793,9.571085953050575 62.44026157518406)))"
22600006935000,27,14,13,57.6,"MULTIPOLYGON(((10.343344533701558 62.46824406965838,10.336352967810408 62.51297536289583,10.433140924245015 62.51617896528013,10.439988630869921 62.47144159962685,10.343344533701558 62.46824406965838)))"
22900006935000,9,6,3,30.7,"MULTIPOLYGON(((10.923547967599324 62.486426100065486,10.9174212018666 62.53119194011373,11.014341948124338 62.533993322457654,11.020324212997016 62.48922216599066,10.923547967599324 62.486426100065486)))"
22950006935000,195,96,99,43.8,"MULTIPOLYGON(((11.020324212997016 62.48922216599066,11.014341948124338 62.533993322457654,11.111283118653025 62.53672756852664,11.11712078387432 62.49195122208883,11.020324212997016 62.48922216599066)))"
23000006935000,361,189,172,47.7,"MULTIPOLYGON(((11.11712078387432 62.49195122208883,11.111283118653025 62.53672756852664,11.208244223865668 62.53939465158184,11.213937192984472 62.49461324174169,11.11712078387432 62.49195122208883)))"
23050006935000,417,205,212,46.8,"MULTIPOLYGON(((11.213937192984472 62.49461324174169,11.208244223865668 62.53939465158184,11.305224773545952 62.541994545531324,11.310772952456471 62.49720819897491,11.213937192984472 62.49461324174169)))"
23100006935000,38,21,17,45.9,"MULTIPOLYGON(((11.310772952456471 62.49720819897491,11.305224773545952 62.541994545531324,11.40222427686335 62.54452722493098,11.407627573810055 62.49973606845914,11.310772952456471 62.49720819897491)))"
23150006935000,35,17,18,45.7,"MULTIPOLYGON(((11.407627573810055 62.49973606845914,11.40222427686335 62.54452722493098,11.499242242388245 62.54699266498552,11.504500567970704 62.50219682551099,11.407627573810055 62.49973606845914)))"
23200006935000,33,18,15,55.3,"MULTIPOLYGON(((11.504500567970704 62.50219682551099,11.499242242388245 62.54699266498552,11.596278178107108 62.54939084154948,11.601391445284701 62.50459044609399,11.504500567970704 62.50219682551099)))"
20000006940000,4,1,3,0,"MULTIPOLYGON(((5.347295444323052 62.2550861906946,5.332985677637828 62.29933072733525,5.428048581044498 62.30597117989055,5.442222921057886 62.26171425647583,5.347295444323052 62.2550861906946)))"
20050006940000,10,4,6,63.6,"MULTIPOLYGON(((5.442222921057886 62.26171425647583,5.428048581044498 62.30597117989055,5.523158967408214 62.31254699287043,5.537197657245522 62.26827779787834,5.442222921057886 62.26171425647583)))"
20100006940000,337,183,154,42.8,"MULTIPOLYGON(((5.537197657245522 62.26827779787834,5.523158967408214 62.31254699287043,5.618316405376624 62.319058104206874,5.632219223409858 62.274776753104035,5.537197657245522 62.26827779787834)))"
20150006940000,468,245,223,43.4,"MULTIPOLYGON(((5.632219223409858 62.274776753104035,5.618316405376624 62.319058104206874,5.713520462199906 62.32550445238631,5.727287188688118 62.28121106090716,5.632219223409858 62.274776753104035)))"
20200006940000,907,486,421,40.5,"MULTIPOLYGON(((5.727287188688118 62.28121106090716,5.713520462199906 62.32550445238631,5.808770703741428 62.33188597645183,5.822401120841455 62.28758066059642,5.727287188688118 62.28121106090716)))"
20250006940000,1587,873,714,39.1,"MULTIPOLYGON(((5.822401120841455 62.28758066059642,5.808770703741428 62.33188597645183,5.90406669448855 62.33820261600533,5.917560586265684 62.29388549203715,5.822401120841455 62.28758066059642)))"
20300006940000,195,102,93,42.9,"MULTIPOLYGON(((5.917560586265684 62.29388549203715,5.90406669448855 62.33820261600533,5.999407997563497 62.34445431120975,6.012765150002078 62.30012549565346,5.917560586265684 62.29388549203715)))"
20350006940000,384,199,185,42.2,"MULTIPOLYGON(((6.012765150002078 62.30012549565346,5.999407997563497 62.34445431120975,6.094794174734378 62.35064100279108,6.10801437574831 62.30630061243034,6.012765150002078 62.30012549565346)))"
20400006940000,184,91,93,52.8,"MULTIPOLYGON(((6.10801437574831 62.30630061243034,6.094794174734378 62.35064100279108,6.190224786426256 62.356762632040585,6.203307825869458 62.312410783915745,6.10801437574831 62.30630061243034)))"
20450006940000,267,140,127,46.8,"MULTIPOLYGON(((6.203307825869458 62.312410783915745,6.190224786426256 62.356762632040585,6.285699391732336 62.36281914081689,6.298645061409094 62.318455952222784,6.203307825869458 62.312410783915745)))"
20500006940000,13,5,8,46.2,"MULTIPOLYGON(((6.298645061409094 62.318455952222784,6.285699391732336 62.36281914081689,6.381217548425233 62.36881047154801,6.394025642100519 62.32443606003164,6.298645061409094 62.318455952222784)))"
20550006940000,97,50,47,42.6,"MULTIPOLYGON(((6.394025642100519 62.32443606003164,6.381217548425233 62.36881047154801,6.476778812968384 62.37473656723353,6.489449126378033 62.33035105059172,6.394025642100519 62.32443606003164)))"
20600006940000,363,198,165,42.5,"MULTIPOLYGON(((6.489449126378033 62.33035105059172,6.476778812968384 62.37473656723353,6.572382740527491 62.380597371446534,6.584915071388346 62.336200867723775,6.489449126378033 62.33035105059172)))"
20650006940000,1349,680,669,40.9,"MULTIPOLYGON(((6.584915071388346 62.336200867723775,6.572382740527491 62.380597371446534,6.66802888498211 62.386392828335715,6.680423033002082 62.341985455821664,6.584915071388346 62.336200867723775)))"
20800006940000,6,4,2,35.5,"MULTIPOLYGON(((6.871563223211297 62.35335872536909,6.859446033735373 62.39778747962748,6.955216139467794 62.4033865652235,6.967194557272183 62.35894729849079,6.871563223211297 62.35335872536909)))"
20850006940000,729,351,378,45.3,"MULTIPOLYGON(((6.967194557272183 62.35894729849079,6.955216139467794 62.4033865652235,7.051026664987062 62.40892008588652,7.062866118890921 62.36447042592657,6.967194557272183 62.35894729849079)))"
20900006940000,50,24,26,51.4,"MULTIPOLYGON(((7.062866118890921 62.36447042592657,7.051026664987062 62.40892008588652,7.146877157918782 62.41438798867311,7.158577457733181 62.36992805496635,7.062866118890921 62.36447042592657)))"
20950006940000,14,7,7,71.6,"MULTIPOLYGON(((7.158577457733181 62.36992805496635,7.146877157918782 62.41438798867311,7.242767164673769 62.41979022122727,7.254328122259392 62.37532013348516,7.158577457733181 62.36992805496635)))"
21300006940000,38,19,19,54.9,"MULTIPOLYGON(((7.829632513779644 62.406293198841205,7.818911444533622 62.45082168422873,7.915065248100962 62.45576280892825,7.925645716315302 62.41122501374684,7.829632513779644 62.406293198841205)))"
21350006940000,8,4,4,61.3,"MULTIPOLYGON(((7.925645716315302 62.41122501374684,7.915065248100962 62.45576280892825,8.011254894530676 62.46063786591996,8.021694590303838 62.4160908824152,7.925645716315302 62.41122501374684)))"
21450006940000,18,9,9,42.1,"MULTIPOLYGON(((8.11777867391484 62.420890758069454,8.10747991986089 62.465446808218324,8.203739859041045 62.4701895894435,8.21389750423784 62.42562459453579,8.11777867391484 62.420890758069454)))"
21500006940000,4,3,1,0,"MULTIPOLYGON(((8.21389750423784 62.42562459453579,8.203739859041045 62.4701895894435,8.300034245944989 62.474866163823016,8.310050617295301 62.43029234624519,8.21389750423784 62.42562459453579)))"
21850006940000,5,1,4,39.4,"MULTIPOLYGON(((8.887663119178072 62.45690860136743,8.878497734310084 62.50153278003252,8.975020116180831 62.505744676232126,8.984043133134026 62.461112534998016,8.887663119178072 62.45690860136743)))"
21900006940000,14,6,8,50.6,"MULTIPOLYGON(((8.984043133134026 62.461112534998016,8.975020116180831 62.505744676232126,9.071573179640092 62.509890021470326,9.080453681173234 62.46525004129007,8.984043133134026 62.461112534998016)))"
22200006940000,191,100,91,40.2,"MULTIPOLYGON(((9.562947845810694 62.48493978258691,9.554782055965676 62.52961709695406,9.651509197223099 62.53336231341205,9.659531633513899 62.488677905518514,9.562947845810694 62.48493978258691)))"
22600006940000,38,19,19,43.4,"MULTIPOLYGON(((10.336352967810408 62.51297536289583,10.329337569291871 62.557705921561414,10.426269869758885 62.56091561452442,10.433140924245015 62.51617896528013,10.336352967810408 62.51297536289583)))"
22950006940000,118,63,55,46.5,"MULTIPOLYGON(((11.014341948124338 62.533993322457654,11.008339258873322 62.578763863722095,11.105425518642894 62.58150331532685,11.111283118653025 62.53672756852664,11.014341948124338 62.533993322457654)))"
23000006940000,10,6,4,60.5,"MULTIPOLYGON(((11.111283118653025 62.53672756852664,11.105425518642894 62.58150331532685,11.202531810176843 62.58417547697505,11.208244223865668 62.53939465158184,11.111283118653025 62.53672756852664)))"
23050006940000,160,87,73,44.2,"MULTIPOLYGON(((11.208244223865668 62.53939465158184,11.202531810176843 62.58417547697505,11.299657640898465 62.58678032245638,11.305224773545952 62.541994545531324,11.208244223865668 62.53939465158184)))"
23100006940000,3676,1793,1883,44.3,"MULTIPOLYGON(((11.305224773545952 62.541994545531324,11.299657640898465 62.58678032245638,11.396802517611832 62.589317826211236,11.40222427686335 62.54452722493098,11.305224773545952 62.541994545531324)))"
23150006940000,131,52,79,60.9,"MULTIPOLYGON(((11.40222427686335 62.54452722493098,11.396802517611832 62.589317826211236,11.49396594651704 62.591787963331775,11.499242242388245 62.54699266498552,11.40222427686335 62.54452722493098)))"
23200006940000,13,6,7,43.7,"MULTIPOLYGON(((11.499242242388245 62.54699266498552,11.49396594651704 62.591787963331775,11.591147433225517 62.59419070956283,11.596278178107108 62.54939084154948,11.499242242388245 62.54699266498552)))"
23250006940000,22,13,9,45.4,"MULTIPOLYGON(((11.596278178107108 62.54939084154948,11.591147433225517 62.59419070956283,11.688346482775378 62.59652604130289,11.69333159143773 62.55172173112805,11.596278178107108 62.54939084154948)))"
23300006940000,5,2,3,31.6,"MULTIPOLYGON(((11.69333159143773 62.55172173112805,11.688346482775378 62.59652604130289,11.78556259964681 62.59879393560489,11.790401989244502 62.55398531087802,11.69333159143773 62.55172173112805)))"
23350006940000,57,34,23,54.2,"MULTIPOLYGON(((11.790401989244502 62.55398531087802,11.78556259964681 62.59879393560489,11.882795287777519 62.600994370177176,11.887488877853716 62.55618155860864,11.790401989244502 62.55398531087802)))"
20100006945000,646,320,326,41.3,"MULTIPOLYGON(((5.523158967408214 62.31254699287043,5.509073225733278 62.3568140906782,5.604366968257373 62.363337393427734,5.618316405376624 62.319058104206874,5.523158967408214 62.31254699287043)))"
20150006945000,4790,2446,2344,41.4,"MULTIPOLYGON(((5.618316405376624 62.319058104206874,5.604366968257373 62.363337393427734,5.699707550764108 62.36979581697901,5.713520462199906 62.32550445238631,5.618316405376624 62.319058104206874)))"
20200006945000,348,173,175,44.8,"MULTIPOLYGON(((5.713520462199906 62.32550445238631,5.699707550764108 62.36979581697901,5.795094537208274 62.37618930010791,5.808770703741428 62.33188597645183,5.713520462199906 62.32550445238631)))"
20250006945000,5959,2930,3029,40.2,"MULTIPOLYGON(((5.808770703741428 62.33188597645183,5.795094537208274 62.37618930010791,5.890527490157886 62.38251778215129,5.90406669448855 62.33820261600533,5.808770703741428 62.33188597645183)))"
20300006945000,974,509,465,40.3,"MULTIPOLYGON(((5.90406669448855 62.33820261600533,5.890527490157886 62.38251778215129,5.986005970805134 62.38878120300931,5.999407997563497 62.34445431120975,5.90406669448855 62.33820261600533)))"
20350006945000,3287,1666,1621,40.7,"MULTIPOLYGON(((5.999407997563497 62.34445431120975,5.986005970805134 62.38878120300931,6.081529538977469 62.39497950314746,6.094794174734378 62.35064100279108,5.999407997563497 62.34445431120975)))"
20400006945000,45,25,20,43.2,"MULTIPOLYGON(((6.094794174734378 62.35064100279108,6.081529538977469 62.39497950314746,6.177097753148757 62.40111262359868,6.190224786426256 62.356762632040585,6.094794174734378 62.35064100279108)))"
20450006945000,54,25,29,39.2,"MULTIPOLYGON(((6.190224786426256 62.356762632040585,6.177097753148757 62.40111262359868,6.272710170450542 62.40718050596562,6.285699391732336 62.36281914081689,6.190224786426256 62.356762632040585)))"
20500006945000,5,2,3,23.4,"MULTIPOLYGON(((6.285699391732336 62.36281914081689,6.272710170450542 62.40718050596562,6.368366346683401 62.41318309242261,6.381217548425233 62.36881047154801,6.285699391732336 62.36281914081689)))"
20550006945000,485,247,238,40.2,"MULTIPOLYGON(((6.381217548425233 62.36881047154801,6.368366346683401 62.41318309242261,6.464065836328414 62.41912032571777,6.476778812968384 62.37473656723353,6.381217548425233 62.36881047154801)))"
20600006945000,1130,554,576,43.3,"MULTIPOLYGON(((6.476778812968384 62.37473656723353,6.464065836328414 62.41912032571777,6.55980819255871 62.42499214917514,6.572382740527491 62.380597371446534,6.476778812968384 62.37473656723353)))"
20650006945000,3306,1622,1684,42.5,"MULTIPOLYGON(((6.572382740527491 62.380597371446534,6.55980819255871 62.42499214917514,6.655592967251107 62.43079850669672,6.66802888498211 62.386392828335715,6.572382740527491 62.380597371446534)))"
20700006945000,60,27,33,48.3,"MULTIPOLYGON(((6.66802888498211 62.386392828335715,6.655592967251107 62.43079850669672,6.751419710997887 62.43653934276437,6.763716798937294 62.392122882627405,6.66802888498211 62.386392828335715)))"
20750006945000,120,71,49,48.5,"MULTIPOLYGON(((6.763716798937294 62.392122882627405,6.751419710997887 62.43653934276437,6.847287973118612 62.442214602442064,6.859446033735373 62.39778747962748,6.763716798937294 62.392122882627405)))"
20800006945000,46,22,24,46.4,"MULTIPOLYGON(((6.859446033735373 62.39778747962748,6.847287973118612 62.442214602442064,6.943197301672061 62.44782423137762,6.955216139467794 62.4033865652235,6.859446033735373 62.39778747962748)))"
20850006945000,30,14,16,48.3,"MULTIPOLYGON(((6.955216139467794 62.4033865652235,6.943197301672061 62.44782423137762,7.039147243468276 62.45336817580494,7.051026664987062 62.40892008588652,6.955216139467794 62.4033865652235)))"
21100006945000,17,8,9,47,"MULTIPOLYGON(((7.434663899296358 62.430397469162884,7.423344036256684 62.474886053725946,7.519490203564682 62.48010078976412,7.530669714022102 62.4356023827866,7.434663899296358 62.430397469162884)))"
21150006945000,30,19,11,38.3,"MULTIPOLYGON(((7.530669714022102 62.4356023827866,7.519490203564682 62.48010078976412,7.615674239437127 62.48524953111065,7.626713216312286 62.440741422666115,7.530669714022102 62.4356023827866)))"
21250006945000,17,9,8,46.5,"MULTIPOLYGON(((7.722793946688859 62.445814539410826,7.711895682287306 62.49033222815486,7.808154069379263 62.49534883188725,7.818911444533622 62.45082168422873,7.722793946688859 62.445814539410826)))"
21300006945000,12,5,7,38.5,"MULTIPOLYGON(((7.818911444533622 62.45082168422873,7.808154069379263 62.49534883188725,7.904448936840629 62.500299293901236,7.915065248100962 62.45576280892825,7.818911444533622 62.45082168422873)))"
21450006945000,33,18,15,43,"MULTIPOLYGON(((8.10747991986089 62.465446808218324,8.097146251777717 62.510001602172885,8.19354776594338 62.51475335464796,8.203739859041045 62.4701895894435,8.10747991986089 62.465446808218324)))"
21900006945000,18,11,7,29.4,"MULTIPOLYGON(((8.975020116180831 62.505744676232126,8.965966417480054 62.550375787142535,9.062662471566648 62.554528994662846,9.071573179640092 62.509890021470326,8.975020116180831 62.505744676232126)))"
21950006945000,94,52,42,47.6,"MULTIPOLYGON(((9.071573179640092 62.509890021470326,9.062662471566648 62.554528994662846,9.159388878261694 62.55861548683021,9.1681564494829 62.51396877551469,9.071573179640092 62.509890021470326)))"
22100006945000,11,6,5,53.9,"MULTIPOLYGON(((9.361411702810704 62.52192635221054,9.352930834991978 62.56658816658431,9.449745425463634 62.57047427648051,9.458082731239044 62.5258050975199,9.361411702810704 62.52192635221054)))"
22200006945000,306,158,148,40.9,"MULTIPOLYGON(((9.554782055965676 62.52961709695406,9.546588449444833 62.57429351564568,9.643459424896523 62.57804584681143,9.651509197223099 62.53336231341205,9.554782055965676 62.52961709695406)))"
22250006945000,72,40,32,46.3,"MULTIPOLYGON(((9.651509197223099 62.53336231341205,9.643459424896523 62.57804584681143,9.740357868902432 62.581731233342765,9.748263674373641 62.53704071042344,9.651509197223099 62.53336231341205)))"
22550006945000,157,79,78,43.9,"MULTIPOLYGON(((10.232429217096628 62.554429171626985,10.225245155589244 62.59915275876235,10.322298222375865 62.60243574378913,10.329337569291871 62.557705921561414,10.232429217096628 62.554429171626985)))"
22600006945000,73,33,40,50.1,"MULTIPOLYGON(((10.329337569291871 62.557705921561414,10.322298222375865 62.60243574378913,10.419375353957529 62.60565154558263,10.426269869758885 62.56091561452442,10.329337569291871 62.557705921561414)))"
23100006945000,371,189,182,40.7,"MULTIPOLYGON(((11.299657640898465 62.58678032245638,11.294071462158573 62.631565528693216,11.39136220607036 62.63410787131408,11.396802517611832 62.589317826211236,11.299657640898465 62.58678032245638)))"
23150006945000,28,14,14,38.1,"MULTIPOLYGON(((11.396802517611832 62.589317826211236,11.39136220607036 62.63410787131408,11.488671592747005 62.63658271963311,11.49396594651704 62.591787963331775,11.396802517611832 62.589317826211236)))"
23200006945000,74,39,35,44.6,"MULTIPOLYGON(((11.49396594651704 62.591787963331775,11.488671592747005 62.63658271963311,11.585999125409556 62.638990049284764,11.591147433225517 62.59419070956283,11.49396594651704 62.591787963331775)))"
23250006945000,35,20,15,59.2,"MULTIPOLYGON(((11.591147433225517 62.59419070956283,11.585999125409556 62.638990049284764,11.683344306701036 62.64132983656009,11.688346482775378 62.59652604130289,11.591147433225517 62.59419070956283)))"
23300006945000,46,27,19,52.5,"MULTIPOLYGON(((11.688346482775378 62.59652604130289,11.683344306701036 62.64132983656009,11.780706638702005 62.643602058407545,11.78556259964681 62.59879393560489,11.688346482775378 62.59652604130289)))"
23350006945000,25,12,13,47.7,"MULTIPOLYGON(((11.78556259964681 62.59879393560489,11.780706638702005 62.643602058407545,11.87808562294609 62.64580669243399,11.882795287777519 62.600994370177176,11.78556259964681 62.59879393560489)))"
23400006945000,22,13,9,40.3,"MULTIPOLYGON(((11.882795287777519 62.600994370177176,11.87808562294609 62.64580669243399,11.975480760435612 62.64794371690548,11.980044050578213 62.6031273233844,11.882795287777519 62.600994370177176)))"
23450006945000,5,2,3,57.8,"MULTIPOLYGON(((11.980044050578213 62.6031273233844,11.975480760435612 62.64794371690548,12.072891551657241 62.65001311074807,12.07730839094812 62.60519277424822,11.980044050578213 62.6031273233844)))"
20100006950000,212,111,101,49.6,"MULTIPOLYGON(((5.509073225733278 62.3568140906782,5.494940209193396 62.401079082879164,5.590370690922538 62.40761461251061,5.604366968257373 62.363337393427734,5.509073225733278 62.3568140906782)))"
20150006950000,206,103,103,47.6,"MULTIPOLYGON(((5.604366968257373 62.363337393427734,5.590370690922538 62.40761461251061,5.685848235159754 62.41408514659448,5.699707550764108 62.36979581697901,5.604366968257373 62.363337393427734)))"
20250006950000,167,88,79,42.2,"MULTIPOLYGON(((5.795094537208274 62.37618930010791,5.781372403940377 62.42049062363778,5.876942757902126 62.42683098271081,5.890527490157886 62.38251778215129,5.795094537208274 62.37618930010791)))"
20350006950000,349,186,163,40.9,"MULTIPOLYGON(((5.986005970805134 62.38878120300931,5.972558856296083 62.43310616344927,6.068220256997879 62.43931610605658,6.081529538977469 62.39497950314746,5.986005970805134 62.38878120300931)))"
20400006950000,94,47,47,31.2,"MULTIPOLYGON(((6.081529538977469 62.39497950314746,6.068220256997879 62.43931610605658,6.163926516518932 62.445460751305816,6.177097753148757 62.40111262359868,6.081529538977469 62.39497950314746)))"
20450006950000,5521,2826,2695,39.6,"MULTIPOLYGON(((6.177097753148757 62.40111262359868,6.163926516518932 62.445460751305816,6.259677190017754 62.45154004054206,6.272710170450542 62.40718050596562,6.177097753148757 62.40111262359868)))"
20500006950000,6146,3165,2981,37.3,"MULTIPOLYGON(((6.272710170450542 62.40718050596562,6.259677190017754 62.45154004054206,6.355471831311423 62.457553915684414,6.368366346683401 62.41318309242261,6.272710170450542 62.40718050596562)))"
20550006950000,8604,4349,4255,37.3,"MULTIPOLYGON(((6.368366346683401 62.41318309242261,6.355471831311423 62.457553915684414,6.451309992887114 62.46350231922806,6.464065836328414 62.41912032571777,6.368366346683401 62.41318309242261)))"
20600006950000,634,330,304,34.1,"MULTIPOLYGON(((6.464065836328414 62.41912032571777,6.451309992887114 62.46350231922806,6.54719122591372 62.46938519424644,6.55980819255871 62.42499214917514,6.464065836328414 62.41912032571777)))"
20650006950000,159,80,79,42.6,"MULTIPOLYGON(((6.55980819255871 62.42499214917514,6.54719122591372 62.46938519424644,6.643115080253603 62.47520248439328,6.655592967251107 62.43079850669672,6.55980819255871 62.42499214917514)))"
20700006950000,144,77,67,41.9,"MULTIPOLYGON(((6.655592967251107 62.43079850669672,6.643115080253603 62.47520248439328,6.739081104474406 62.48095413390458,6.751419710997887 62.43653934276437,6.655592967251107 62.43079850669672)))"
20750006950000,1303,676,627,42.5,"MULTIPOLYGON(((6.751419710997887 62.43653934276437,6.739081104474406 62.48095413390458,6.835088845860993 62.486640087600826,6.847287973118612 62.442214602442064,6.751419710997887 62.43653934276437)))"
20800006950000,635,334,301,42.3,"MULTIPOLYGON(((6.847287973118612 62.442214602442064,6.835088845860993 62.486640087600826,6.931137850427461 62.492260290888744,6.943197301672061 62.44782423137762,6.847287973118612 62.442214602442064)))"
20850006950000,7,4,3,53.7,"MULTIPOLYGON(((6.943197301672061 62.44782423137762,6.931137850427461 62.492260290888744,7.027227662929253 62.49781468976349,7.039147243468276 62.45336817580494,6.943197301672061 62.44782423137762)))"
20900006950000,29,17,12,37.3,"MULTIPOLYGON(((7.039147243468276 62.45336817580494,7.027227662929253 62.49781468976349,7.123357826875376 62.50330323081057,7.135137344080674 62.458846382545715,7.039147243468276 62.45336817580494)))"
20950006950000,118,62,56,42.2,"MULTIPOLYGON(((7.135137344080674 62.458846382545715,7.123357826875376 62.50330323081057,7.219527884540687 62.508725861207786,7.231167147858233 62.464258799011596,7.135137344080674 62.458846382545715)))"
21050006950000,49,28,21,42,"MULTIPOLYGON(((7.327236197937847 62.46960537320598,7.315737376978299 62.514082528727165,7.411985844032068 62.51937318173689,7.423344036256684 62.474886053725946,7.327236197937847 62.46960537320598)))"
21150006950000,330,180,150,43.7,"MULTIPOLYGON(((7.519490203564682 62.48010078976412,7.508272824349151 62.524597769203204,7.604597855392693 62.52975624069231,7.615674239437127 62.48524953111065,7.519490203564682 62.48010078976412)))"
21200006950000,143,69,74,42.4,"MULTIPOLYGON(((7.615674239437127 62.48524953111065,7.604597855392693 62.52975624069231,7.700960473454571 62.53484854637216,7.711895682287306 62.49033222815486,7.615674239437127 62.48524953111065)))"
21250006950000,109,55,54,44.9,"MULTIPOLYGON(((7.711895682287306 62.49033222815486,7.700960473454571 62.53484854637216,7.797360213668237 62.53987463701439,7.808154069379263 62.49534883188725,7.711895682287306 62.49033222815486)))"
21300006950000,14,8,6,41.9,"MULTIPOLYGON(((7.808154069379263 62.49534883188725,7.797360213668237 62.53987463701439,7.893796610021656 62.544834463996054,7.904448936840629 62.500299293901236,7.808154069379263 62.49534883188725)))"
21350006950000,11,7,4,40.7,"MULTIPOLYGON(((7.904448936840629 62.500299293901236,7.893796610021656 62.544834463996054,7.990269195370314 62.54972797930153,8.00077981967556 62.505183566394926,7.904448936840629 62.500299293901236)))"
21450006950000,2,1,1,0,"MULTIPOLYGON(((8.097146251777717 62.510001602172885,8.086777501450332 62.55455513552418,8.183321058891652 62.559315885868166,8.19354776594338 62.51475335464796,8.097146251777717 62.510001602172885)))"
21900006950000,38,17,21,44.5,"MULTIPOLYGON(((8.965966417480054 62.550375787142535,8.956881888570795 62.595005864414965,9.053721410726743 62.59916695766685,9.062662471566648 62.554528994662846,8.965966417480054 62.550375787142535)))"
21950006950000,32,15,17,53.5,"MULTIPOLYGON(((9.062662471566648 62.554528994662846,9.053721410726743 62.59916695766685,9.150591432664138 62.60326121104861,9.159388878261694 62.55861548683021,9.062662471566648 62.554528994662846)))"
22000006950000,10,5,5,51.5,"MULTIPOLYGON(((9.159388878261694 62.55861548683021,9.150591432664138 62.60326121104861,9.24749147373886 62.60728858459355,9.25614515917741 62.5626352238573,9.159388878261694 62.55861548683021)))"
22050006950000,110,54,56,43.2,"MULTIPOLYGON(((9.25614515917741 62.5626352238573,9.24749147373886 62.60728858459355,9.344421052365206 62.611249038965205,9.352930834991978 62.56658816658431,9.25614515917741 62.5626352238573)))"
22100006950000,123,65,58,42.6,"MULTIPOLYGON(((9.352930834991978 62.56658816658431,9.344421052365206 62.611249038965205,9.441379686030082 62.615142535458936,9.449745425463634 62.57047427648051,9.352930834991978 62.56658816658431)))"
22150006950000,233,125,108,44.4,"MULTIPOLYGON(((9.449745425463634 62.57047427648051,9.441379686030082 62.615142535458936,9.538366891307296 62.618969036003314,9.546588449444833 62.57429351564568,9.449745425463634 62.57047427648051)))"
22200006950000,571,275,296,38,"MULTIPOLYGON(((9.546588449444833 62.57429351564568,9.538366891307296 62.618969036003314,9.63538218387192 62.62272850316158,9.643459424896523 62.57804584681143,9.546588449444833 62.57429351564568)))"
22250006950000,4882,2420,2462,43.2,"MULTIPOLYGON(((9.643459424896523 62.57804584681143,9.63538218387192 62.62272850316158,9.7324250785147 62.62642090013315,9.740357868902432 62.581731233342765,9.643459424896523 62.57804584681143)))"
22300006950000,126,70,56,39.9,"MULTIPOLYGON(((9.740357868902432 62.581731233342765,9.7324250785147 62.62642090013315,9.829495089156572 62.63004619075481,9.837283297683472 62.58534963923936,9.740357868902432 62.581731233342765)))"
22350006950000,1,1,0,0,"MULTIPOLYGON(((9.837283297683472 62.58534963923936,9.829495089156572 62.63004619075481,9.926591728863208 62.63360433950229,9.934235226612174 62.58890102913699,9.837283297683472 62.58534963923936)))"
22500006950000,15,8,7,35.7,"MULTIPOLYGON(((10.128216642247978 62.59580262266661,10.120862943545049 62.64051907247989,10.218036540507322 62.64387558886775,10.225245155589244 62.59915275876235,10.128216642247978 62.59580262266661)))"
22550006950000,71,35,36,45.3,"MULTIPOLYGON(((10.225245155589244 62.59915275876235,10.218036540507322 62.64387558886775,10.315234810538094 62.64716482769943,10.322298222375865 62.60243574378913,10.225245155589244 62.59915275876235)))"
23100006950000,11,4,7,39.1,"MULTIPOLYGON(((11.294071462158573 62.631565528693216,11.288466144366843 62.676350163176664,11.385903251665107 62.67889735924582,11.39136220607036 62.63410787131408,11.294071462158573 62.631565528693216)))"
23150006950000,284,132,152,45.7,"MULTIPOLYGON(((11.39136220607036 62.63410787131408,11.385903251665107 62.67889735924582,11.48335909289474 62.681376932965456,11.488671592747005 62.63658271963311,11.39136220607036 62.63410787131408)))"
23200006950000,90,41,49,47.5,"MULTIPOLYGON(((11.488671592747005 62.63658271963311,11.48335909289474 62.681376932965456,11.580833168870912 62.683788859858986,11.585999125409556 62.638990049284764,11.488671592747005 62.63658271963311)))"
23250006950000,27,16,11,44.1,"MULTIPOLYGON(((11.585999125409556 62.638990049284764,11.580833168870912 62.683788859858986,11.678324979826057 62.686133116109325,11.683344306701036 62.64132983656009,11.585999125409556 62.638990049284764)))"
23300006950000,57,26,31,39.7,"MULTIPOLYGON(((11.683344306701036 62.64132983656009,11.678324979826057 62.686133116109325,11.775834025425528 62.68840967855983,11.780706638702005 62.643602058407545,11.683344306701036 62.64132983656009)))"
23350006950000,172,93,79,47.9,"MULTIPOLYGON(((11.780706638702005 62.643602058407545,11.775834025425528 62.68840967855983,11.873359804783274 62.690618524715156,11.87808562294609 62.64580669243399,11.780706638702005 62.643602058407545)))"
23400006950000,32,19,13,49.2,"MULTIPOLYGON(((11.87808562294609 62.64580669243399,11.873359804783274 62.690618524715156,11.970901816477582 62.69275963274215,11.975480760435612 62.64794371690548,11.87808562294609 62.64580669243399)))"
20350006955000,1019,497,522,38.5,"MULTIPOLYGON(((5.972558856296083 62.43310616344927,5.959066439251813 62.4774291848768,6.054866115973559 62.48365080402659,6.068220256997879 62.43931610605658,5.972558856296083 62.43310616344927)))"
20400006955000,7254,3774,3480,40.7,"MULTIPOLYGON(((6.068220256997879 62.43931610605658,6.054866115973559 62.48365080402659,6.150710865687755 62.489807007829796,6.163926516518932 62.445460751305816,6.068220256997879 62.43931610605658)))"
20450006955000,11470,5920,5550,40.8,"MULTIPOLYGON(((6.163926516518932 62.445460751305816,6.150710865687755 62.489807007829796,6.246600241568462 62.495897737372346,6.259677190017754 62.45154004054206,6.163926516518932 62.445460751305816)))"
20500006955000,11653,5917,5736,40.5,"MULTIPOLYGON(((6.259677190017754 62.45154004054206,6.246600241568462 62.495897737372346,6.342533795437713 62.5019229343165,6.355471831311423 62.457553915684414,6.259677190017754 62.45154004054206)))"
20550006955000,6548,3243,3305,42.2,"MULTIPOLYGON(((6.355471831311423 62.457553915684414,6.342533795437713 62.5019229343165,6.438511077777138 62.507882540903005,6.451309992887114 62.46350231922806,6.355471831311423 62.457553915684414)))"
20600006955000,332,184,148,41.5,"MULTIPOLYGON(((6.451309992887114 62.46350231922806,6.438511077777138 62.507882540903005,6.534531637739672 62.51377649995316,6.54719122591372 62.46938519424644,6.451309992887114 62.46350231922806)))"
20650006955000,137,79,58,42.5,"MULTIPOLYGON(((6.54719122591372 62.46938519424644,6.534531637739672 62.51377649995316,6.630595023161374 62.519604754870905,6.643115080253603 62.47520248439328,6.54719122591372 62.46938519424644)))"
20700006955000,3310,1663,1647,39,"MULTIPOLYGON(((6.643115080253603 62.47520248439328,6.630595023161374 62.519604754870905,6.726700780573342 62.525367249644894,6.739081104474406 62.48095413390458,6.643115080253603 62.47520248439328)))"
20750006955000,309,161,148,47.2,"MULTIPOLYGON(((6.739081104474406 62.48095413390458,6.726700780573342 62.525367249644894,6.822848455213719 62.53106392885056,6.835088845860993 62.486640087600826,6.739081104474406 62.48095413390458)))"
20800006955000,19,11,8,32.8,"MULTIPOLYGON(((6.835088845860993 62.486640087600826,6.822848455213719 62.53106392885056,6.919037591039791 62.53669473765211,6.931137850427461 62.492260290888744,6.835088845860993 62.486640087600826)))"
20900006955000,85,39,46,42.2,"MULTIPOLYGON(((7.027227662929253 62.49781468976349,7.015267730740204 62.54225962180454,7.111538415747261 62.5477585276556,7.123357826875376 62.50330323081057,7.027227662929253 62.49781468976349)))"
20950006955000,348,182,166,46.1,"MULTIPOLYGON(((7.123357826875376 62.50330323081057,7.111538415747261 62.5477585276556,7.207849186249292 62.55319140214787,7.219527884540687 62.508725861207786,7.123357826875376 62.50330323081057)))"
21050006955000,80,38,42,40.7,"MULTIPOLYGON(((7.315737376978299 62.514082528727165,7.304199581203152 62.55855819282054,7.400589138346796 62.56385884781153,7.411985844032068 62.51937318173689,7.315737376978299 62.514082528727165)))"
21100006955000,566,301,265,42.8,"MULTIPOLYGON(((7.411985844032068 62.51937318173689,7.400589138346796 62.56385884781153,7.497017394211944 62.569093315859284,7.508272824349151 62.524597769203204,7.411985844032068 62.51937318173689)))"
21150006955000,150,79,71,41.1,"MULTIPOLYGON(((7.508272824349151 62.524597769203204,7.497017394211944 62.569093315859284,7.593483884136852 62.57426154630466,7.604597855392693 62.52975624069231,7.508272824349151 62.524597769203204)))"
21200006955000,1853,931,922,45.1,"MULTIPOLYGON(((7.604597855392693 62.52975624069231,7.593483884136852 62.57426154630466,7.689988142279129 62.57936348909289,7.700960473454571 62.53484854637216,7.604597855392693 62.52975624069231)))"
21250006955000,1378,696,682,41.5,"MULTIPOLYGON(((7.700960473454571 62.53484854637216,7.689988142279129 62.57936348909289,7.786529701628717 62.584399094775364,7.797360213668237 62.53987463701439,7.700960473454571 62.53484854637216)))"
21300006955000,1239,617,622,41.3,"MULTIPOLYGON(((7.797360213668237 62.53987463701439,7.786529701628717 62.584399094775364,7.883108094020878 62.589368314511496,7.893796610021656 62.544834463996054,7.797360213668237 62.53987463701439)))"
21350006955000,18,9,9,39.8,"MULTIPOLYGON(((7.893796610021656 62.544834463996054,7.883108094020878 62.589368314511496,7.979722850149344 62.59427110007055,7.990269195370314 62.54972797930153,7.893796610021656 62.544834463996054)))"
21450006955000,12,7,5,44.5,"MULTIPOLYGON(((8.086777501450332 62.55455513552418,8.0763734995795 62.59910740383333,8.17305957076166 62.60387717879416,8.183321058891652 62.559315885868166,8.086777501450332 62.55455513552418)))"
21650006955000,2,1,1,0,"MULTIPOLYGON(((8.473158529369394 62.57319924286857,8.46332558287903 62.617786870045,8.560148603741158 62.62229007206944,8.569838376897994 62.57769391401634,8.473158529369394 62.57319924286857)))"
21800006955000,22,10,12,45.2,"MULTIPOLYGON(((8.763296261386921 62.586483321310205,8.753893310755451 62.63109616912197,8.850814039975372 62.63539897819681,8.860073345884663 62.590777971888485,8.763296261386921 62.586483321310205)))"
21850006955000,65,29,36,43.3,"MULTIPOLYGON(((8.860073345884663 62.590777971888485,8.850814039975372 62.63539897819681,8.947766380030084 62.63963490471216,8.956881888570795 62.595005864414965,8.860073345884663 62.590777971888485)))"
21900006955000,4,1,3,0,"MULTIPOLYGON(((8.956881888570795 62.595005864414965,8.947766380030084 62.63963490471216,9.0447498499461 62.64380390725931,9.053721410726743 62.59916695766685,8.956881888570795 62.595005864414965)))"
22050006955000,15,9,6,50.7,"MULTIPOLYGON(((9.24749147373886 62.60728858459355,9.238808250594118 62.651940977965374,9.335882214547716 62.655908966462846,9.344421052365206 62.611249038965205,9.24749147373886 62.60728858459355)))"
22150006955000,62,31,31,43.6,"MULTIPOLYGON(((9.441379686030082 62.615142535458936,9.4329853748344 62.65980987167222,9.530117245734969 62.66364365534983,9.538366891307296 62.618969036003314,9.441379686030082 62.615142535458936)))"
22200006955000,164,85,79,39.8,"MULTIPOLYGON(((9.538366891307296 62.618969036003314,9.530117245734969 62.66364365534983,9.627277340624188 62.667410279889495,9.63538218387192 62.62272850316158,9.538366891307296 62.618969036003314)))"
22300006955000,89,48,41,40.6,"MULTIPOLYGON(((9.7324250785147 62.62642090013315,9.724465171985331 62.67110970832388,9.821680251424798 62.67474190432599,9.829495089156572 62.63004619075481,9.7324250785147 62.62642090013315)))"
22350006955000,135,74,61,42.1,"MULTIPOLYGON(((9.829495089156572 62.63004619075481,9.821680251424798 62.67474190432599,9.918922089686772 62.67830683221048,9.926591728863208 62.63360433950229,9.829495089156572 62.63004619075481)))"
22450006955000,13,5,8,37.2,"MULTIPOLYGON(((10.02371450985966 62.6370953114915,10.01619019666798 62.68180445693499,10.113484081432507 62.685234744101635,10.120862943545049 62.64051907247989,10.02371450985966 62.6370953114915)))"
22500006955000,17,7,10,40.9,"MULTIPOLYGON(((10.120862943545049 62.64051907247989,10.113484081432507 62.685234744101635,10.210803252226658 62.68859765995809,10.218036540507322 62.64387558886775,10.120862943545049 62.64051907247989)))"
23100006955000,6,3,3,42,"MULTIPOLYGON(((11.288466144366843 62.676350163176664,11.28284159395493 62.721134224833165,11.380425563228764 62.72368628900483,11.385903251665107 62.67889735924582,11.288466144366843 62.676350163176664)))"
23150006955000,15,10,5,58.9,"MULTIPOLYGON(((11.385903251665107 62.67889735924582,11.380425563228764 62.72368628900483,11.47802835819881 62.72617060239731,11.48335909289474 62.681376932965456,11.385903251665107 62.67889735924582)))"
23200006955000,22,12,10,46.5,"MULTIPOLYGON(((11.48335909289474 62.681376932965456,11.47802835819881 62.72617060239731,11.575649477258777 62.72858714042224,11.580833168870912 62.683788859858986,11.48335909289474 62.681376932965456)))"
23250006955000,7,5,2,37.9,"MULTIPOLYGON(((11.580833168870912 62.683788859858986,11.575649477258777 62.72858714042224,11.673288418214854 62.73093587915373,11.678324979826057 62.686133116109325,11.580833168870912 62.683788859858986)))"
23300006955000,50,26,24,44.8,"MULTIPOLYGON(((11.678324979826057 62.686133116109325,11.673288418214854 62.73093587915373,11.770944678301499 62.733216795329334,11.775834025425528 62.68840967855983,11.678324979826057 62.686133116109325)))"
23350006955000,2,2,0,0,"MULTIPOLYGON(((11.775834025425528 62.68840967855983,11.770944678301499 62.733216795329334,11.868617754197246 62.73542986635089,11.873359804783274 62.690618524715156,11.775834025425528 62.68840967855983)))"
23400006955000,3,2,1,0,"MULTIPOLYGON(((11.873359804783274 62.690618524715156,11.868617754197246 62.73542986635089,11.966307142040572 62.737575070285416,11.970901816477582 62.69275963274215,11.873359804783274 62.690618524715156)))"
20350006960000,677,345,332,39.1,"MULTIPOLYGON(((5.959066439251813 62.4774291848768,5.945528503523549 62.521750259588785,6.041466901729539 62.52798358951639,6.054866115973559 62.48365080402659,5.959066439251813 62.4774291848768)))"
20400006960000,4782,2383,2399,38.3,"MULTIPOLYGON(((6.054866115973559 62.48365080402659,6.041466901729539 62.52798358951639,6.137450588464737 62.534151385790146,6.150710865687755 62.489807007829796,6.054866115973559 62.48365080402659)))"
20450006960000,938,466,472,35,"MULTIPOLYGON(((6.150710865687755 62.489807007829796,6.137450588464737 62.534151385790146,6.233479114907222 62.54025358923524,6.246600241568462 62.495897737372346,6.150710865687755 62.489807007829796)))"
20500006960000,328,171,157,45.5,"MULTIPOLYGON(((6.246600241568462 62.495897737372346,6.233479114907222 62.54025358923524,6.329552030872378 62.54629014125556,6.342533795437713 62.5019229343165,6.246600241568462 62.495897737372346)))"
20550006960000,552,285,267,40.6,"MULTIPOLYGON(((6.342533795437713 62.5019229343165,6.329552030872378 62.54629014125556,6.425668884824575 62.55226098383581,6.438511077777138 62.507882540903005,6.342533795437713 62.5019229343165)))"
20600006960000,270,132,138,42.8,"MULTIPOLYGON(((6.438511077777138 62.507882540903005,6.425668884824575 62.55226098383581,6.521829223888963 62.55816605954362,6.534531637739672 62.51377649995316,6.438511077777138 62.507882540903005)))"
20650006960000,2653,1345,1308,38.4,"MULTIPOLYGON(((6.534531637739672 62.51377649995316,6.521829223888963 62.55816605954362,6.618032593863393 62.56400531153165,6.630595023161374 62.519604754870905,6.534531637739672 62.51377649995316)))"
20700006960000,755,395,360,41,"MULTIPOLYGON(((6.630595023161374 62.519604754870905,6.618032593863393 62.56400531153165,6.714278539230404 62.56977868353964,6.726700780573342 62.525367249644894,6.630595023161374 62.519604754870905)))"
20750006960000,35,21,14,46.9,"MULTIPOLYGON(((6.726700780573342 62.525367249644894,6.714278539230404 62.56977868353964,6.810566603169302 62.57548611989652,6.822848455213719 62.53106392885056,6.726700780573342 62.525367249644894)))"
20800006960000,13,7,6,61.2,"MULTIPOLYGON(((6.822848455213719 62.53106392885056,6.810566603169302 62.57548611989652,6.906896327568382 62.58112756552239,6.919037591039791 62.53669473765211,6.822848455213719 62.53106392885056)))"
20850006960000,214,136,78,48.6,"MULTIPOLYGON(((6.919037591039791 62.53669473765211,6.906896327568382 62.58112756552239,7.00326725303719 62.586702965930655,7.015267730740204 62.54225962180454,6.919037591039791 62.53669473765211)))"
20900006960000,36,18,18,48.8,"MULTIPOLYGON(((7.015267730740204 62.54225962180454,7.00326725303719 62.586702965930655,7.099678918918929 62.59221226722988,7.111538415747261 62.5477585276556,7.015267730740204 62.54225962180454)))"
20950006960000,492,262,230,45.1,"MULTIPOLYGON(((7.111538415747261 62.5477585276556,7.099678918918929 62.59221226722988,7.196130863302916 62.59765541612592,7.207849186249292 62.55319140214787,7.111538415747261 62.5477585276556)))"
21000006960000,18,12,6,44.8,"MULTIPOLYGON(((7.207849186249292 62.55319140214787,7.196130863302916 62.59765541612592,7.292622623037179 62.60303235992373,7.304199581203152 62.55855819282054,7.207849186249292 62.55319140214787)))"
21050006960000,68,41,27,51.1,"MULTIPOLYGON(((7.304199581203152 62.55855819282054,7.292622623037179 62.60303235992373,7.389153733741105 62.60834304652954,7.400589138346796 62.56385884781153,7.304199581203152 62.55855819282054)))"
21100006960000,45,21,24,48.3,"MULTIPOLYGON(((7.400589138346796 62.56385884781153,7.389153733741105 62.60834304652954,7.485723729818219 62.613587424452525,7.497017394211944 62.569093315859284,7.400589138346796 62.56385884781153)))"
21150006960000,196,98,98,44.5,"MULTIPOLYGON(((7.497017394211944 62.569093315859284,7.485723729818219 62.613587424452525,7.582332144469023 62.61876544280691,7.593483884136852 62.57426154630466,7.497017394211944 62.569093315859284)))"
21200006960000,16,8,8,45.4,"MULTIPOLYGON(((7.593483884136852 62.57426154630466,7.582332144469023 62.61876544280691,7.678978509703938 62.62387705131374,7.689988142279129 62.57936348909289,7.593483884136852 62.57426154630466)))"
21250006960000,74,43,31,39.8,"MULTIPOLYGON(((7.689988142279129 62.57936348909289,7.678978509703938 62.62387705131374,7.775662356356355 62.62892220030283,7.786529701628717 62.584399094775364,7.689988142279129 62.57936348909289)))"
21300006960000,2,1,1,0,"MULTIPOLYGON(((7.786529701628717 62.584399094775364,7.775662356356355 62.62892220030283,7.872383214095736 62.63390084071458,7.883108094020878 62.589368314511496,7.786529701628717 62.584399094775364)))"
21450006960000,50,25,25,47.3,"MULTIPOLYGON(((8.0763734995795 62.59910740383333,8.065934075773036 62.643658402631424,8.162763133349651 62.648437229086575,8.17305957076166 62.60387717879416,8.0763734995795 62.59910740383333)))"
21550006960000,11,6,5,50.2,"MULTIPOLYGON(((8.269780591044476 62.6085803785624,8.259627309317475 62.65314935686805,8.356526127726317 62.657794739996184,8.366536086688358 62.61321695736438,8.269780591044476 62.6085803785624)))"
21650006960000,441,225,216,40.2,"MULTIPOLYGON(((8.46332558287903 62.617786870045,8.453459111542644 62.66237333311256,8.550425782663297 62.66688509148173,8.560148603741158 62.62229007206944,8.46332558287903 62.617786870045)))"
21700006960000,1443,734,709,39.5,"MULTIPOLYGON(((8.560148603741158 62.62229007206944,8.550425782663297 62.66688509148173,8.64742566192932 62.67132997099283,8.657004672352056 62.626726519524844,8.560148603741158 62.62229007206944)))"
21750006960000,643,326,317,44.8,"MULTIPOLYGON(((8.657004672352056 62.626726519524844,8.64742566192932 62.67132997099283,8.744458269139827 62.67570792816135,8.753893310755451 62.63109616912197,8.657004672352056 62.626726519524844)))"
21800006960000,68,34,34,46.4,"MULTIPOLYGON(((8.753893310755451 62.63109616912197,8.744458269139827 62.67570792816135,8.841523123066004 62.68001892013069,8.850814039975372 62.63539897819681,8.753893310755451 62.63109616912197)))"
22000006960000,13,5,8,53.4,"MULTIPOLYGON(((9.141763967772311 62.64790594505944,9.132906337726684 62.69254968573064,9.230095346161773 62.69659240095224,9.238808250594118 62.651940977965374,9.141763967772311 62.64790594505944)))"
22050006960000,10,4,6,39.4,"MULTIPOLYGON(((9.238808250594118 62.651940977965374,9.230095346161773 62.69659240095224,9.327314180243725 62.70056794616661,9.335882214547716 62.655908966462846,9.238808250594118 62.651940977965374)))"
22200006960000,2,2,0,0,"MULTIPOLYGON(((9.530117245734969 62.66364365534983,9.521839376025406 62.70831737098929,9.619144760758381 62.7120911744039,9.627277340624188 62.667410279889495,9.530117245734969 62.66364365534983)))"
22350006960000,18,12,6,40.6,"MULTIPOLYGON(((9.821680251424798 62.67474190432599,9.813838654729276 62.71943677756598,9.911226181652324 62.723008504974096,9.918922089686772 62.67830683221048,9.821680251424798 62.67474190432599)))"
22400006960000,74,37,37,50.7,"MULTIPOLYGON(((9.918922089686772 62.67830683221048,9.911226181652324 62.723008504974096,10.008640105556688 62.726512802449584,10.01619019666798 62.68180445693499,9.918922089686772 62.67830683221048)))"
22450006960000,148,72,76,43.1,"MULTIPOLYGON(((10.01619019666798 62.68180445693499,10.008640105556688 62.726512802449584,10.106079933156533 62.72994963543812,10.113484081432507 62.685234744101635,10.01619019666798 62.68180445693499)))"
22500006960000,10,6,4,39.6,"MULTIPOLYGON(((10.113484081432507 62.685234744101635,10.106079933156533 62.72994963543812,10.203545170341581 62.73331897003392,10.210803252226658 62.68859765995809,10.113484081432507 62.685234744101635)))"
23000006960000,5,3,2,49.8,"MULTIPOLYGON(((11.087732135889262 62.715826945812324,11.081793819540557 62.760600281925825,11.17948580598511 62.763292911352494,11.185276951380377 62.71851443513218,11.087732135889262 62.715826945812324)))"
23050006960000,10,5,5,66,"MULTIPOLYGON(((11.185276951380377 62.71851443513218,11.17948580598511 62.763292911352494,11.277197716740583 62.765917712580695,11.28284159395493 62.721134224833165,11.185276951380377 62.71851443513218)))"
23100006960000,24,12,12,50.8,"MULTIPOLYGON(((11.28284159395493 62.721134224833165,11.277197716740583 62.765917712580695,11.374929048995662 62.76847465958151,11.380425563228764 62.72368628900483,11.28284159395493 62.721134224833165)))"
20350006965000,34,18,16,36.5,"MULTIPOLYGON(((5.945528503523549 62.521750259588785,5.931944831587494 62.56606937983146,6.028022398727249 62.572314454935196,6.041466901729539 62.52798358951639,5.945528503523549 62.521750259588785)))"
20400006965000,1095,579,516,41.4,"MULTIPOLYGON(((6.041466901729539 62.52798358951639,6.028022398727249 62.572314454935196,6.1241454713073 62.57849387775768,6.137450588464737 62.534151385790146,6.041466901729539 62.52798358951639)))"
20500006965000,1069,568,501,39.9,"MULTIPOLYGON(((6.233479114907222 62.54025358923524,6.22031359849814 62.58460758886185,6.316526328096801 62.59065552939157,6.329552030872378 62.54629014125556,6.233479114907222 62.54025358923524)))"
20600006965000,1509,812,697,42.5,"MULTIPOLYGON(((6.425668884824575 62.55226098383581,6.412783206538587 62.59663764107398,6.50908377890898 62.60255386622146,6.521829223888963 62.55816605954362,6.425668884824575 62.55226098383581)))"
20650006965000,33,13,20,41.5,"MULTIPOLYGON(((6.521829223888963 62.55816605954362,6.50908377890898 62.60255386622146,6.605427588955628 62.608404147733786,6.618032593863393 62.56400531153165,6.521829223888963 62.55816605954362)))"
20700006965000,206,105,101,41.6,"MULTIPOLYGON(((6.618032593863393 62.56400531153165,6.605427588955628 62.608404147733786,6.701814179100391 62.61418842910033,6.714278539230404 62.56977868353964,6.618032593863393 62.56400531153165)))"
20800006965000,350,193,157,43.4,"MULTIPOLYGON(((6.810566603169302 62.57548611989652,6.798243090451582 62.619906654401944,6.894713862816182 62.62555876831324,6.906896327568382 62.58112756552239,6.810566603169302 62.57548611989652)))"
20850006965000,1135,617,518,42.1,"MULTIPOLYGON(((6.906896327568382 62.58112756552239,6.894713862816182 62.62555876831324,6.99122603471227 62.63114471610441,7.00326725303719 62.586702965930655,6.906896327568382 62.58112756552239)))"
20900006965000,1882,900,982,41.3,"MULTIPOLYGON(((7.00326725303719 62.586702965930655,6.99122603471227 62.63114471610441,7.087779143381459 62.6366644436434,7.099678918918929 62.59221226722988,7.00326725303719 62.586702965930655)))"
20950006965000,1122,558,564,46.2,"MULTIPOLYGON(((7.099678918918929 62.59221226722988,7.087779143381459 62.6366644436434,7.184372724801487 62.64211789739786,7.196130863302916 62.59765541612592,7.099678918918929 62.59221226722988)))"
21000006965000,165,87,78,43.3,"MULTIPOLYGON(((7.196130863302916 62.59765541612592,7.184372724801487 62.64211789739786,7.281006313698885 62.647505024437145,7.292622623037179 62.60303235992373,7.196130863302916 62.59765541612592)))"
21050006965000,174,95,79,43.4,"MULTIPOLYGON(((7.292622623037179 62.60303235992373,7.281006313698885 62.647505024437145,7.377679443561717 62.65282577243423,7.389153733741105 62.60834304652954,7.292622623037179 62.60303235992373)))"
21100006965000,43,24,19,49.6,"MULTIPOLYGON(((7.389153733741105 62.60834304652954,7.377679443561717 62.65282577243423,7.474391646652453 62.6580800896677,7.485723729818219 62.613587424452525,7.389153733741105 62.60834304652954)))"
21150006965000,198,106,92,45.1,"MULTIPOLYGON(((7.485723729818219 62.613587424452525,7.474391646652453 62.6580800896677,7.571142454020899 62.66326792502365,7.582332144469023 62.61876544280691,7.485723729818219 62.613587424452525)))"
21400006965000,24,12,12,49,"MULTIPOLYGON(((7.969140611440846 62.63881292410176,7.958522305557923 62.68335344676378,8.055459058537062 62.68820812741908,8.065934075773036 62.643658402631424,7.969140611440846 62.63881292410176)))"
21450006965000,281,144,137,44.4,"MULTIPOLYGON(((8.065934075773036 62.643658402631424,8.055459058537062 62.68820812741908,8.15243157736359 62.69299603237662,8.162763133349651 62.648437229086575,8.065934075773036 62.643658402631424)))"
21550006965000,13,4,9,44.1,"MULTIPOLYGON(((8.259627309317475 62.65314935686805,8.249439384968891 62.69771711482727,8.346482003178522 62.70237132858415,8.356526127726317 62.657794739996184,8.259627309317475 62.65314935686805)))"
21600006965000,161,79,82,41.6,"MULTIPOLYGON(((8.356526127726317 62.657794739996184,8.346482003178522 62.70237132858415,8.443558952725958 62.70695862808421,8.453459111542644 62.66237333311256,8.356526127726317 62.657794739996184)))"
21650006965000,357,168,189,42.9,"MULTIPOLYGON(((8.453459111542644 62.66237333311256,8.443558952725958 62.70695862808421,8.540669753266409 62.711478968390146,8.550425782663297 62.66688509148173,8.453459111542644 62.66237333311256)))"
21700006965000,2465,1192,1273,46.7,"MULTIPOLYGON(((8.550425782663297 62.66688509148173,8.540669753266409 62.711478968390146,8.637813923390762 62.715932305191856,8.64742566192932 62.67132997099283,8.550425782663297 62.66688509148173)))"
21800006965000,1,1,0,0,"MULTIPOLYGON(((8.744458269139827 62.67570792816135,8.734990980639557 62.72031859480835,8.832200441517058 62.72463779418923,8.841523123066004 62.68001892013069,8.744458269139827 62.67570792816135)))"
21950006965000,17,8,9,52.5,"MULTIPOLYGON(((9.035747641094694 62.68843984019487,9.02671463507899 62.73307475320567,9.124018395718474 62.73719242990829,9.132906337726684 62.69254968573064,9.035747641094694 62.68843984019487)))"
22200006965000,3,2,1,0,"MULTIPOLYGON(((9.521839376025406 62.70831737098929,9.51353314458465 62.75299018020671,9.610984309002648 62.756771184095285,9.619144760758381 62.7120911744039,9.521839376025406 62.70831737098929)))"
22350006965000,20,9,11,46.4,"MULTIPOLYGON(((9.813838654729276 62.71943677756598,9.805970168463634 62.7641308080708,9.903503876496654 62.767709355489366,9.911226181652324 62.723008504974096,9.813838654729276 62.71943677756598)))"
22400006965000,139,75,64,45.3,"MULTIPOLYGON(((9.911226181652324 62.723008504974096,9.903503876496654 62.767709355489366,10.001064110612507 62.77122034582985,10.008640105556688 62.726512802449584,9.911226181652324 62.723008504974096)))"
22450006965000,6,4,2,41.5,"MULTIPOLYGON(((10.008640105556688 62.726512802449584,10.001064110612507 62.77122034582985,10.098650375160451 62.77466374438061,10.106079933156533 62.72994963543812,10.008640105556688 62.726512802449584)))"
23000006965000,8,5,3,35.6,"MULTIPOLYGON(((11.081793819540557 62.760600281925825,11.075835076600113 62.80537301228657,11.17367473617229 62.80807079738884,11.17948580598511 62.763292911352494,11.081793819540557 62.760600281925825)))"
23050006965000,79,42,37,46.7,"MULTIPOLYGON(((11.17948580598511 62.763292911352494,11.17367473617229 62.80807079738884,11.271534417922629 62.81070062532875,11.277197716740583 62.765917712580695,11.17948580598511 62.763292911352494)))"
23100006965000,131,66,65,43.4,"MULTIPOLYGON(((11.277197716740583 62.765917712580695,11.271534417922629 62.81070062532875,11.369413616596896 62.813262469958225,11.374929048995662 62.76847465958151,11.277197716740583 62.765917712580695)))"
23150006965000,8,6,2,63.4,"MULTIPOLYGON(((11.374929048995662 62.76847465958151,11.369413616596896 62.813262469958225,11.467311826311743 62.8157563057957,11.472679299315045 62.770963726989606,11.374929048995662 62.76847465958151)))"
20400006970000,840,420,420,40.1,"MULTIPOLYGON(((6.028022398727249 62.572314454935196,6.014532390053811 62.616643392642025,6.110795299310149 62.62283447625414,6.1241454713073 62.57849387775768,6.028022398727249 62.572314454935196)))"
20450006970000,428,222,206,43.9,"MULTIPOLYGON(((6.1241454713073 62.57849387775768,6.110795299310149 62.62283447625414,6.20710347945429 62.628959728935136,6.22031359849814 62.58460758886185,6.1241454713073 62.57849387775768)))"
20500006970000,228,124,104,45.7,"MULTIPOLYGON(((6.22031359849814 62.58460758886185,6.20710347945429 62.628959728935136,6.303456476253129 62.6350190915674,6.316526328096801 62.59065552939157,6.22031359849814 62.58460758886185)))"
20550006970000,388,198,190,44.5,"MULTIPOLYGON(((6.316526328096801 62.59065552939157,6.303456476253129 62.6350190915674,6.39985383410102 62.641012505618825,6.412783206538587 62.59663764107398,6.316526328096801 62.59065552939157)))"
20600006970000,1239,647,592,40.6,"MULTIPOLYGON(((6.412783206538587 62.59663764107398,6.39985383410102 62.641012505618825,6.496295096031794 62.64693991314499,6.50908377890898 62.60255386622146,6.412783206538587 62.59663764107398)))"
20650006970000,17,9,8,57.1,"MULTIPOLYGON(((6.50908377890898 62.60255386622146,6.496295096031794 62.64693991314499,6.592779803730803 62.65280125679135,6.605427588955628 62.608404147733786,6.50908377890898 62.60255386622146)))"
20700006970000,56,31,25,52.4,"MULTIPOLYGON(((6.605427588955628 62.608404147733786,6.592779803730803 62.65280125679135,6.689307497547079 62.6585964797952,6.701814179100391 62.61418842910033,6.605427588955628 62.608404147733786)))"
20750006970000,134,76,58,48.2,"MULTIPOLYGON(((6.701814179100391 62.61418842910033,6.689307497547079 62.6585964797952,6.785877716505621 62.66432552598792,6.798243090451582 62.619906654401944,6.701814179100391 62.61418842910033)))"
20800006970000,59,34,25,48.3,"MULTIPOLYGON(((6.798243090451582 62.619906654401944,6.785877716505621 62.66432552598792,6.882489998319755 62.66998833979696,6.894713862816182 62.62555876831324,6.798243090451582 62.619906654401944)))"
20850006970000,321,157,164,39.7,"MULTIPOLYGON(((6.894713862816182 62.62555876831324,6.882489998319755 62.66998833979696,6.979143879403593 62.67558486624794,6.99122603471227 62.63114471610441,6.894713862816182 62.62555876831324)))"
20900006970000,251,126,125,39.8,"MULTIPOLYGON(((6.99122603471227 62.63114471610441,6.979143879403593 62.67558486624794,7.075838894884608 62.681115050966646,7.087779143381459 62.6366644436434,6.99122603471227 62.63114471610441)))"
20950006970000,20,10,10,32.4,"MULTIPOLYGON(((7.087779143381459 62.6366644436434,7.075838894884608 62.681115050966646,7.172574578616286 62.686578840181085,7.184372724801487 62.64211789739786,7.087779143381459 62.6366644436434)))"
21000006970000,2,2,0,0,"MULTIPOLYGON(((7.184372724801487 62.64211789739786,7.172574578616286 62.686578840181085,7.269350463190896 62.69197618072344,7.281006313698885 62.647505024437145,7.184372724801487 62.64211789739786)))"
21050006970000,140,69,71,47.5,"MULTIPOLYGON(((7.281006313698885 62.647505024437145,7.269350463190896 62.69197618072344,7.366166079952321 62.69730702003212,7.377679443561717 62.65282577243423,7.281006313698885 62.647505024437145)))"
21100006970000,742,371,371,40.7,"MULTIPOLYGON(((7.377679443561717 62.65282577243423,7.366166079952321 62.69730702003212,7.463020959009036 62.70257130615361,7.474391646652453 62.6580800896677,7.377679443561717 62.65282577243423)))"
21150006970000,247,118,129,39.6,"MULTIPOLYGON(((7.474391646652453 62.6580800896677,7.463020959009036 62.70257130615361,7.559914629247118 62.70776898774452,7.571142454020899 62.66326792502365,7.474391646652453 62.6580800896677)))"
21200006970000,69,35,34,42.9,"MULTIPOLYGON(((7.571142454020899 62.66326792502365,7.559914629247118 62.70776898774452,7.656846618343409 62.71290001407344,7.667931395517255 62.66838922799765,7.571142454020899 62.66326792502365)))"
21250006970000,119,67,52,45.6,"MULTIPOLYGON(((7.667931395517255 62.66838922799765,7.656846618343409 62.71290001407344,7.753816452778728 62.71796433502284,7.764757999805242 62.67344394869648,7.667931395517255 62.66838922799765)))"
21350006970000,116,61,55,48.7,"MULTIPOLYGON(((7.861621794375298 62.678432037840196,7.850823657851198 62.722961901090954,7.947867757689646 62.727892663393696,7.958522305557923 62.68335344676378,7.861621794375298 62.678432037840196)))"
21400006970000,53,26,27,49.8,"MULTIPOLYGON(((7.958522305557923 62.68335344676378,7.947867757689646 62.727892663393696,8.044948275267116 62.732756573666364,8.055459058537062 62.68820812741908,7.958522305557923 62.68335344676378)))"
21450006970000,2,1,1,0,"MULTIPOLYGON(((8.055459058537062 62.68820812741908,8.044948275267116 62.732756573666364,8.142064732414452 62.73755358426559,8.15243157736359 62.69299603237662,8.055459058537062 62.68820812741908)))"
21600006970000,124,66,58,45.1,"MULTIPOLYGON(((8.346482003178522 62.70237132858415,8.33640354711322 62.746946718987296,8.433624942738861 62.751542750945454,8.443558952725958 62.70695862808421,8.346482003178522 62.70237132858415)))"
21650006970000,154,80,74,44.2,"MULTIPOLYGON(((8.443558952725958 62.70695862808421,8.433624942738861 62.751542750945454,8.530880354110568 62.756071698905,8.540669753266409 62.711478968390146,8.443558952725958 62.70695862808421)))"
21700006970000,17,8,9,42.9,"MULTIPOLYGON(((8.540669753266409 62.711478968390146,8.530880354110568 62.756071698905,8.628169297555063 62.76053351835542,8.637813923390762 62.715932305191856,8.540669753266409 62.711478968390146)))"
21750006970000,17,11,6,42.6,"MULTIPOLYGON(((8.637813923390762 62.715932305191856,8.628169297555063 62.76053351835542,8.725491288340223 62.76492816541795,8.734990980639557 62.72031859480835,8.637813923390762 62.715932305191856)))"
22200006970000,68,37,31,44.8,"MULTIPOLYGON(((9.51353314458465 62.75299018020671,9.505198412919993 62.79766208026792,9.6027958492011 62.80145030633555,9.610984309002648 62.756771184095285,9.51353314458465 62.75299018020671)))"
22250006970000,48,27,21,43.6,"MULTIPOLYGON(((9.610984309002648 62.756771184095285,9.6027958492011 62.80145030633555,9.700421430425397 62.80517095632763,9.708463481317917 62.760484738935936,9.610984309002648 62.756771184095285)))"
22400006970000,42,22,20,50,"MULTIPOLYGON(((9.903503876496654 62.767709355489366,9.895755045117099 62.812409381435955,9.993462085097715 62.81592708485453,10.001064110612507 62.77122034582985,9.903503876496654 62.767709355489366)))"
22450006970000,39,20,19,48,"MULTIPOLYGON(((10.001064110612507 62.77122034582985,9.993462085097715 62.81592708485453,10.091195283078203 62.819377068805004,10.098650375160451 62.77466374438061,10.001064110612507 62.77122034582985)))"
22550006970000,5,3,2,44.2,"MULTIPOLYGON(((10.196262173658567 62.778039517081304,10.188954140189832 62.822759299071606,10.286738156741187 62.8260737420943,10.293899008808948 62.78134763052443,10.196262173658567 62.778039517081304)))"
22650006970000,13,6,7,56.2,"MULTIPOLYGON(((10.391560382512946 62.78458805195646,10.384546832233573 62.82932036496981,10.482379665376405 62.832499135453254,10.48924579588648 62.7877607492791,10.391560382512946 62.78458805195646)))"
22700006970000,52,21,31,43.4,"MULTIPOLYGON(((10.48924579588648 62.7877607492791,10.482379665376405 62.832499135453254,10.580236154102742 62.835610021959035,10.586954749275389 62.79086569105063,10.48924579588648 62.7877607492791)))"
22750006970000,7,5,2,27.7,"MULTIPOLYGON(((10.586954749275389 62.79086569105063,10.580236154102742 62.835610021959035,10.6781157955848 62.83865299356234,10.684686742270896 62.79390284648699,10.586954749275389 62.79086569105063)))"
23050006970000,288,152,136,43.4,"MULTIPOLYGON(((11.17367473617229 62.80807079738884,11.16784364407381 62.852848092066736,11.265851602075896 62.855482961978105,11.271534417922629 62.81070062532875,11.17367473617229 62.80807079738884)))"
23100006970000,851,399,452,46.5,"MULTIPOLYGON(((11.271534417922629 62.81070062532875,11.265851602075896 62.855482961978105,11.363879173055352 62.85804971910912,11.369413616596896 62.813262469958225,11.271534417922629 62.81070062532875)))"
20450006975000,60,32,28,48,"MULTIPOLYGON(((6.110795299310149 62.62283447625414,6.097399856194452 62.667173173751706,6.193848543526997 62.673310002089615,6.20710347945429 62.628959728935136,6.110795299310149 62.62283447625414)))"
20500006975000,693,355,338,46,"MULTIPOLYGON(((6.20710347945429 62.628959728935136,6.193848543526997 62.673310002089615,6.290342263133629 62.6793808205784,6.303456476253129 62.6350190915674,6.20710347945429 62.628959728935136)))"
20550006975000,59,30,29,52.2,"MULTIPOLYGON(((6.303456476253129 62.6350190915674,6.290342263133629 62.6793808205784,6.386880557355815 62.6853855704252,6.39985383410102 62.641012505618825,6.303456476253129 62.6350190915674)))"
20650006975000,63,31,32,47.6,"MULTIPOLYGON(((6.496295096031794 62.64693991314499,6.483462967163653 62.6913241934272,6.580089032168033 62.697196631973846,6.592779803730803 62.65280125679135,6.496295096031794 62.64693991314499)))"
20700006975000,890,447,443,42.2,"MULTIPOLYGON(((6.592779803730803 62.65280125679135,6.580089032168033 62.697196631973846,6.676758290632882 62.70300282904898,6.689307497547079 62.6585964797952,6.592779803730803 62.65280125679135)))"
20750006975000,295,160,135,42.5,"MULTIPOLYGON(((6.689307497547079 62.6585964797952,6.676758290632882 62.70300282904898,6.773470279487534 62.708742728232835,6.785877716505621 62.66432552598792,6.689307497547079 62.6585964797952)))"
20800006975000,84,46,38,46.2,"MULTIPOLYGON(((6.785877716505621 62.66432552598792,6.773470279487534 62.708742728232835,6.870224534339176 62.71441627370426,6.882489998319755 62.66998833979696,6.785877716505621 62.66432552598792)))"
20850006975000,64,33,31,43.5,"MULTIPOLYGON(((6.882489998319755 62.66998833979696,6.870224534339176 62.71441627370426,6.967020589485407 62.72002341024273,6.979143879403593 62.67558486624794,6.882489998319755 62.66998833979696)))"
21050006975000,482,232,250,36.7,"MULTIPOLYGON(((7.269350463190896 62.69197618072344,7.257654880290176 62.736445823107466,7.354613453843902 62.74178678379278,7.366166079952321 62.69730702003212,7.269350463190896 62.69197618072344)))"
21100006975000,845,439,406,37.5,"MULTIPOLYGON(((7.366166079952321 62.69730702003212,7.354613453843902 62.74178678379278,7.451611479982698 62.74706106852306,7.463020959009036 62.70257130615361,7.366166079952321 62.69730702003212)))"
21150006975000,6,1,5,37.2,"MULTIPOLYGON(((7.463020959009036 62.70257130615361,7.451611479982698 62.74706106852306,7.548648485415783 62.75226862572394,7.559914629247118 62.70776898774452,7.463020959009036 62.70257130615361)))"
21200006975000,16,8,8,43.5,"MULTIPOLYGON(((7.559914629247118 62.70776898774452,7.548648485415783 62.75226862572394,7.645723995633407 62.757409404435684,7.656846618343409 62.71290001407344,7.559914629247118 62.70776898774452)))"
21250006975000,12,8,4,43.4,"MULTIPOLYGON(((7.656846618343409 62.71290001407344,7.645723995633407 62.757409404435684,7.742837534920179 62.76248335431496,7.753816452778728 62.71796433502284,7.656846618343409 62.71290001407344)))"
21300006975000,72,43,29,46.5,"MULTIPOLYGON(((7.753816452778728 62.71796433502284,7.742837534920179 62.76248335431496,7.839988626368477 62.76749042563694,7.850823657851198 62.722961901090954,7.753816452778728 62.71796433502284)))"
21350006975000,36,23,13,55.7,"MULTIPOLYGON(((7.850823657851198 62.722961901090954,7.839988626368477 62.76749042563694,7.937176791891976 62.772430569296915,7.947867757689646 62.727892663393696,7.850823657851198 62.722961901090954)))"
21400006975000,405,216,189,42.4,"MULTIPOLYGON(((7.947867757689646 62.727892663393696,7.937176791891976 62.772430569296915,8.034401552239217 62.7773037368124,8.044948275267116 62.732756573666364,7.947867757689646 62.727892663393696)))"
21450006975000,839,406,433,44.1,"MULTIPOLYGON(((8.044948275267116 62.732756573666364,8.034401552239217 62.7773037368124,8.131662427007333 62.78210988032481,8.142064732414452 62.73755358426559,8.044948275267116 62.732756573666364)))"
21550006975000,56,28,28,43.5,"MULTIPOLYGON(((8.239216649833965 62.74228364817105,8.22895893465581 62.78684895260125,8.326290592520357 62.79152090703644,8.33640354711322 62.746946718987296,8.239216649833965 62.74228364817105)))"
21600006975000,9,4,5,55.6,"MULTIPOLYGON(((8.33640354711322 62.746946718987296,8.326290592520357 62.79152090703644,8.423656916826868 62.79612569765432,8.433624942738861 62.751542750945454,8.33640354711322 62.746946718987296)))"
21650006975000,80,42,38,52.5,"MULTIPOLYGON(((8.433624942738861 62.751542750945454,8.423656916826868 62.79612569765432,8.521057422705452 62.80066327910995,8.530880354110568 62.756071698905,8.433624942738861 62.751542750945454)))"
21700006975000,280,152,128,43,"MULTIPOLYGON(((8.530880354110568 62.756071698905,8.521057422705452 62.80066327910995,8.61849162420458 62.805133606691065,8.628169297555063 62.76053351835542,8.530880354110568 62.756071698905)))"
21750006975000,9,4,5,47.8,"MULTIPOLYGON(((8.628169297555063 62.76053351835542,8.61849162420458 62.805133606691065,8.715959034305278 62.80953663631992,8.725491288340223 62.76492816541795,8.628169297555063 62.76053351835542)))"
21800006975000,98,51,47,45.2,"MULTIPOLYGON(((8.725491288340223 62.76492816541795,8.715959034305278 62.80953663631992,8.81345916493542 62.8138723245549,8.822845840689256 62.769255596847174,8.725491288340223 62.76492816541795)))"
21850006975000,5,2,3,42,"MULTIPOLYGON(((8.822845840689256 62.769255596847174,8.81345916493542 62.8138723245549,8.910991526984128 62.818140628592204,8.920232467794982 62.77351577003278,8.822845840689256 62.769255596847174)))"
22250006975000,1,1,0,0,"MULTIPOLYGON(((9.6027958492011 62.80145030633555,9.594579244306608 62.84612853847801,9.69235172986819 62.84985630506018,9.700421430425397 62.80517095632763,9.6027958492011 62.80145030633555)))"
22350006975000,208,116,92,40.9,"MULTIPOLYGON(((9.798074661167137 62.808823993419296,9.790152000517677 62.85351633117306,9.88797955756469 62.857108580476876,9.895755045117099 62.812409381435955,9.798074661167137 62.808823993419296)))"
22400006975000,122,59,63,40.4,"MULTIPOLYGON(((9.895755045117099 62.812409381435955,9.88797955756469 62.857108580476876,9.985833901443376 62.8606330172863,9.993462085097715 62.81592708485453,9.895755045117099 62.812409381435955)))"
22450006975000,1050,504,546,45.6,"MULTIPOLYGON(((9.993462085097715 62.81592708485453,9.985833901443376 62.8606330172863,10.083714531727704 62.86408960657191,10.091195283078203 62.819377068805004,9.993462085097715 62.81592708485453)))"
22500006975000,12,8,4,41.2,"MULTIPOLYGON(((10.091195283078203 62.819377068805004,10.083714531727704 62.86408960657191,10.181620947146808 62.86747831396154,10.188954140189832 62.822759299071606,10.091195283078203 62.819377068805004)))"
22550006975000,37,17,20,45.1,"MULTIPOLYGON(((10.188954140189832 62.822759299071606,10.181620947146808 62.86747831396154,10.279552645600416 62.87079910574153,10.286738156741187 62.8260737420943,10.188954140189832 62.822759299071606)))"
22600006975000,10,5,5,44.5,"MULTIPOLYGON(((10.286738156741187 62.8260737420943,10.279552645600416 62.87079910574153,10.377509124174345 62.87405194885813,10.384546832233573 62.82932036496981,10.286738156741187 62.8260737420943)))"
22650006975000,72,30,42,43,"MULTIPOLYGON(((10.384546832233573 62.82932036496981,10.377509124174345 62.87405194885813,10.47548987915603 62.877236810918696,10.482379665376405 62.832499135453254,10.384546832233573 62.82932036496981)))"
22700006975000,120,66,54,43.6,"MULTIPOLYGON(((10.482379665376405 62.832499135453254,10.47548987915603 62.877236810918696,10.573494406050164 62.88035366019301,10.580236154102742 62.835610021959035,10.482379665376405 62.832499135453254)))"
23050006975000,75,42,33,47.4,"MULTIPOLYGON(((11.16784364407381 62.852848092066736,11.161992431176547 62.897624794202684,11.260149173146072 62.900264721420974,11.265851602075896 62.855482961978105,11.16784364407381 62.852848092066736)))"
23400006975000,71,38,33,55.5,"MULTIPOLYGON(((11.85429340915747 62.869860940600475,11.849485627498051 62.91467031283987,11.947769588501794 62.916832025154115,11.952427961634129 62.8720185069834,11.85429340915747 62.869860940600475)))"
20450006980000,10,5,5,28.7,"MULTIPOLYGON(((6.097399856194452 62.667173173751706,6.083958924296981 62.711509962672686,6.180548575095042 62.71765840091087,6.193848543526997 62.673310002089615,6.097399856194452 62.667173173751706)))"
20500006980000,213,110,103,47.2,"MULTIPOLYGON(((6.193848543526997 62.673310002089615,6.180548575095042 62.71765840091087,6.277183475170022 62.723740709172056,6.290342263133629 62.6793808205784,6.193848543526997 62.673310002089615)))"
20550006980000,37,21,16,68.5,"MULTIPOLYGON(((6.290342263133629 62.6793808205784,6.277183475170022 62.723740709172056,6.373863164798426 62.729756828401044,6.386880557355815 62.6853855704252,6.290342263133629 62.6793808205784)))"
20600006980000,259,128,131,51.2,"MULTIPOLYGON(((6.386880557355815 62.6853855704252,6.373863164798426 62.729756828401044,6.470587182874479 62.735706700135026,6.483462967163653 62.6913241934272,6.386880557355815 62.6853855704252)))"
20700006980000,16,10,6,59.1,"MULTIPOLYGON(((6.580089032168033 62.697196631973846,6.567355066922354 62.74159026650591,6.664166353108518 62.74740747024241,6.676758290632882 62.70300282904898,6.580089032168033 62.697196631973846)))"
20750006980000,447,236,211,41.6,"MULTIPOLYGON(((6.676758290632882 62.70300282904898,6.664166353108518 62.74740747024241,6.761020576254188 62.75315825467214,6.773470279487534 62.708742728232835,6.676758290632882 62.70300282904898)))"
20800006980000,56,31,25,52.5,"MULTIPOLYGON(((6.773470279487534 62.708742728232835,6.761020576254188 62.75315825467214,6.857917269847856 62.75884256372379,6.870224534339176 62.71441627370426,6.773470279487534 62.708742728232835)))"
20850006980000,23,11,12,52.7,"MULTIPOLYGON(((6.870224534339176 62.71441627370426,6.857917269847856 62.75884256372379,6.954855966057936 62.76446034192917,6.967020589485407 62.72002341024273,6.870224534339176 62.71441627370426)))"
20900006980000,569,290,279,41.8,"MULTIPOLYGON(((6.967020589485407 62.72002341024273,6.954855966057936 62.76446034192917,7.051836195745541 62.770011534425265,7.063857977926884 62.72556408323039,6.967020589485407 62.72002341024273)))"
20950006980000,6037,2936,3101,43.7,"MULTIPOLYGON(((7.063857977926884 62.72556408323039,7.051836195745541 62.770011534425265,7.14885748847728 62.7754960869563,7.160736231380091 62.7310382386541,7.063857977926884 62.72556408323039)))"
21000006980000,14005,6915,7090,42.4,"MULTIPOLYGON(((7.160736231380091 62.7310382386541,7.14885748847728 62.7754960869563,7.245919372538253 62.78091394587577,7.257654880290176 62.736445823107466,7.160736231380091 62.7310382386541)))"
21050006980000,2190,1112,1078,33.3,"MULTIPOLYGON(((7.257654880290176 62.736445823107466,7.245919372538253 62.78091394587577,7.343021374945049 62.78626505814846,7.354613453843902 62.74178678379278,7.257654880290176 62.736445823107466)))"
21100006980000,246,123,123,42.9,"MULTIPOLYGON(((7.354613453843902 62.74178678379278,7.343021374945049 62.78626505814846,7.440163021458912 62.79154937135238,7.451611479982698 62.74706106852306,7.354613453843902 62.74178678379278)))"
21150006980000,1157,610,547,43.5,"MULTIPOLYGON(((7.451611479982698 62.74706106852306,7.440163021458912 62.79154937135238,7.537343836598964 62.796766833680834,7.548648485415783 62.75226862572394,7.451611479982698 62.74706106852306)))"
21200006980000,610,322,288,39.2,"MULTIPOLYGON(((7.548648485415783 62.75226862572394,7.537343836598964 62.796766833680834,7.634563343655552 62.80191739394425,7.645723995633407 62.757409404435684,7.548648485415783 62.75226862572394)))"
21250006980000,323,154,169,47.2,"MULTIPOLYGON(((7.645723995633407 62.757409404435684,7.634563343655552 62.80191739394425,7.731821064703646 62.80700100157218,7.742837534920179 62.76248335431496,7.645723995633407 62.757409404435684)))"
21300006980000,39,18,21,44.4,"MULTIPOLYGON(((7.742837534920179 62.76248335431496,7.731821064703646 62.80700100157218,7.829116520616379 62.81201760661522,7.839988626368477 62.76749042563694,7.742837534920179 62.76248335431496)))"
21350006980000,50,24,26,43.9,"MULTIPOLYGON(((7.839988626368477 62.76749042563694,7.829116520616379 62.81201760661522,7.92644923107865 62.81696715974684,7.937176791891976 62.772430569296915,7.839988626368477 62.76749042563694)))"
21400006980000,3,1,2,0,"MULTIPOLYGON(((7.937176791891976 62.772430569296915,7.92644923107865 62.81696715974684,8.023818714600829 62.82184961226523,8.034401552239217 62.7773037368124,7.937176791891976 62.772430569296915)))"
21450006980000,346,179,167,47.1,"MULTIPOLYGON(((8.034401552239217 62.7773037368124,8.023818714600829 62.82184961226523,8.121224488532556 62.82666491609527,8.131662427007333 62.78210988032481,8.034401552239217 62.7773037368124)))"
21500006980000,279,146,133,41.4,"MULTIPOLYGON(((8.131662427007333 62.78210988032481,8.121224488532556 62.82666491609527,8.218666069076612 62.83141302379023,8.22895893465581 62.78684895260125,8.131662427007333 62.78210988032481)))"
21550006980000,93,46,47,40.9,"MULTIPOLYGON(((8.22895893465581 62.78684895260125,8.218666069076612 62.83141302379023,8.3161429713029 62.83609388853362,8.326290592520357 62.79152090703644,8.22895893465581 62.78684895260125)))"
21600006980000,17,10,7,35.9,"MULTIPOLYGON(((8.326290592520357 62.79152090703644,8.3161429713029 62.83609388853362,8.41365470916252 62.84070746414095,8.423656916826868 62.79612569765432,8.326290592520357 62.79152090703644)))"
21650006980000,60,30,30,40.1,"MULTIPOLYGON(((8.423656916826868 62.79612569765432,8.41365470916252 62.84070746414095,8.51120079550189 62.84525370506149,8.521057422705452 62.80066327910995,8.423656916826868 62.79612569765432)))"
21700006980000,59,31,28,39.8,"MULTIPOLYGON(((8.521057422705452 62.80066327910995,8.51120079550189 62.84525370506149,8.608780742077005 62.84973256638004,8.61849162420458 62.805133606691065,8.521057422705452 62.80066327910995)))"
21750006980000,144,73,71,47.3,"MULTIPOLYGON(((8.61849162420458 62.805133606691065,8.608780742077005 62.84973256638004,8.70639405956775 62.85414400381863,8.715959034305278 62.80953663631992,8.61849162420458 62.805133606691065)))"
21800006980000,40,24,16,51,"MULTIPOLYGON(((8.715959034305278 62.80953663631992,8.70639405956775 62.85414400381863,8.804040257592298 62.85848797373812,8.81345916493542 62.8138723245549,8.715959034305278 62.80953663631992)))"
22300006980000,6,4,2,23.8,"MULTIPOLYGON(((9.69235172986819 62.84985630506018,9.684254244074625 62.894540782573785,9.782202053324784 62.89820781887618,9.790152000517677 62.85351633117306,9.69235172986819 62.84985630506018)))"
22350006980000,225,109,116,47.1,"MULTIPOLYGON(((9.790152000517677 62.85351633117306,9.782202053324784 62.89820781887618,9.880177283037243 62.901806950258376,9.88797955756469 62.857108580476876,9.790152000517677 62.85351633117306)))"
22450006980000,56,30,26,44,"MULTIPOLYGON(((9.985833901443376 62.8606330172863,9.978179431242594 62.9053381408717,10.076207995104191 62.90880135552639,10.083714531727704 62.86408960657191,9.985833901443376 62.8606330172863)))"
22500006980000,89,40,49,42.1,"MULTIPOLYGON(((10.083714531727704 62.86408960657191,10.076207995104191 62.90880135552639,10.174262470933625 62.9121965596928,10.181620947146808 62.86747831396154,10.083714531727704 62.86408960657191)))"
22550006980000,189,91,98,40.8,"MULTIPOLYGON(((10.181620947146808 62.86747831396154,10.174262470933625 62.9121965596928,10.272342354206268 62.91552371950279,10.279552645600416 62.87079910574153,10.181620947146808 62.86747831396154)))"
22600006980000,81,48,33,38.4,"MULTIPOLYGON(((10.279552645600416 62.87079910574153,10.272342354206268 62.91552371950279,10.3704471395769 62.91878280175103,10.377509124174345 62.87405194885813,10.279552645600416 62.87079910574153)))"
22650006980000,95,54,41,39.4,"MULTIPOLYGON(((10.377509124174345 62.87405194885813,10.3704471395769 62.91878280175103,10.468576320895357 62.921973773896276,10.47548987915603 62.877236810918696,10.377509124174345 62.87405194885813)))"
22700006980000,131,58,73,42.7,"MULTIPOLYGON(((10.47548987915603 62.877236810918696,10.468576320895357 62.921973773896276,10.566729391222296 62.925096604062716,10.573494406050164 62.88035366019301,10.47548987915603 62.877236810918696)))"
22750006980000,11,7,4,48.1,"MULTIPOLYGON(((10.573494406050164 62.88035366019301,10.566729391222296 62.925096604062716,10.664905842844991 62.92815126104112,10.671522199594369 62.88340246561447,10.573494406050164 62.88035366019301)))"
22800006980000,90,49,41,41.6,"MULTIPOLYGON(((10.671522199594369 62.88340246561447,10.664905842844991 62.92815126104112,10.763105167293203 62.93113771429009,10.769572753774934 62.886383196781345,10.671522199594369 62.88340246561447)))"
23000006980000,148,77,71,45.8,"MULTIPOLYGON(((11.063855909059969 62.89491665073409,11.057835281860724 62.93968755628872,11.156120998317054 62.94240090260378,11.161992431176547 62.897624794202684,11.063855909059969 62.89491665073409)))"
23050006980000,249,118,131,43.6,"MULTIPOLYGON(((11.161992431176547 62.897624794202684,11.156120998317054 62.94240090260378,11.254427034444545 62.9450459025407,11.260149173146072 62.900264721420974,11.161992431176547 62.897624794202684)))"
23100006980000,10,6,4,37.2,"MULTIPOLYGON(((11.260149173146072 62.900264721420974,11.254427034444545 62.9450459025407,11.352752877564425 62.947622529589225,11.358325624780715 62.902836406000205,11.260149173146072 62.900264721420974)))"
23350006980000,4,1,3,0,"MULTIPOLYGON(((11.75121830217087 62.91244021371246,11.746244044167357 62.9572448023621,11.844661210071795 62.95947919099669,11.849485627498051 62.91467031283987,11.75121830217087 62.91244021371246)))"
23400006980000,8,2,6,64.4,"MULTIPOLYGON(((11.849485627498051 62.91467031283987,11.844661210071795 62.95947919099669,11.94309509392814 62.96164506190416,11.947769588501794 62.916832025154115,11.849485627498051 62.91467031283987)))"
20600006985000,246,139,107,44.4,"MULTIPOLYGON(((6.373863164798426 62.729756828401044,6.360801443565043 62.77412627240706,6.45766753238719 62.78008742628922,6.470587182874479 62.735706700135026,6.373863164798426 62.729756828401044)))"
20650006985000,196,92,104,50.5,"MULTIPOLYGON(((6.470587182874479 62.735706700135026,6.45766753238719 62.78008742628922,6.554577699314168 62.78598215356685,6.567355066922354 62.74159026650591,6.470587182874479 62.735706700135026)))"
20700006985000,1,0,1,0,"MULTIPOLYGON(((6.567355066922354 62.74159026650591,6.554577699314168 62.78598215356685,6.651531478402532 62.791810396711966,6.664166353108518 62.74740747024241,6.567355066922354 62.74159026650591)))"
20750006985000,13,7,6,44.2,"MULTIPOLYGON(((6.664166353108518 62.74740747024241,6.651531478402532 62.791810396711966,6.748528402352836 62.79757209879798,6.761020576254188 62.75315825467214,6.664166353108518 62.74740747024241)))"
20800006985000,14,9,5,56.8,"MULTIPOLYGON(((6.761020576254188 62.75315825467214,6.748528402352836 62.79757209879798,6.845568002522222 62.8032672035019,6.857917269847856 62.75884256372379,6.761020576254188 62.75315825467214)))"
20850006985000,861,393,468,44.2,"MULTIPOLYGON(((6.857917269847856 62.75884256372379,6.845568002522222 62.8032672035019,6.942649808937201 62.8088956551063,6.954855966057936 62.76446034192917,6.857917269847856 62.75884256372379)))"
20900006985000,1379,702,677,33.1,"MULTIPOLYGON(((6.954855966057936 62.76446034192917,6.942649808937201 62.8088956551063,7.039773350306465 62.81445739850148,7.051836195745541 62.770011534425265,6.954855966057936 62.76446034192917)))"
20950006985000,359,181,178,42.5,"MULTIPOLYGON(((7.051836195745541 62.770011534425265,7.039773350306465 62.81445739850148,7.136938154033828 62.81995237918752,7.14885748847728 62.7754960869563,7.051836195745541 62.770011534425265)))"
21000006985000,420,215,205,42.7,"MULTIPOLYGON(((7.14885748847728 62.7754960869563,7.136938154033828 62.81995237918752,7.234143746231278 62.82538054327636,7.245919372538253 62.78091394587577,7.14885748847728 62.7754960869563)))"
21050006985000,596,306,290,40.2,"MULTIPOLYGON(((7.245919372538253 62.78091394587577,7.234143746231278 62.82538054327636,7.331389651732104 62.83074183749371,7.343021374945049 62.78626505814846,7.245919372538253 62.78091394587577)))"
21200006985000,94,46,48,45.7,"MULTIPOLYGON(((7.537343836598964 62.796766833680834,7.526000495663054 62.84126360629829,7.623364477485882 62.84642397742416,7.634563343655552 62.80191739394425,7.537343836598964 62.796766833680834)))"
21250006985000,153,86,67,36.8,"MULTIPOLYGON(((7.634563343655552 62.80191739394425,7.623364477485882 62.84642397742416,7.720766859424432 62.85151727175984,7.731821064703646 62.80700100157218,7.634563343655552 62.80191739394425)))"
21300006985000,134,65,69,42.3,"MULTIPOLYGON(((7.731821064703646 62.80700100157218,7.720766859424432 62.85151727175984,7.818207160118981 62.8565434391299,7.829116520616379 62.81201760661522,7.731821064703646 62.80700100157218)))"
21350006985000,28,14,14,42.6,"MULTIPOLYGON(((7.829116520616379 62.81201760661522,7.818207160118981 62.8565434391299,7.915684897011956 62.86150242998456,7.92644923107865 62.81696715974684,7.829116520616379 62.81201760661522)))"
21400006985000,1,1,0,0,"MULTIPOLYGON(((7.92644923107865 62.81696715974684,7.915684897011956 62.86150242998456,8.013199586361758 62.86639419540142,8.023818714600829 62.82184961226523,7.92644923107865 62.81696715974684)))"
21450006985000,93,50,43,43.3,"MULTIPOLYGON(((8.023818714600829 62.82184961226523,8.013199586361758 62.86639419540142,8.110750743256634 62.87121868708744,8.121224488532556 62.82666491609527,8.023818714600829 62.82184961226523)))"
21500006985000,139,75,64,49.4,"MULTIPOLYGON(((8.121224488532556 62.82666491609527,8.110750743256634 62.87121868708744,8.208337881628706 62.87597585738066,8.218666069076612 62.83141302379023,8.121224488532556 62.82666491609527)))"
21550006985000,214,108,106,46.7,"MULTIPOLYGON(((8.218666069076612 62.83141302379023,8.208337881628706 62.87597585738066,8.305960514268007 62.88066565925207,8.3161429713029 62.83609388853362,8.218666069076612 62.83141302379023)))"
21600006985000,61,26,35,35.3,"MULTIPOLYGON(((8.3161429713029 62.83609388853362,8.305960514268007 62.88066565925207,8.403618152836682 62.885288046307416,8.41365470916252 62.84070746414095,8.3161429713029 62.83609388853362)))"
21650006985000,63,29,34,44.6,"MULTIPOLYGON(((8.41365470916252 62.84070746414095,8.403618152836682 62.885288046307416,8.501310307883228 62.88984297278899,8.51120079550189 62.84525370506149,8.41365470916252 62.84070746414095)))"
21700006985000,433,216,217,41.8,"MULTIPOLYGON(((8.51120079550189 62.84525370506149,8.501310307883228 62.88984297278899,8.59903648885685 62.89433039357727,8.608780742077005 62.84973256638004,8.51120079550189 62.84525370506149)))"
21750006985000,111,59,52,40.5,"MULTIPOLYGON(((8.608780742077005 62.84973256638004,8.59903648885685 62.89433039357727,8.696796204121885 62.89875026419276,8.70639405956775 62.85414400381863,8.608780742077005 62.84973256638004)))"
22300006985000,84,45,39,49.9,"MULTIPOLYGON(((9.684254244074625 62.894540782573785,9.676128836582325 62.93922438629034,9.774224685522478 62.94289845405518,9.782202053324784 62.89820781887618,9.684254244074625 62.894540782573785)))"
22350006985000,51,30,21,49.1,"MULTIPOLYGON(((9.782202053324784 62.89820781887618,9.774224685522478 62.94289845405518,9.872348089872364 62.946504488409715,9.880177283037243 62.901806950258376,9.782202053324784 62.89820781887618)))"
22500006985000,89,45,44,39.9,"MULTIPOLYGON(((10.076207995104191 62.90880135552639,10.068675546373468 62.95351231349787,10.166878587140458 62.95691403419219,10.174262470933625 62.9121965596928,10.076207995104191 62.90880135552639)))"
22550006985000,806,403,403,43.1,"MULTIPOLYGON(((10.174262470933625 62.9121965596928,10.166878587140458 62.95691403419219,10.26510716057998 62.96024758140032,10.272342354206268 62.91552371950279,10.174262470933625 62.9121965596928)))"
22600006985000,181,94,87,41.2,"MULTIPOLYGON(((10.272342354206268 62.91552371950279,10.26510716057998 62.96024758140032,10.363360758900097 62.9635129217644,10.3704471395769 62.91878280175103,10.272342354206268 62.91552371950279)))"
22650006985000,9,4,5,42.1,"MULTIPOLYGON(((10.3704471395769 62.91878280175103,10.363360758900097 62.9635129217644,10.4616388734973 62.9667100225937,10.468576320895357 62.921973773896276,10.3704471395769 62.91878280175103)))"
22700006985000,72,33,39,46.5,"MULTIPOLYGON(((10.468576320895357 62.921973773896276,10.4616388734973 62.9667100225937,10.559940994972418 62.96983885186583,10.566729391222296 62.925096604062716,10.468576320895357 62.921973773896276)))"
22750006985000,240,123,117,43.1,"MULTIPOLYGON(((10.566729391222296 62.925096604062716,10.559940994972418 62.96983885186583,10.658266613146498 62.972899378227986,10.664905842844991 62.92815126104112,10.566729391222296 62.925096604062716)))"
22800006985000,389,201,188,44.2,"MULTIPOLYGON(((10.664905842844991 62.92815126104112,10.658266613146498 62.972899378227986,10.756615217076847 62.97589157099828,10.763105167293203 62.93113771429009,10.664905842844991 62.92815126104112)))"
22850006985000,27,15,12,43.3,"MULTIPOLYGON(((10.763105167293203 62.93113771429009,10.756615217076847 62.97589157099828,10.85498629507306 62.97881540016677,10.8613268553551 62.934055933937245,10.763105167293203 62.93113771429009)))"
22900006985000,46,23,23,48.2,"MULTIPOLYGON(((10.8613268553551 62.934055933937245,10.85498629507306 62.97881540016677,10.953379334713151 62.98167083639683,10.959570397093266 62.93690589078041,10.8613268553551 62.934055933937245)))"
22950006985000,46,21,25,50.6,"MULTIPOLYGON(((10.959570397093266 62.93690589078041,10.953379334713151 62.98167083639683,11.051793822859729 62.984457851026136,11.057835281860724 62.93968755628872,10.959570397093266 62.93690589078041)))"
23000006985000,35,16,19,55.7,"MULTIPOLYGON(((11.057835281860724 62.93968755628872,11.051793822859729 62.984457851026136,11.150229245676215 62.987176416067875,11.156120998317054 62.94240090260378,11.057835281860724 62.93968755628872)))"
23050006985000,8,4,4,45.1,"MULTIPOLYGON(((11.156120998317054 62.94240090260378,11.150229245676215 62.987176416067875,11.248685088643162 62.98982650421184,11.254427034444545 62.9450459025407,11.156120998317054 62.94240090260378)))"
23100006985000,28,15,13,52.1,"MULTIPOLYGON(((11.254427034444545 62.9450459025407,11.248685088643162 62.98982650421184,11.347160836574579 62.99240808882549,11.352752877564425 62.947622529589225,11.254427034444545 62.9450459025407)))"
23300006985000,14,8,6,40.6,"MULTIPOLYGON(((11.647844112516593 62.95494191844218,11.642702348642539 62.9997415653456,11.741252551816391 63.002048883101715,11.746244044167357 62.9572448023621,11.647844112516593 62.95494191844218)))"
23350006985000,6,4,2,66.8,"MULTIPOLYGON(((11.746244044167357 62.9572448023621,11.741252551816391 63.002048883101715,11.839820074602606 63.00428757436545,11.844661210071795 62.95947919099669,11.746244044167357 62.9572448023621)))"
20650006990000,448,245,203,45.1,"MULTIPOLYGON(((6.45766753238719 62.78008742628922,6.444703803566981 62.82446636486388,6.541756719318579 62.830372286290356,6.554577699314168 62.78598215356685,6.45766753238719 62.78008742628922)))"
20700006990000,28,13,15,64.8,"MULTIPOLYGON(((6.554577699314168 62.78598215356685,6.541756719318579 62.830372286290356,6.638853458610715 62.836211601749476,6.651531478402532 62.791810396711966,6.554577699314168 62.78598215356685)))"
20800006990000,515,249,266,42.1,"MULTIPOLYGON(((6.748528402352836 62.79757209879798,6.735993552010612 62.84198425405887,6.833176528731361 62.84769018664223,6.845568002522222 62.8032672035019,6.748528402352836 62.79757209879798)))"
20850006990000,1029,540,489,42.8,"MULTIPOLYGON(((6.845568002522222 62.8032672035019,6.833176528731361 62.84769018664223,6.930401916644703 62.853329343531385,6.942649808937201 62.8088956551063,6.845568002522222 62.8032672035019)))"
20900006990000,317,161,156,43.4,"MULTIPOLYGON(((6.942649808937201 62.8088956551063,6.930401916644703 62.853329343531385,7.027669242293977 62.85890166936846,7.039773350306465 62.81445739850148,6.942649808937201 62.8088956551063)))"
20950006990000,940,473,467,40.8,"MULTIPOLYGON(((7.039773350306465 62.81445739850148,7.027669242293977 62.85890166936846,7.124978030907172 62.864407109407814,7.136938154033828 62.81995237918752,7.039773350306465 62.81445739850148)))"
21000006990000,2870,1403,1467,41.2,"MULTIPOLYGON(((7.136938154033828 62.81995237918752,7.124978030907172 62.864407109407814,7.222327806410016 62.86984560951832,7.234143746231278 62.82538054327636,7.136938154033828 62.81995237918752)))"
21050006990000,625,311,314,38.8,"MULTIPOLYGON(((7.234143746231278 62.82538054327636,7.222327806410016 62.86984560951832,7.319718091439265 62.87521711618522,7.331389651732104 62.83074183749371,7.234143746231278 62.82538054327636)))"
21150006990000,41,23,18,30.9,"MULTIPOLYGON(((7.428675394104129 62.83603620918121,7.417148407355995 62.88052157651216,7.514618274259043 62.88575893822332,7.526000495663054 62.84126360629829,7.428675394104129 62.83603620918121)))"
21200006990000,83,45,38,36.9,"MULTIPOLYGON(((7.526000495663054 62.84126360629829,7.514618274259043 62.88575893822332,7.612127210998554 62.89092914966524,7.623364477485882 62.84642397742416,7.526000495663054 62.84126360629829)))"
21250006990000,407,184,223,44,"MULTIPOLYGON(((7.623364477485882 62.84642397742416,7.612127210998554 62.89092914966524,7.70967473518958 62.8960321598089,7.720766859424432 62.85151727175984,7.623364477485882 62.84642397742416)))"
21300006990000,11,5,6,46.7,"MULTIPOLYGON(((7.720766859424432 62.85151727175984,7.70967473518958 62.8960321598089,7.807260363225813 62.901067918251535,7.818207160118981 62.8565434391299,7.720766859424432 62.85151727175984)))"
21350006990000,126,60,66,43.3,"MULTIPOLYGON(((7.818207160118981 62.8565434391299,7.807260363225813 62.901067918251535,7.904883610293421 62.90603637521867,7.915684897011956 62.86150242998456,7.818207160118981 62.8565434391299)))"
21400006990000,66,39,27,44.3,"MULTIPOLYGON(((7.915684897011956 62.86150242998456,7.904883610293421 62.90603637521867,8.00254399038491 62.91093748156594,8.013199586361758 62.86639419540142,7.915684897011956 62.86150242998456)))"
21450006990000,250,143,107,40.8,"MULTIPOLYGON(((8.013199586361758 62.86639419540142,8.00254399038491 62.91093748156594,8.100241016313179 62.91577118878096,8.110750743256634 62.87121868708744,8.013199586361758 62.86639419540142)))"
21500006990000,692,353,339,44.2,"MULTIPOLYGON(((8.110750743256634 62.87121868708744,8.100241016313179 62.91577118878096,8.19797419972558 62.92053744898522,8.208337881628706 62.87597585738066,8.110750743256634 62.87121868708744)))"
21550006990000,438,206,232,45.9,"MULTIPOLYGON(((8.208337881628706 62.87597585738066,8.19797419972558 62.92053744898522,8.295743051118125 62.925236214935886,8.305960514268007 62.88066565925207,8.208337881628706 62.87597585738066)))"
21600006990000,25,10,15,55.7,"MULTIPOLYGON(((8.305960514268007 62.88066565925207,8.295743051118125 62.925236214935886,8.393547079849746 62.929867440027614,8.403618152836682 62.885288046307416,8.305960514268007 62.88066565925207)))"
21650006990000,147,81,66,44.9,"MULTIPOLYGON(((8.403618152836682 62.885288046307416,8.393547079849746 62.929867440027614,8.491385794156676 62.93443107829431,8.501310307883228 62.88984297278899,8.403618152836682 62.885288046307416)))"
21700006990000,132,68,64,41.3,"MULTIPOLYGON(((8.501310307883228 62.88984297278899,8.491385794156676 62.93443107829431,8.589258701166898 62.93892708441091,8.59903648885685 62.89433039357727,8.501310307883228 62.88984297278899)))"
21750006990000,114,59,55,40.1,"MULTIPOLYGON(((8.59903648885685 62.89433039357727,8.589258701166898 62.93892708441091,8.687165306914668 62.94335541369521,8.696796204121885 62.89875026419276,8.59903648885685 62.89433039357727)))"
21800006990000,93,48,45,40.7,"MULTIPOLYGON(((8.696796204121885 62.89875026419276,8.687165306914668 62.94335541369521,8.785105116355181 62.94771602210936,8.794588960972304 62.90310254079768,8.696796204121885 62.89875026419276)))"
22300006990000,221,115,106,46.6,"MULTIPOLYGON(((9.676128836582325 62.93922438629034,9.667975370030911 62.98390711361331,9.766219762162121 62.98758823421876,9.774224685522478 62.94289845405518,9.676128836582325 62.93922438629034)))"
22350006990000,97,56,41,47.4,"MULTIPOLYGON(((9.774224685522478 62.94289845405518,9.766219762162121 62.98758823421876,9.864491845540394 62.99120119254314,9.872348089872364 62.946504488409715,9.774224685522478 62.94289845405518)))"
22550006990000,305,160,145,39.7,"MULTIPOLYGON(((10.166878587140458 62.95691403419219,10.159469170536857 63.001630735371286,10.257846941937839 63.00497068944181,10.26510716057998 62.96024758140032,10.166878587140458 62.95691403419219)))"
22600006990000,49,23,26,42.2,"MULTIPOLYGON(((10.26510716057998 62.96024758140032,10.257846941937839 63.00497068944181,10.356249861813582 63.00824230700025,10.363360758900097 62.9635129217644,10.26510716057998 62.96024758140032)))"
22650006990000,25,14,11,50.7,"MULTIPOLYGON(((10.363360758900097 62.9635129217644,10.356249861813582 63.00824230700025,10.454677419091379 63.01144555520535,10.4616388734973 62.9667100225937,10.363360758900097 62.9635129217644)))"
22700006990000,175,92,83,44.6,"MULTIPOLYGON(((10.4616388734973 62.9667100225937,10.454677419091379 63.01144555520535,10.553129101896275 63.01458040188722,10.559940994972418 62.96983885186583,10.4616388734973 62.9667100225937)))"
22750006990000,74,37,37,38,"MULTIPOLYGON(((10.559940994972418 62.96983885186583,10.553129101896275 63.01458040188722,10.651604397567118 63.01764681554862,10.658266613146498 62.972899378227986,10.559940994972418 62.96983885186583)))"
22900006990000,8,4,4,41.9,"MULTIPOLYGON(((10.85498629507306 62.97881540016677,10.848623773027903 63.023574221191645,10.947166823710024 63.02643515355297,10.953379334713151 62.98167083639683,10.85498629507306 62.97881540016677)))"
23250006990000,35,18,17,49.4,"MULTIPOLYGON(((11.54416998335266 62.997365644326095,11.538859680175085 63.04216019003701,11.63754274678718 63.04454068997606,11.642702348642539 62.9997415653456,11.54416998335266 62.997365644326095)))"
23300006990000,268,123,145,47.4,"MULTIPOLYGON(((11.642702348642539 62.9997415653456,11.63754274678718 63.04454068997606,11.7362437397585 63.046852455154074,11.741252551816391 63.002048883101715,11.642702348642539 62.9997415653456)))"
20700006995000,14,7,7,60.3,"MULTIPOLYGON(((6.541756719318579 62.830372286290356,6.52889191555465 62.8747606577641,6.626132084485428 62.88061107860173,6.638853458610715 62.836211601749476,6.541756719318579 62.830372286290356)))"
20800006995000,14,7,7,51.6,"MULTIPOLYGON(((6.735993552010612 62.84198425405887,6.723415818123991 62.88639471385918,6.820742643526506 62.892111506705334,6.833176528731361 62.84769018664223,6.735993552010612 62.84198425405887)))"
20900006995000,421,223,198,43.7,"MULTIPOLYGON(((6.930401916644703 62.853329343531385,6.918112086397036 62.89776140091966,7.015523671100543 62.90334434089449,7.027669242293977 62.85890166936846,6.930401916644703 62.853329343531385)))"
20950006995000,63,29,34,37.8,"MULTIPOLYGON(((7.027669242293977 62.85890166936846,7.015523671100543 62.90334434089449,7.11297692067602 62.9088602716371,7.124978030907172 62.864407109407814,7.027669242293977 62.85890166936846)))"
21000006995000,42,24,18,47.3,"MULTIPOLYGON(((7.124978030907172 62.864407109407814,7.11297692067602 62.9088602716371,7.210471356849742 62.91430913877164,7.222327806410016 62.86984560951832,7.124978030907172 62.864407109407814)))"
21050006995000,31,19,12,42.5,"MULTIPOLYGON(((7.222327806410016 62.86984560951832,7.210471356849742 62.91430913877164,7.308006500048579 62.91969088854133,7.319718091439265 62.87521711618522,7.222327806410016 62.86984560951832)))"
21100006995000,404,215,189,40.7,"MULTIPOLYGON(((7.319718091439265 62.87521711618522,7.308006500048579 62.91969088854133,7.405581869413423 62.925005467810486,7.417148407355995 62.88052157651216,7.319718091439265 62.87521711618522)))"
21150006995000,1611,800,811,41.8,"MULTIPOLYGON(((7.417148407355995 62.88052157651216,7.405581869413423 62.925005467810486,7.503196982812729 62.9302528240665,7.514618274259043 62.88575893822332,7.417148407355995 62.88052157651216)))"
21200006995000,171,86,85,38.9,"MULTIPOLYGON(((7.514618274259043 62.88575893822332,7.503196982812729 62.9302528240665,7.600851356856153 62.93543290542176,7.612127210998554 62.89092914966524,7.514618274259043 62.88575893822332)))"
21250006995000,432,225,207,44.5,"MULTIPOLYGON(((7.612127210998554 62.89092914966524,7.600851356856153 62.93543290542176,7.698544506908255 62.9405456606158,7.70967473518958 62.8960321598089,7.612127210998554 62.89092914966524)))"
21300006995000,249,128,121,37.6,"MULTIPOLYGON(((7.70967473518958 62.8960321598089,7.698544506908255 62.9405456606158,7.796275947102346 62.94559103901706,7.807260363225813 62.901067918251535,7.70967473518958 62.8960321598089)))"
21350006995000,384,200,184,40.5,"MULTIPOLYGON(((7.807260363225813 62.901067918251535,7.796275947102346 62.94559103901706,7.894045190354388 62.95056899062497,7.904883610293421 62.90603637521867,7.807260363225813 62.901067918251535)))"
21450006995000,148,79,69,47.5,"MULTIPOLYGON(((8.00254399038491 62.91093748156594,7.991851748377026 62.95547946607178,8.089695131693693 62.96032241662441,8.100241016313179 62.91577118878096,8.00254399038491 62.91093748156594)))"
21500006995000,135,73,62,46.1,"MULTIPOLYGON(((8.100241016313179 62.91577118878096,8.089695131693693 62.96032241662441,8.187574849652803 62.96509779418643,8.19797419972558 62.92053744898522,8.100241016313179 62.91577118878096)))"
21550006995000,114,58,56,47,"MULTIPOLYGON(((8.19797419972558 62.92053744898522,8.187574849652803 62.96509779418643,8.28549041044205 62.969805551299814,8.295743051118125 62.925236214935886,8.19797419972558 62.92053744898522)))"
21600006995000,72,36,36,40.9,"MULTIPOLYGON(((8.295743051118125 62.925236214935886,8.28549041044205 62.969805551299814,8.383441321102795 62.97444564114678,8.393547079849746 62.929867440027614,8.295743051118125 62.925236214935886)))"
21650006995000,20,8,12,39,"MULTIPOLYGON(((8.393547079849746 62.929867440027614,8.383441321102795 62.97444564114678,8.481427087544553 62.979018017551574,8.491385794156676 62.93443107829431,8.393547079849746 62.929867440027614)))"
21700006995000,80,42,38,48.6,"MULTIPOLYGON(((8.491385794156676 62.93443107829431,8.481427087544553 62.979018017551574,8.579447214559536 62.98352263498233,8.589258701166898 62.93892708441091,8.491385794156676 62.93443107829431)))"
21750006995000,408,212,196,45.3,"MULTIPOLYGON(((8.589258701166898 62.93892708441091,8.579447214559536 62.98352263498233,8.677501205837316 62.987959448552694,8.687165306914668 62.94335541369521,8.589258701166898 62.93892708441091)))"
21800006995000,2663,1280,1383,43.7,"MULTIPOLYGON(((8.687165306914668 62.94335541369521,8.677501205837316 62.987959448552694,8.775588563979573 62.992328414023646,8.785105116355181 62.94771602210936,8.687165306914668 62.94335541369521)))"
21850006995000,119,59,60,44.2,"MULTIPOLYGON(((8.785105116355181 62.94771602210936,8.775588563979573 62.992328414023646,8.873708790514907 62.996629487805215,8.88307763337925 62.95200886626181,8.785105116355181 62.94771602210936)))"
21900006995000,209,123,86,42.4,"MULTIPOLYGON(((8.88307763337925 62.95200886626181,8.873708790514907 62.996629487805215,8.97186138591377 63.000862626958074,8.981082360828113 62.95623390340883,8.88307763337925 62.95200886626181)))"
21950006995000,34,14,20,40.6,"MULTIPOLYGON(((8.981082360828113 62.95623390340883,8.97186138591377 63.000862626958074,9.070045849603439 63.0050277891953,9.079118800508326 62.960391091456174,8.981082360828113 62.95623390340883)))"
22150006995000,33,20,13,43.9,"MULTIPOLYGON(((9.373413395796948 62.972455149834545,9.364785429359895 63.01711500136348,9.463092340151828 63.02100784617289,9.471571682299587 62.97634053358753,9.373413395796948 62.972455149834545)))"
22200006995000,3,0,3,0,"MULTIPOLYGON(((9.471571682299587 62.97634053358753,9.463092340151828 63.02100784617289,9.561428601254143 63.02483251247398,9.56975917507244 62.98015786756841,9.471571682299587 62.97634053358753)))"
22300006995000,397,200,197,46.4,"MULTIPOLYGON(((9.667975370030911 62.98390711361331,9.659793706154629 63.028588961927554,9.758187147405165 63.03227715685776,9.766219762162121 62.98758823421876,9.667975370030911 62.98390711361331)))"
22350006995000,5,3,2,46.2,"MULTIPOLYGON(((9.766219762162121 62.98758823421876,9.758187147405165 63.03227715685776,9.85660841663731 63.03589706025357,9.864491845540394 62.99120119254314,9.766219762162121 62.98758823421876)))"
22550006995000,49,25,24,44.9,"MULTIPOLYGON(((10.159469170536857 63.001630735371286,10.152034095065005 63.04634666112639,10.250561574684559 63.04969304162036,10.257846941937839 63.00497068944181,10.159469170536857 63.001630735371286)))"
22600006995000,2283,1159,1124,41.5,"MULTIPOLYGON(((10.257846941937839 63.00497068944181,10.250561574684559 63.04969304162036,10.349114327191307 63.052970955546506,10.356249861813582 63.00824230700025,10.257846941937839 63.00497068944181)))"
22650006995000,114,63,51,45.9,"MULTIPOLYGON(((10.356249861813582 63.00824230700025,10.349114327191307 63.052970955546506,10.44769183902733 63.05618036991216,10.454677419091379 63.01144555520535,10.356249861813582 63.00824230700025)))"
23150006995000,21,10,11,48.9,"MULTIPOLYGON(((11.34154940635077 63.037193082649914,11.335918490798898 63.08197750999489,11.43471518035275 63.08450026313384,11.440195060154167 63.03971097935924,11.34154940635077 63.037193082649914)))"
23200006995000,93,52,41,45.1,"MULTIPOLYGON(((11.440195060154167 63.03971097935924,11.43471518035275 63.08450026313384,11.533530930305403 63.08695419856999,11.538859680175085 63.04216019003701,11.440195060154167 63.03971097935924)))"
23250006995000,68,33,35,56.6,"MULTIPOLYGON(((11.538859680175085 63.04216019003701,11.533530930305403 63.08695419856999,11.632365218474446 63.08933929148168,11.63754274678718 63.04454068997606,11.538859680175085 63.04216019003701)))"
23300006995000,163,95,68,45.2,"MULTIPOLYGON(((11.63754274678718 63.04454068997606,11.632365218474446 63.08933929148168,11.73121752206684 63.09165551773525,11.7362437397585 63.046852455154074,11.63754274678718 63.04454068997606)))"
20850007000000,362,170,192,47.2,"MULTIPOLYGON(((6.820742643526506 62.892111506705334,6.808266140630454 62.93653115720842,6.905780114095396 62.94219182094394,6.918112086397036 62.89776140091966,6.820742643526506 62.892111506705334)))"
20900007000000,836,423,413,42.9,"MULTIPOLYGON(((6.918112086397036 62.89776140091966,6.905780114095396 62.94219182094394,7.00333643481633 62.94778540690656,7.015523671100543 62.90334434089449,6.918112086397036 62.89776140091966)))"
20950007000000,235,134,101,41.9,"MULTIPOLYGON(((7.015523671100543 62.90334434089449,7.00333643481633 62.94778540690656,7.100934623630054 62.95331185985479,7.11297692067602 62.9088602716371,7.015523671100543 62.90334434089449)))"
21000007000000,165,88,77,41.2,"MULTIPOLYGON(((7.11297692067602 62.9088602716371,7.100934623630054 62.95331185985479,7.198574200050024 62.958771125166685,7.210471356849742 62.91430913877164,7.11297692067602 62.9088602716371)))"
21050007000000,77,41,36,36.8,"MULTIPOLYGON(((7.210471356849742 62.91430913877164,7.198574200050024 62.958771125166685,7.296254682279802 62.96416314884193,7.308006500048579 62.91969088854133,7.210471356849742 62.91430913877164)))"
21100007000000,447,244,203,38.8,"MULTIPOLYGON(((7.308006500048579 62.91969088854133,7.296254682279802 62.96416314884193,7.393975587226572 62.969487877503916,7.405581869413423 62.925005467810486,7.308006500048579 62.91969088854133)))"
21150007000000,380,197,183,41.3,"MULTIPOLYGON(((7.405581869413423 62.925005467810486,7.393975587226572 62.969487877503916,7.491736430514784 62.97474525840175,7.503196982812729 62.9302528240665,7.405581869413423 62.925005467810486)))"
21200007000000,280,137,143,44.9,"MULTIPOLYGON(((7.503196982812729 62.9302528240665,7.491736430514784 62.97474525840175,7.589536726499857 62.979935239412306,7.600851356856153 62.93543290542176,7.503196982812729 62.9302528240665)))"
21250007000000,274,142,132,42.6,"MULTIPOLYGON(((7.600851356856153 62.93543290542176,7.589536726499857 62.979935239412306,7.687375988282053 62.985057769042115,7.698544506908255 62.9405456606158,7.600851356856153 62.93543290542176)))"
21300007000000,96,53,43,46.3,"MULTIPOLYGON(((7.698544506908255 62.9405456606158,7.687375988282053 62.985057769042115,7.785253727720363 62.990112796429436,7.796275947102346 62.94559103901706,7.698544506908255 62.9405456606158)))"
21350007000000,176,94,82,43.1,"MULTIPOLYGON(((7.796275947102346 62.94559103901706,7.785253727720363 62.990112796429436,7.883169455446552 62.99510027134616,7.894045190354388 62.95056899062497,7.796275947102346 62.94559103901706)))"
21400007000000,57,28,29,44.2,"MULTIPOLYGON(((7.894045190354388 62.95056899062497,7.883169455446552 62.99510027134616,7.98112268087928 63.00002014419975,7.991851748377026 62.95547946607178,7.894045190354388 62.95056899062497)))"
21450007000000,56,30,26,42.4,"MULTIPOLYGON(((7.991851748377026 62.95547946607178,7.98112268087928 63.00002014419975,8.07911291223831 63.004872366035066,8.089695131693693 62.96032241662441,7.991851748377026 62.95547946607178)))"
21550007000000,106,55,51,50.2,"MULTIPOLYGON(((8.187574849652803 62.96509779418643,8.177139656558825 63.009656888536334,8.275202419705822 63.01437366402898,8.28549041044205 62.969805551299814,8.187574849652803 62.96509779418643)))"
21600007000000,138,71,67,46.3,"MULTIPOLYGON(((8.28549041044205 62.969805551299814,8.275202419705822 63.01437366402898,8.373300706388617 63.01902264548147,8.383441321102795 62.97444564114678,8.28549041044205 62.969805551299814)))"
21650007000000,69,35,34,44.7,"MULTIPOLYGON(((8.383441321102795 62.97444564114678,8.373300706388617 63.01902264548147,8.471434020175431 63.023603786507074,8.481427087544553 62.979018017551574,8.383441321102795 62.97444564114678)))"
21700007000000,129,75,54,48.5,"MULTIPOLYGON(((8.481427087544553 62.979018017551574,8.471434020175431 63.023603786507074,8.56960186350806 63.02811704136573,8.579447214559536 62.98352263498233,8.481427087544553 62.979018017551574)))"
21750007000000,450,239,211,41.6,"MULTIPOLYGON(((8.579447214559536 62.98352263498233,8.56960186350806 63.02811704136573,8.66780373771664 63.03256236496575,8.677501205837316 62.987959448552694,8.579447214559536 62.98352263498233)))"
21800007000000,102,53,49,47.2,"MULTIPOLYGON(((8.677501205837316 62.987959448552694,8.66780373771664 63.03256236496575,8.766039143034519 63.0369397128656,8.775588563979573 62.992328414023646,8.677501205837316 62.987959448552694)))"
21900007000000,13,7,6,52.4,"MULTIPOLYGON(((8.873708790514907 62.996629487805215,8.86430757861318 63.04124904127561,8.962608542537268 63.045490307059666,8.97186138591377 63.000862626958074,8.873708790514907 62.996629487805215)))"
21950007000000,105,58,47,44.2,"MULTIPOLYGON(((8.97186138591377 63.000862626958074,8.962608542537268 63.045490307059666,9.060941531839722 63.0496634677369,9.070045849603439 63.0050277891953,8.97186138591377 63.000862626958074)))"
22000007000000,271,148,123,42.4,"MULTIPOLYGON(((9.070045849603439 63.0050277891953,9.060941531839722 63.0496634677369,9.159306042516958 63.05376848148332,9.168261679983116 63.009124932883935,9.070045849603439 63.0050277891953)))"
22050007000000,671,324,347,45.2,"MULTIPOLYGON(((9.168261679983116 63.009124932883935,9.159306042516958 63.05376848148332,9.257701569544142 63.057805307133485,9.266508374439068 63.01315401704671,9.168261679983116 63.009124932883935)))"
22100007000000,78,43,35,50.7,"MULTIPOLYGON(((9.266508374439068 63.01315401704671,9.257701569544142 63.057805307133485,9.356127606890574 63.06177390418201,9.364785429359895 63.01711500136348,9.266508374439068 63.01315401704671)))"
22150007000000,1,1,0,0,"MULTIPOLYGON(((9.364785429359895 63.01711500136348,9.356127606890574 63.06177390418201,9.454583647535102 63.065674232785284,9.463092340151828 63.02100784617289,9.364785429359895 63.01711500136348)))"
22250007000000,79,49,30,44.7,"MULTIPOLYGON(((9.561428601254143 63.02483251247398,9.553069183481675 63.06950625376288,9.651583705774918 63.0732699285992,9.659793706154629 63.028588961927554,9.561428601254143 63.02483251247398)))"
22300007000000,778,370,408,47.1,"MULTIPOLYGON(((9.659793706154629 63.028588961927554,9.651583705774918 63.0732699285992,9.75012670451582 63.07696521944498,9.758187147405165 63.03227715685776,9.659793706154629 63.028588961927554)))"
22350007000000,3,2,1,0,"MULTIPOLYGON(((9.758187147405165 63.03227715685776,9.75012670451582 63.07696521944498,9.848697668877492 63.08059208911862,9.85660841663731 63.03589706025357,9.758187147405165 63.03227715685776)))"
22450007000000,8,4,4,47.6,"MULTIPOLYGON(((9.955057004578054 63.039448635770164,9.947296087120984 63.08415050110782,10.0459214466112 63.08764041957096,10.053532401065551 63.04293184773047,9.955057004578054 63.039448635770164)))"
22500007000000,56,30,26,35.6,"MULTIPOLYGON(((10.053532401065551 63.04293184773047,10.0459214466112 63.08764041957096,10.144573233832869 63.09106180933849,10.152034095065005 63.04634666112639,10.053532401065551 63.04293184773047)))"
22550007000000,92,49,43,39.9,"MULTIPOLYGON(((10.152034095065005 63.04634666112639,10.144573233832869 63.09106180933849,10.243250934406586 63.09441463591428,10.250561574684559 63.04969304162036,10.152034095065005 63.04634666112639)))"
22600007000000,336,164,172,40.2,"MULTIPOLYGON(((10.250561574684559 63.04969304162036,10.243250934406586 63.09441463591428,10.341954033104935 63.097698865477035,10.349114327191307 63.052970955546506,10.250561574684559 63.04969304162036)))"
23100007000000,55,30,25,50.9,"MULTIPOLYGON(((11.237141383198786 63.07938596466177,11.231339425654008 63.124164821144674,11.330267993185904 63.12676136978428,11.335918490798898 63.08197750999489,11.237141383198786 63.07938596466177)))"
23150007000000,17,11,6,51.2,"MULTIPOLYGON(((11.335918490798898 63.08197750999489,11.330267993185904 63.12676136978428,11.429216240047957 63.129288994276926,11.43471518035275 63.08450026313384,11.335918490798898 63.08197750999489)))"
20950007005000,254,131,123,38.9,"MULTIPOLYGON(((7.00333643481633 62.94778540690656,6.991107330218781 62.99222486118968,7.08885093875952 62.99776186799949,7.100934623630054 62.95331185985479,7.00333643481633 62.94778540690656)))"
21000007005000,659,348,311,44.4,"MULTIPOLYGON(((7.100934623630054 62.95331185985479,7.08885093875952 62.99776186799949,7.186636137224432 63.00323156279404,7.198574200050024 62.958771125166685,7.100934623630054 62.95331185985479)))"
21050007005000,314,161,153,44.4,"MULTIPOLYGON(((7.198574200050024 62.958771125166685,7.186636137224432 63.00323156279404,7.284462441580242 63.008633891327904,7.296254682279802 62.96416314884193,7.198574200050024 62.958771125166685)))"
21100007005000,400,207,193,42,"MULTIPOLYGON(((7.296254682279802 62.96416314884193,7.284462441580242 63.008633891327904,7.382329366486792 63.01396879998209,7.393975587226572 62.969487877503916,7.296254682279802 62.96416314884193)))"
21150007005000,937,486,451,41.8,"MULTIPOLYGON(((7.393975587226572 62.969487877503916,7.382329366486792 63.01396879998209,7.480236425310769 63.01923623576595,7.491736430514784 62.97474525840175,7.393975587226572 62.969487877503916)))"
21200007005000,278,155,123,45.4,"MULTIPOLYGON(((7.491736430514784 62.97474525840175,7.480236425310769 63.01923623576595,7.578183130139569 63.024436146319275,7.589536726499857 62.979935239412306,7.491736430514784 62.97474525840175)))"
21250007005000,268,148,120,44.7,"MULTIPOLYGON(((7.589536726499857 62.979935239412306,7.578183130139569 63.024436146319275,7.676168991795197 63.02956847991422,7.687375988282053 62.985057769042115,7.589536726499857 62.979935239412306)))"
21300007005000,490,251,239,45.8,"MULTIPOLYGON(((7.687375988282053 62.985057769042115,7.676168991795197 63.02956847991422,7.774193519848313 63.03463318545735,7.785253727720363 62.990112796429436,7.687375988282053 62.985057769042115)))"
21350007005000,479,239,240,39.8,"MULTIPOLYGON(((7.785253727720363 62.990112796429436,7.774193519848313 63.03463318545735,7.872256222632361 63.03963021249161,7.883169455446552 62.99510027134616,7.785253727720363 62.990112796429436)))"
21400007005000,310,161,149,42.1,"MULTIPOLYGON(((7.883169455446552 62.99510027134616,7.872256222632361 63.03963021249161,7.970356607257798 63.04455951119821,7.98112268087928 63.00002014419975,7.883169455446552 62.99510027134616)))"
21450007005000,291,141,150,46.5,"MULTIPOLYGON(((7.98112268087928 63.00002014419975,7.970356607257798 63.04455951119821,8.068494179626413 63.04942103239858,8.07911291223831 63.004872366035066,7.98112268087928 63.00002014419975)))"
21500007005000,61,33,28,44.3,"MULTIPOLYGON(((8.07911291223831 63.004872366035066,8.068494179626413 63.04942103239858,8.16666844444575 63.05421472755623,8.177139656558825 63.009656888536334,8.07911291223831 63.004872366035066)))"
21550007005000,36,17,19,56.1,"MULTIPOLYGON(((8.177139656558825 63.009656888536334,8.16666844444575 63.05421472755623,8.264878905243615 63.05894054877867,8.275202419705822 63.01437366402898,8.177139656558825 63.009656888536334)))"
21600007005000,41,21,20,54.5,"MULTIPOLYGON(((8.275202419705822 63.01437366402898,8.264878905243615 63.05894054877867,8.363125064382686 63.06359844881923,8.373300706388617 63.01902264548147,8.275202419705822 63.01437366402898)))"
21650007005000,58,32,26,51.9,"MULTIPOLYGON(((8.373300706388617 63.01902264548147,8.363125064382686 63.06359844881923,8.461406423075221 63.06818838107886,8.471434020175431 63.023603786507074,8.373300706388617 63.01902264548147)))"
21700007005000,5,2,3,50.6,"MULTIPOLYGON(((8.471434020175431 63.023603786507074,8.461406423075221 63.06818838107886,8.559722481397825 63.072710299608,8.56960186350806 63.02811704136573,8.471434020175431 63.023603786507074)))"
21750007005000,32,16,16,37.8,"MULTIPOLYGON(((8.56960186350806 63.02811704136573,8.559722481397825 63.072710299608,8.658072738306359 63.07716415910833,8.66780373771664 63.03256236496575,8.56960186350806 63.02811704136573)))"
21800007005000,54,27,27,43,"MULTIPOLYGON(((8.66780373771664 63.03256236496575,8.658072738306359 63.07716415910833,8.756456691650886 63.08154991493448,8.766039143034519 63.0369397128656,8.66780373771664 63.03256236496575)))"
21850007005000,19,11,8,47.4,"MULTIPOLYGON(((8.766039143034519 63.0369397128656,8.756456691650886 63.08154991493448,8.854873838190734 63.08586752309586,8.86430757861318 63.04124904127561,8.766039143034519 63.0369397128656)))"
21900007005000,1,1,0,0,"MULTIPOLYGON(((8.86430757861318 63.04124904127561,8.854873838190734 63.08586752309586,8.953323673609647 63.09011694025829,8.962608542537268 63.045490307059666,8.86430757861318 63.04124904127561)))"
22050007005000,566,280,286,44.7,"MULTIPOLYGON(((9.159306042516958 63.05376848148332,9.150319388533207 63.0984110315419,9.248864254164902 63.102455622292005,9.257701569544142 63.057805307133485,9.159306042516958 63.05376848148332)))"
22100007005000,203,102,101,42.9,"MULTIPOLYGON(((9.257701569544142 63.057805307133485,9.248864254164902 63.102455622292005,9.347439780960665 63.10643185530429,9.356127606890574 63.06177390418201,9.257701569544142 63.057805307133485)))"
22150007005000,90,52,38,41.2,"MULTIPOLYGON(((9.356127606890574 63.06177390418201,9.347439780960665 63.10643185530429,9.446045459456451 63.11033969055161,9.454583647535102 63.065674232785284,9.356127606890574 63.06177390418201)))"
22200007005000,11,6,5,65.5,"MULTIPOLYGON(((9.454583647535102 63.065674232785284,9.446045459456451 63.11033969055161,9.544680779205269 63.11417908867307,9.553069183481675 63.06950625376288,9.454583647535102 63.065674232785284)))"
22250007005000,575,300,275,42.6,"MULTIPOLYGON(((9.553069183481675 63.06950625376288,9.544680779205269 63.11417908867307,9.6433452287929 63.11795001097545,9.651583705774918 63.0732699285992,9.553069183481675 63.06950625376288)))"
22300007005000,524,269,255,44.7,"MULTIPOLYGON(((9.651583705774918 63.0732699285992,9.6433452287929 63.11795001097545,9.742038295853702 63.121652419434895,9.75012670451582 63.07696521944498,9.651583705774918 63.0732699285992)))"
22350007005000,8,5,3,51.5,"MULTIPOLYGON(((9.75012670451582 63.07696521944498,9.742038295853702 63.121652419434895,9.84075946708649 63.1252862766983,9.848697668877492 63.08059208911862,9.75012670451582 63.07696521944498)))"
22400007005000,49,27,22,45.2,"MULTIPOLYGON(((9.848697668877492 63.08059208911862,9.84075946708649 63.1252862766983,9.939508228270492 63.128851546084725,9.947296087120984 63.08415050110782,9.848697668877492 63.08059208911862)))"
22450007005000,356,179,177,39.9,"MULTIPOLYGON(((9.947296087120984 63.08415050110782,9.939508228270492 63.128851546084725,10.038284064281374 63.13234819158697,10.0459214466112 63.08764041957096,9.947296087120984 63.08415050110782)))"
22500007005000,149,81,68,35.2,"MULTIPOLYGON(((10.0459214466112 63.08764041957096,10.038284064281374 63.13234819158697,10.137086459107348 63.135776177872906,10.144573233832869 63.09106180933849,10.0459214466112 63.08764041957096)))"
22550007005000,1178,611,567,39.1,"MULTIPOLYGON(((10.144573233832869 63.09106180933849,10.137086459107348 63.135776177872906,10.235914895865337 63.139135470286945,10.243250934406586 63.09441463591428,10.144573233832869 63.09106180933849)))"
22600007005000,372,199,173,43.5,"MULTIPOLYGON(((10.243250934406586 63.09441463591428,10.235914895865337 63.139135470286945,10.334768856817245 63.1424260348513,10.341954033104935 63.097698865477035,10.243250934406586 63.09441463591428)))"
22650007005000,6,4,2,39.3,"MULTIPOLYGON(((10.341954033104935 63.097698865477035,10.334768856817245 63.1424260348513,10.433647823386238 63.145647838267365,10.440682013868678 63.1009144648816,10.341954033104935 63.097698865477035)))"
22900007005000,1,0,1,0,"MULTIPOLYGON(((10.835832408190834 63.11308992175256,10.82940334586088 63.157846798322986,10.928399533658448 63.16072432038216,10.934677030420401 63.11596189694408,10.835832408190834 63.11308992175256)))"
23350007005000,1,1,0,0,"MULTIPOLYGON(((11.726173812242479 63.13645807005465,11.721112523209644 63.181260111314884,11.820286687564106 63.18351614563289,11.825195528957096 63.13870974859552,11.726173812242479 63.13645807005465)))"
21150007010000,246,119,127,45.2,"MULTIPOLYGON(((7.382329366486792 63.01396879998209,7.370643011616347 63.05844822959647,7.468696773891034 63.06372575065867,7.480236425310769 63.01923623576595,7.382329366486792 63.01396879998209)))"
21200007010000,525,269,256,45.2,"MULTIPOLYGON(((7.480236425310769 63.01923623576595,7.468696773891034 63.06372575065867,7.566790376743888 63.068935620788764,7.578183130139569 63.024436146319275,7.480236425310769 63.01923623576595)))"
21250007010000,1187,600,587,40.5,"MULTIPOLYGON(((7.578183130139569 63.024436146319275,7.566790376743888 63.068935620788764,7.664923328704644 63.074077788023054,7.676168991795197 63.02956847991422,7.578183130139569 63.024436146319275)))"
21300007010000,345,185,160,43.7,"MULTIPOLYGON(((7.676168991795197 63.02956847991422,7.664923328704644 63.074077788023054,7.763095137041491 63.07915220103496,7.774193519848313 63.03463318545735,7.676168991795197 63.02956847991422)))"
21350007010000,618,319,299,42.5,"MULTIPOLYGON(((7.774193519848313 63.03463318545735,7.763095137041491 63.07915220103496,7.86130530777533 63.08415880913703,7.872256222632361 63.03963021249161,7.774193519848313 63.03463318545735)))"
21400007010000,788,411,377,39.9,"MULTIPOLYGON(((7.872256222632361 63.03963021249161,7.86130530777533 63.08415880913703,7.959553345694094 63.089097562282795,7.970356607257798 63.04455951119821,7.872256222632361 63.03963021249161)))"
21450007010000,246,132,114,49.6,"MULTIPOLYGON(((7.970356607257798 63.04455951119821,7.959553345694094 63.089097562282795,8.05783875436717 63.093968411068815,8.068494179626413 63.04942103239858,7.970356607257798 63.04455951119821)))"
21500007010000,55,33,22,54.7,"MULTIPOLYGON(((8.068494179626413 63.04942103239858,8.05783875436717 63.093968411068815,8.156161036159952 63.098771306736516,8.16666844444575 63.05421472755623,8.068494179626413 63.04942103239858)))"
21550007010000,203,103,100,43.9,"MULTIPOLYGON(((8.16666844444575 63.05421472755623,8.156161036159952 63.098771306736516,8.254519692248453 63.10350620117408,8.264878905243615 63.05894054877867,8.16666844444575 63.05421472755623)))"
21600007010000,201,103,98,47.9,"MULTIPOLYGON(((8.264878905243615 63.05894054877867,8.254519692248453 63.10350620117408,8.352914222634013 63.10817304691834,8.363125064382686 63.06359844881923,8.264878905243615 63.05894054877867)))"
21650007010000,59,30,29,42.6,"MULTIPOLYGON(((8.363125064382686 63.06359844881923,8.352914222634013 63.10817304691834,8.451344126158135 63.11277179715661,8.461406423075221 63.06818838107886,8.363125064382686 63.06359844881923)))"
21750007010000,113,58,55,47.4,"MULTIPOLYGON(((8.559722481397825 63.072710299608,8.549808900517363 63.11730240572849,8.648308042278295 63.12176482712767,8.658072738306359 63.07716415910833,8.559722481397825 63.072710299608)))"
21950007010000,2,1,1,0,"MULTIPOLYGON(((8.953323673609647 63.09011694025829,8.944006621005393 63.13474252307433,9.042638175969902 63.13893175386297,9.051805692531023 63.094298123745716,8.953323673609647 63.09011694025829)))"
22000007010000,4,3,1,0,"MULTIPOLYGON(((9.051805692531023 63.094298123745716,9.042638175969902 63.13893175386297,9.141301564750904 63.1430525798199,9.150319388533207 63.0984110315419,9.051805692531023 63.094298123745716)))"
22100007010000,60,34,26,44.6,"MULTIPOLYGON(((9.248864254164902 63.102455622292005,9.239996277455157 63.14710495939978,9.338721803166903 63.1510888517232,9.347439780960665 63.10643185530429,9.248864254164902 63.102455622292005)))"
22150007010000,90,48,42,45.9,"MULTIPOLYGON(((9.347439780960665 63.10643185530429,9.338721803166903 63.1510888517232,9.43747762996356 63.15500421657839,9.446045459456451 63.11033969055161,9.347439780960665 63.10643185530429)))"
22200007010000,8,4,4,62.5,"MULTIPOLYGON(((9.446045459456451 63.11033969055161,9.43747762996356 63.15500421657839,9.536263244931474 63.15885101442275,9.544680779205269 63.11417908867307,9.446045459456451 63.11033969055161)))"
22250007010000,136,73,63,41.3,"MULTIPOLYGON(((9.544680779205269 63.11417908867307,9.536263244931474 63.15885101442275,9.63507813418178 63.1626292063844,9.6433452287929 63.11795001097545,9.544680779205269 63.11417908867307)))"
22300007010000,1054,553,501,41.6,"MULTIPOLYGON(((9.6433452287929 63.11795001097545,9.63507813418178 63.1626292063844,9.733921782866325 63.16633875426376,9.742038295853702 63.121652419434895,9.6433452287929 63.11795001097545)))"
22350007010000,132,73,59,40.4,"MULTIPOLYGON(((9.742038295853702 63.121652419434895,9.733921782866325 63.16633875426376,9.832793675193681 63.16997962053502,9.84075946708649 63.1252862766983,9.742038295853702 63.121652419434895)))"
22400007010000,15,8,7,57.2,"MULTIPOLYGON(((9.84075946708649 63.1252862766983,9.832793675193681 63.16997962053502,9.93169329444521 63.173551768347586,9.939508228270492 63.128851546084725,9.84075946708649 63.1252862766983)))"
22450007010000,117,58,59,38.4,"MULTIPOLYGON(((9.939508228270492 63.128851546084725,9.93169329444521 63.173551768347586,10.030620122991243 63.17705516152763,10.038284064281374 63.13234819158697,9.939508228270492 63.128851546084725)))"
22500007010000,814,429,385,41.8,"MULTIPOLYGON(((10.038284064281374 63.13234819158697,10.030620122991243 63.17705516152763,10.1295736423073 63.180489764579406,10.137086459107348 63.135776177872906,10.038284064281374 63.13234819158697)))"
22550007010000,61,34,27,46.9,"MULTIPOLYGON(((10.137086459107348 63.135776177872906,10.1295736423073 63.180489764579406,10.228553332990387 63.183855542686764,10.235914895865337 63.139135470286945,10.137086459107348 63.135776177872906)))"
22600007010000,1635,827,808,41.8,"MULTIPOLYGON(((10.235914895865337 63.139135470286945,10.228553332990387 63.183855542686764,10.327558674775402 63.18715246171448,10.334768856817245 63.1424260348513,10.235914895865337 63.139135470286945)))"
22650007010000,58,29,29,41.5,"MULTIPOLYGON(((10.334768856817245 63.1424260348513,10.327558674775402 63.18715246171448,10.426589146551551 63.190380488209534,10.433647823386238 63.145647838267365,10.334768856817245 63.1424260348513)))"
22950007010000,239,122,117,44.5,"MULTIPOLYGON(((10.928399533658448 63.16072432038216,10.922100159310832 63.20548610976598,11.021270422438707 63.20830011692445,11.027417598921234 63.16353289583687,10.928399533658448 63.16072432038216)))"
23000007010000,423,219,204,42.4,"MULTIPOLYGON(((11.027417598921234 63.16353289583687,11.021270422438707 63.20830011692445,11.120462145498974 63.21104501659153,11.126457017663824 63.16627249617842,11.027417598921234 63.16353289583687)))"
23050007010000,303,152,151,46.1,"MULTIPOLYGON(((11.126457017663824 63.16627249617842,11.120462145498974 63.21104501659153,11.219674801215568 63.213720780818036,11.225517265194972 63.16894309358707,11.126457017663824 63.16627249617842)))"
23350007010000,1,0,1,0,"MULTIPOLYGON(((11.721112523209644 63.181260111314884,11.716033567310914 63.22606164071174,11.815360708464267 63.22832204426116,11.820286687564106 63.18351614563289,11.721112523209644 63.181260111314884)))"
21200007015000,215,115,100,42.1,"MULTIPOLYGON(((7.468696773891034 63.06372575065867,7.457117281680516 63.108213797541836,7.55535827403005 63.113433657430136,7.566790376743888 63.068935620788764,7.468696773891034 63.06372575065867)))"
21250007015000,1240,605,635,43.2,"MULTIPOLYGON(((7.566790376743888 63.068935620788764,7.55535827403005 63.113433657430136,7.653638809030108 63.11858568812378,7.664923328704644 63.074077788023054,7.566790376743888 63.068935620788764)))"
21300007015000,10830,5448,5382,45.7,"MULTIPOLYGON(((7.664923328704644 63.074077788023054,7.653638809030108 63.11858568812378,7.751958391632186 63.12366983806156,7.763095137041491 63.07915220103496,7.664923328704644 63.074077788023054)))"
21350007015000,6875,3540,3335,39.4,"MULTIPOLYGON(((7.763095137041491 63.07915220103496,7.751958391632186 63.12366983806156,7.850316525530293 63.12868605632416,7.86130530777533 63.08415880913703,7.763095137041491 63.07915220103496)))"
21400007015000,668,354,314,39.4,"MULTIPOLYGON(((7.86130530777533 63.08415880913703,7.850316525530293 63.12868605632416,7.948712713175404 63.13363429263605,7.959553345694094 63.089097562282795,7.86130530777533 63.08415880913703)))"
21450007015000,48,24,24,49.8,"MULTIPOLYGON(((7.959553345694094 63.089097562282795,7.948712713175404 63.13363429263605,8.047146455789983 63.13851449736745,8.05783875436717 63.093968411068815,7.959553345694094 63.089097562282795)))"
21500007015000,8,3,5,51.8,"MULTIPOLYGON(((8.05783875436717 63.093968411068815,8.047146455789983 63.13851449736745,8.14561725338266 63.14332662153625,8.156161036159952 63.098771306736516,8.05783875436717 63.093968411068815)))"
21550007015000,34,14,20,56.3,"MULTIPOLYGON(((8.156161036159952 63.098771306736516,8.14561725338266 63.14332662153625,8.244124604762916 63.148070616809974,8.254519692248453 63.10350620117408,8.156161036159952 63.098771306736516)))"
21600007015000,370,194,176,47.6,"MULTIPOLYGON(((8.254519692248453 63.10350620117408,8.244124604762916 63.148070616809974,8.342668007555954 63.152746435507574,8.352914222634013 63.10817304691834,8.254519692248453 63.10350620117408)))"
21650007015000,66,36,30,52.7,"MULTIPOLYGON(((8.352914222634013 63.10817304691834,8.342668007555954 63.152746435507574,8.441246958217615 63.15735403060133,8.451344126158135 63.11277179715661,8.352914222634013 63.10817304691834)))"
21700007015000,129,67,62,48.6,"MULTIPOLYGON(((8.451344126158135 63.11277179715661,8.441246958217615 63.15735403060133,8.539860952049382 63.161893355718675,8.549808900517363 63.11730240572849,8.451344126158135 63.11277179715661)))"
21750007015000,221,116,105,49.3,"MULTIPOLYGON(((8.549808900517363 63.11730240572849,8.539860952049382 63.161893355718675,8.638509483213511 63.166364365144,8.648308042278295 63.12176482712767,8.549808900517363 63.11730240572849)))"
21800007015000,1,0,1,0,"MULTIPOLYGON(((8.648308042278295 63.12176482712767,8.638509483213511 63.166364365144,8.737192044748216 63.17076701382047,8.746841046892655 63.12615901650369,8.648308042278295 63.12176482712767)))"
22000007015000,4,2,2,0,"MULTIPOLYGON(((9.042638175969902 63.13893175386297,9.03343882541927 63.18356435470609,9.13225241687493 63.18769312305461,9.141301564750904 63.1430525798199,9.042638175969902 63.13893175386297)))"
22150007015000,16,10,6,44.6,"MULTIPOLYGON(((9.338721803166903 63.1510888517232,9.329973524123055 63.195744890410154,9.428880012136874 63.199667807951336,9.43747762996356 63.15500421657839,9.338721803166903 63.1510888517232)))"
22200007015000,44,21,23,49.1,"MULTIPOLYGON(((9.43747762996356 63.15500421657839,9.428880012136874 63.199667807951336,9.527816436215401 63.20352202821018,9.536263244931474 63.15885101442275,9.43747762996356 63.15500421657839)))"
22250007015000,168,97,71,41.9,"MULTIPOLYGON(((9.536263244931474 63.15885101442275,9.527816436215401 63.20352202821018,9.626782279979203 63.20730751213491,9.63507813418178 63.1626292063844,9.536263244931474 63.15885101442275)))"
22300007015000,87,45,42,45.6,"MULTIPOLYGON(((9.63507813418178 63.1626292063844,9.626782279979203 63.20730751213491,9.725777026081609 63.21102422134916,9.733921782866325 63.16633875426376,9.63507813418178 63.1626292063844)))"
22350007015000,1072,554,518,38.8,"MULTIPOLYGON(((9.733921782866325 63.16633875426376,9.725777026081609 63.21102422134916,9.824800156224851 63.214672118153295,9.832793675193681 63.16997962053502,9.733921782866325 63.16633875426376)))"
22400007015000,35,20,15,44.3,"MULTIPOLYGON(((9.832793675193681 63.16997962053502,9.824800156224851 63.214672118153295,9.923851151176288 63.21825116552594,9.93169329444521 63.173551768347586,9.832793675193681 63.16997962053502)))"
22500007015000,87,44,43,41.9,"MULTIPOLYGON(((10.030620122991243 63.17705516152763,10.02292949078467 63.221761327125584,10.12203465399652 63.22520256729182,10.1295736423073 63.180489764579406,10.030620122991243 63.17705516152763)))"
22550007015000,65,35,30,38.3,"MULTIPOLYGON(((10.1295736423073 63.180489764579406,10.12203465399652 63.22520256729182,10.221166118872565 63.228574851046915,10.228553332990387 63.183855542686764,10.1295736423073 63.180489764579406)))"
22600007015000,1665,859,806,38.3,"MULTIPOLYGON(((10.228553332990387 63.183855542686764,10.221166118872565 63.228574851046915,10.320323362604233 63.231878144097145,10.327558674775402 63.18715246171448,10.228553332990387 63.183855542686764)))"
22650007015000,437,238,199,36.8,"MULTIPOLYGON(((10.327558674775402 63.18715246171448,10.320323362604233 63.231878144097145,10.419505861530252 63.23511241283411,10.426589146551551 63.190380488209534,10.327558674775402 63.18715246171448)))"
22700007015000,71,38,33,29.9,"MULTIPOLYGON(((10.426589146551551 63.190380488209534,10.419505861530252 63.23511241283411,10.518713091153286 63.23827762433617,10.525644226378876 63.193539589402604,10.426589146551551 63.190380488209534)))"
22900007015000,2,1,1,0,"MULTIPOLYGON(((10.82295188267971 63.202603023757405,10.816477907041845 63.24735859654441,10.915778798345015 63.25024726366986,10.922100159310832 63.20548610976598,10.82295188267971 63.202603023757405)))"
22950007015000,311,168,143,41.7,"MULTIPOLYGON(((10.922100159310832 63.20548610976598,10.915778798345015 63.25024726366986,11.015101785905161 63.25306671929778,11.021270422438707 63.20830011692445,10.922100159310832 63.20548610976598)))"
23000007015000,1735,861,874,44.7,"MULTIPOLYGON(((11.021270422438707 63.20830011692445,11.015101785905161 63.25306671929778,11.114446340562015 63.255816934653424,11.120462145498974 63.21104501659153,11.021270422438707 63.20830011692445)))"
23050007015000,17,9,8,48.6,"MULTIPOLYGON(((11.120462145498974 63.21104501659153,11.114446340562015 63.255816934653424,11.213811932437661 63.2584978816573,11.219674801215568 63.213720780818036,11.120462145498974 63.21104501659153)))"
23350007015000,3,2,1,0,"MULTIPOLYGON(((11.716033567310914 63.22606164071174,11.710936856302371 63.27086265743412,11.810417506035769 63.27312744373696,11.815360708464267 63.22832204426116,11.716033567310914 63.22606164071174)))"
21300007020000,2594,1252,1342,44.9,"MULTIPOLYGON(((7.653638809030108 63.11858568812378,7.642315241543973 63.163092174935485,7.740783094719672 63.16818609140136,7.751958391632186 63.12366983806156,7.653638809030108 63.11858568812378)))"
21350007020000,824,413,411,30.5,"MULTIPOLYGON(((7.751958391632186 63.12366983806156,7.740783094719672 63.16818609140136,7.839289689333501 63.17321194906065,7.850316525530293 63.12868605632416,7.751958391632186 63.12366983806156)))"
21400007020000,77,42,35,52.8,"MULTIPOLYGON(((7.850316525530293 63.12868605632416,7.839289689333501 63.17321194906065,7.937834525484924 63.1781696974073,7.948712713175404 63.13363429263605,7.850316525530293 63.12868605632416)))"
21450007020000,254,132,122,46,"MULTIPOLYGON(((7.948712713175404 63.13363429263605,7.937834525484924 63.1781696974073,8.036417102034852 63.18305928658379,8.047146455789983 63.13851449736745,7.948712713175404 63.13363429263605)))"
21500007020000,27,14,13,46.2,"MULTIPOLYGON(((8.047146455789983 63.13851449736745,8.036417102034852 63.18305928658379,8.135036916620395 63.187880667383084,8.14561725338266 63.14332662153625,8.047146455789983 63.13851449736745)))"
21550007020000,39,20,19,49.5,"MULTIPOLYGON(((8.14561725338266 63.14332662153625,8.135036916620395 63.187880667383084,8.233693465669695 63.192633791250564,8.244124604762916 63.148070616809974,8.14561725338266 63.14332662153625)))"
21600007020000,18,8,10,61.5,"MULTIPOLYGON(((8.244124604762916 63.148070616809974,8.233693465669695 63.192633791250564,8.332386244416885 63.19731861028597,8.342668007555954 63.152746435507574,8.244124604762916 63.148070616809974)))"
21650007020000,30,17,13,50.6,"MULTIPOLYGON(((8.342668007555954 63.152746435507574,8.332386244416885 63.19731861028597,8.431114746917114 63.20193507724517,8.441246958217615 63.15735403060133,8.342668007555954 63.152746435507574)))"
21700007020000,30,15,15,57,"MULTIPOLYGON(((8.441246958217615 63.15735403060133,8.431114746917114 63.20193507724517,8.529878466061705 63.20648314554205,8.539860952049382 63.161893355718675,8.441246958217615 63.15735403060133)))"
21750007020000,36,15,21,49.1,"MULTIPOLYGON(((8.539860952049382 63.161893355718675,8.529878466061705 63.20648314554205,8.628676893593358 63.21096276925043,8.638509483213511 63.166364365144,8.539860952049382 63.161893355718675)))"
21800007020000,55,29,26,52.5,"MULTIPOLYGON(((8.638509483213511 63.166364365144,8.628676893593358 63.21096276925043,8.727509520121494 63.215373903105665,8.737192044748216 63.17076701382047,8.638509483213511 63.166364365144)))"
21850007020000,44,23,21,42.9,"MULTIPOLYGON(((8.737192044748216 63.17076701382047,8.727509520121494 63.215373903105665,8.826375835137648 63.21971650250661,8.83590812858298 63.17510125735171,8.737192044748216 63.17076701382047)))"
21900007020000,85,43,42,43.7,"MULTIPOLYGON(((8.83590812858298 63.17510125735171,8.826375835137648 63.21971650250661,8.925275327030985 63.223990523517266,8.93465722555392 63.17936705200363,8.83590812858298 63.17510125735171)))"
21950007020000,225,121,104,43.2,"MULTIPOLYGON(((8.93465722555392 63.17936705200363,8.925275327030985 63.223990523517266,9.02420748310388 63.22819592286857,9.03343882541927 63.18356435470609,8.93465722555392 63.17936705200363)))"
22000007020000,64,34,30,40,"MULTIPOLYGON(((9.03343882541927 63.18356435470609,9.02420748310388 63.22819592286857,9.123171789587605 63.232332657960086,9.13225241687493 63.18769312305461,9.03343882541927 63.18356435470609)))"
22100007020000,1,1,0,0,"MULTIPOLYGON(((9.231097487570105 63.191753315312035,9.222167731658093 63.23640068686161,9.321194793451792 63.24039996831491,9.329973524123055 63.195744890410154,9.231097487570105 63.191753315312035)))"
22150007020000,26,15,11,56,"MULTIPOLYGON(((9.329973524123055 63.195744890410154,9.321194793451792 63.24039996831491,9.420252458081592 63.24433046173533,9.428880012136874 63.199667807951336,9.329973524123055 63.195744890410154)))"
22200007020000,5,3,2,40.4,"MULTIPOLYGON(((9.428880012136874 63.199667807951336,9.420252458081592 63.24433046173533,9.519340207652853 63.248192127213436,9.527816436215401 63.20352202821018,9.428880012136874 63.199667807951336)))"
22250007020000,56,30,26,42.9,"MULTIPOLYGON(((9.527816436215401 63.20352202821018,9.519340207652853 63.248192127213436,9.618457523279508 63.251984925516446,9.626782279979203 63.20730751213491,9.527816436215401 63.20352202821018)))"
22300007020000,55,27,28,39.8,"MULTIPOLYGON(((9.626782279979203 63.20730751213491,9.618457523279508 63.251984925516446,9.717603885100235 63.25570881809002,9.725777026081609 63.21102422134916,9.626782279979203 63.20730751213491)))"
22350007020000,744,401,343,39.8,"MULTIPOLYGON(((9.725777026081609 63.21102422134916,9.717603885100235 63.25570881809002,9.81677877229473 63.259363767059625,9.824800156224851 63.214672118153295,9.725777026081609 63.21102422134916)))"
22400007020000,101,55,46,39.2,"MULTIPOLYGON(((9.824800156224851 63.214672118153295,9.81677877229473 63.259363767059625,9.915981663100045 63.262949735232034,9.923851151176288 63.21825116552594,9.824800156224851 63.214672118153295)))"
22450007020000,376,204,172,39.9,"MULTIPOLYGON(((9.923851151176288 63.21825116552594,9.915981663100045 63.262949735232034,10.015212034826993 63.26646668609687,10.02292949078467 63.221761327125584,9.923851151176288 63.21825116552594)))"
22500007020000,734,390,344,39.6,"MULTIPOLYGON(((10.02292949078467 63.221761327125584,10.015212034826993 63.26646668609687,10.11446936387667 63.26991458382811,10.12203465399652 63.22520256729182,10.02292949078467 63.221761327125584)))"
22550007020000,502,271,231,39.1,"MULTIPOLYGON(((10.12203465399652 63.22520256729182,10.11446936387667 63.26991458382811,10.213753125756995 63.27329339328532,10.221166118872565 63.228574851046915,10.12203465399652 63.22520256729182)))"
22600007020000,2347,1188,1159,37.3,"MULTIPOLYGON(((10.221166118872565 63.228574851046915,10.213753125756995 63.27329339328532,10.313062795099368 63.276603080015285,10.320323362604233 63.231878144097145,10.221166118872565 63.228574851046915)))"
22700007020000,467,246,221,39.4,"MULTIPOLYGON(((10.419505861530252 63.23511241283411,10.412397845675375 63.2798436102532,10.51175775041359 63.28301495092416,10.518713091153286 63.23827762433617,10.419505861530252 63.23511241283411)))"
22750007020000,77,41,36,41.8,"MULTIPOLYGON(((10.518713091153286 63.23827762433617,10.51175775041359 63.28301495092416,10.611141981416404 63.28611706964436,10.617944526156665 63.24137374636972,10.518713091153286 63.23827762433617)))"
22800007020000,112,56,56,33.6,"MULTIPOLYGON(((10.617944526156665 63.24137374636972,10.611141981416404 63.28611706964436,10.710550009976975 63.28914993472249,10.717199640421159 63.244400747390365,10.617944526156665 63.24137374636972)))"
22850007020000,10,6,4,54.3,"MULTIPOLYGON(((10.717199640421159 63.244400747390365,10.710550009976975 63.28914993472249,10.809981306596196 63.292113515160956,10.816477907041845 63.24735859654441,10.717199640421159 63.244400747390365)))"
22900007020000,26,16,10,56.3,"MULTIPOLYGON(((10.816477907041845 63.24735859654441,10.809981306596196 63.292113515160956,10.909435340999762 63.295007780657116,10.915778798345015 63.25024726366986,10.816477907041845 63.24735859654441)))"
22950007020000,341,182,159,40.9,"MULTIPOLYGON(((10.915778798345015 63.25024726366986,10.909435340999762 63.295007780657116,11.008911582155298 63.297832701604506,11.015101785905161 63.25306671929778,10.915778798345015 63.25024726366986)))"
23000007020000,471,241,230,43.3,"MULTIPOLYGON(((11.015101785905161 63.25306671929778,11.008911582155298 63.297832701604506,11.108409498289516 63.300588249094076,11.114446340562015 63.255816934653424,11.015101785905161 63.25306671929778)))"
23050007020000,67,38,29,40.8,"MULTIPOLYGON(((11.114446340562015 63.255816934653424,11.108409498289516 63.300588249094076,11.20792855690549 63.30327439491525,11.213811932437661 63.2584978816573,11.114446340562015 63.255816934653424)))"
23350007020000,9,4,5,51.1,"MULTIPOLYGON(((11.710936856302371 63.27086265743412,11.705822301348702 63.31566316066391,11.805456994082807 63.31793234331045,11.810417506035769 63.27312744373696,11.710936856302371 63.27086265743412)))"
23400007020000,53,28,25,45.6,"MULTIPOLYGON(((11.810417506035769 63.27312744373696,11.805456994082807 63.31793234331045,11.905109083018717 63.32013194646551,11.909915465197164 63.27532278469264,11.810417506035769 63.27312744373696)))"
21450007025000,196,96,100,42.8,"MULTIPOLYGON(((7.937834525484924 63.1781696974073,7.926918597191962 63.22270377171227,8.025650510042615 63.227602773974475,8.036417102034852 63.18305928658379,7.937834525484924 63.1781696974073)))"
21500007025000,128,62,66,50.4,"MULTIPOLYGON(((8.036417102034852 63.18305928658379,8.025650510042615 63.227602773974475,8.124419845195371 63.23243343967283,8.135036916620395 63.187880667383084,8.036417102034852 63.18305928658379)))"
21550007025000,162,87,75,48.2,"MULTIPOLYGON(((8.135036916620395 63.187880667383084,8.124419845195371 63.23243343967283,8.223226096682096 63.237195720029156,8.233693465669695 63.192633791250564,8.135036916620395 63.187880667383084)))"
21600007025000,22,9,13,45,"MULTIPOLYGON(((8.233693465669695 63.192633791250564,8.223226096682096 63.237195720029156,8.322068757330793 63.241889566922545,8.332386244416885 63.19731861028597,8.233693465669695 63.192633791250564)))"
21650007025000,57,32,25,45.2,"MULTIPOLYGON(((8.332386244416885 63.19731861028597,8.322068757330793 63.241889566922545,8.420947318780813 63.2465149328911,8.431114746917114 63.20193507724517,8.332386244416885 63.19731861028597)))"
21700007025000,149,84,65,44.9,"MULTIPOLYGON(((8.431114746917114 63.20193507724517,8.420947318780813 63.2465149328911,8.519861271498073 63.25107177113384,8.529878466061705 63.20648314554205,8.431114746917114 63.20193507724517)))"
21750007025000,58,32,26,48.7,"MULTIPOLYGON(((8.529878466061705 63.20648314554205,8.519861271498073 63.25107177113384,8.618810104790409 63.25556003551252,8.628676893593358 63.21096276925043,8.529878466061705 63.20648314554205)))"
21950007025000,72,34,38,43.5,"MULTIPOLYGON(((8.925275327030985 63.223990523517266,8.915860764149965 63.26861293406139,9.014943990201763 63.27282645491981,9.02420748310388 63.22819592286857,8.925275327030985 63.223990523517266)))"
22000007025000,103,50,53,44.8,"MULTIPOLYGON(((9.02420748310388 63.22819592286857,9.014943990201763 63.27282645491981,9.114059526540267 63.27697118122709,9.123171789587605 63.232332657960086,9.02420748310388 63.22819592286857)))"
22250007025000,59,33,26,40.8,"MULTIPOLYGON(((9.519340207652853 63.248192127213436,9.510834412872368 63.29286130859026,9.610103720225904 63.29666144379886,9.618457523279508 63.251984925516446,9.519340207652853 63.248192127213436)))"
22300007025000,131,74,57,43.9,"MULTIPOLYGON(((9.618457523279508 63.251984925516446,9.610103720225904 63.29666144379886,9.709402218587984 63.30039254186645,9.717603885100235 63.25570881809002,9.618457523279508 63.251984925516446)))"
22350007025000,906,447,459,41.6,"MULTIPOLYGON(((9.717603885100235 63.25570881809002,9.709402218587984 63.30039254186645,9.808729384599419 63.304054564742415,9.81677877229473 63.259363767059625,9.717603885100235 63.25570881809002)))"
22400007025000,5981,2908,3073,43,"MULTIPOLYGON(((9.81677877229473 63.259363767059625,9.808729384599419 63.304054564742415,9.908084693950535 63.30764747506063,9.915981663100045 63.262949735232034,9.81677877229473 63.259363767059625)))"
22450007025000,73,40,33,45.1,"MULTIPOLYGON(((9.915981663100045 63.262949735232034,9.908084693950535 63.30764747506063,10.00746762139773 63.311171236140794,10.015212034826993 63.26646668609687,9.915981663100045 63.262949735232034)))"
22500007025000,628,329,299,39.9,"MULTIPOLYGON(((10.015212034826993 63.26646668609687,10.00746762139773 63.311171236140794,10.106877640780082 63.3146258119901,10.11446936387667 63.26991458382811,10.015212034826993 63.26646668609687)))"
22550007025000,3272,1637,1635,36.8,"MULTIPOLYGON(((10.11446936387667 63.26991458382811,10.106877640780082 63.3146258119901,10.206314225036076 63.318011167304434,10.213753125756995 63.27329339328532,10.11446936387667 63.26991458382811)))"
22600007025000,5449,2666,2783,43.2,"MULTIPOLYGON(((10.213753125756995 63.27329339328532,10.206314225036076 63.318011167304434,10.305776846220361 63.32132726747003,10.313062795099368 63.276603080015285,10.213753125756995 63.27329339328532)))"
22650007025000,1800,925,875,34.3,"MULTIPOLYGON(((10.313062795099368 63.276603080015285,10.305776846220361 63.32132726747003,10.405264975520602 63.3245740785647,10.412397845675375 63.2798436102532,10.313062795099368 63.276603080015285)))"
22700007025000,5428,2776,2652,38,"MULTIPOLYGON(((10.412397845675375 63.2798436102532,10.405264975520602 63.3245740785647,10.504778083274417 63.32775156735921,10.51175775041359 63.28301495092416,10.412397845675375 63.2798436102532)))"
22750007025000,62,32,30,39.5,"MULTIPOLYGON(((10.51175775041359 63.28301495092416,10.504778083274417 63.32775156735921,10.60431563898635 63.3308597013187,10.611141981416404 63.28611706964436,10.51175775041359 63.28301495092416)))"
22800007025000,8,3,5,37.1,"MULTIPOLYGON(((10.611141981416404 63.28611706964436,10.60431563898635 63.3308597013187,10.703877111344937 63.33389844860387,10.710550009976975 63.28914993472249,10.611141981416404 63.28611706964436)))"
22850007025000,23,12,11,41.8,"MULTIPOLYGON(((10.710550009976975 63.28914993472249,10.703877111344937 63.33389844860387,10.80346196823985 63.336867778072346,10.809981306596196 63.292113515160956,10.710550009976975 63.28914993472249)))"
22900007025000,119,65,54,44.7,"MULTIPOLYGON(((10.809981306596196 63.292113515160956,10.80346196823985 63.336867778072346,10.903069676779062 63.3397676592799,10.909435340999762 63.295007780657116,10.809981306596196 63.292113515160956)))"
23400007025000,5,2,3,23.6,"MULTIPOLYGON(((11.805456994082807 63.31793234331045,11.800479085830764 63.36273674222522,11.900285842202557 63.36494062082572,11.905109083018717 63.32013194646551,11.805456994082807 63.31793234331045)))"
23500007025000,14,8,6,66.1,"MULTIPOLYGON(((12.004778030498013 63.322261947545265,12.000109541795583 63.36707476268771,12.099949643701146 63.36913914583256,12.104463298296382 63.32432232467373,12.004778030498013 63.322261947545265)))"
21500007030000,7,5,2,65.7,"MULTIPOLYGON(((8.025650510042615 63.227602773974475,8.014846495545113 63.27214495476321,8.11376585723575 63.27698493376927,8.124419845195371 63.23243343967283,8.025650510042615 63.227602773974475)))"
21550007030000,5,2,3,28.4,"MULTIPOLYGON(((8.124419845195371 63.23243343967283,8.11376585723575 63.27698493376927,8.2127223183344 63.28175639864791,8.223226096682096 63.237195720029156,8.124419845195371 63.23243343967283)))"
21600007030000,56,29,27,49.6,"MULTIPOLYGON(((8.223226096682096 63.237195720029156,8.2127223183344 63.28175639864791,8.31171536924781 63.28645930105609,8.322068757330793 63.241889566922545,8.223226096682096 63.237195720029156)))"
21650007030000,237,124,113,43.4,"MULTIPOLYGON(((8.322068757330793 63.241889566922545,8.31171536924781 63.28645930105609,8.410744499184267 63.29109359331276,8.420947318780813 63.2465149328911,8.322068757330793 63.241889566922545)))"
21700007030000,65,32,33,43.4,"MULTIPOLYGON(((8.420947318780813 63.2465149328911,8.410744499184267 63.29109359331276,8.509809196168929 63.29565922840066,8.519861271498073 63.25107177113384,8.420947318780813 63.2465149328911)))"
21750007030000,831,412,419,46.2,"MULTIPOLYGON(((8.519861271498073 63.25107177113384,8.509809196168929 63.29565922840066,8.608908947059332 63.300156159968246,8.618810104790409 63.25556003551252,8.519861271498073 63.25107177113384)))"
21800007030000,2,1,1,0,"MULTIPOLYGON(((8.618810104790409 63.25556003551252,8.608908947059332 63.300156159968246,8.708043237560924 63.304584342331474,8.717793306823017 63.25997968055351,8.618810104790409 63.25556003551252)))"
21950007030000,9,6,3,53.1,"MULTIPOLYGON(((8.915860764149965 63.26861293406139,8.906413374553129 63.31323428005693,9.005648186835595 63.31745594740473,9.014943990201763 63.27282645491981,8.915860764149965 63.26861293406139)))"
22000007030000,2789,1403,1386,43.8,"MULTIPOLYGON(((9.014943990201763 63.27282645491981,9.005648186835595 63.31745594740473,9.104915470344737 63.32160868952274,9.114059526540267 63.27697118122709,9.014943990201763 63.27282645491981)))"
22050007030000,208,109,99,36.3,"MULTIPOLYGON(((9.114059526540267 63.27697118122709,9.104915470344737 63.32160868952274,9.204214705262244 63.32569246409109,9.213206855852277 63.281047070858804,9.114059526540267 63.27697118122709)))"
22100007030000,9,4,5,34.3,"MULTIPOLYGON(((9.213206855852277 63.281047070858804,9.204214705262244 63.32569246409109,9.303545370713021 63.32970722946775,9.312385459776504 63.285054082365455,9.213206855852277 63.281047070858804)))"
22250007030000,2,1,1,0,"MULTIPOLYGON(((9.510834412872368 63.29286130859026,9.502298904527219 63.33752956947798,9.6017207260026 63.341337064232256,9.610103720225904 63.29666144379886,9.510834412872368 63.29286130859026)))"
22300007030000,10,6,4,66.8,"MULTIPOLYGON(((9.610103720225904 63.29666144379886,9.6017207260026 63.341337064232256,9.701171884267962 63.34507539003943,9.709402218587984 63.30039254186645,9.610103720225904 63.29666144379886)))"
22350007030000,88,43,45,38.8,"MULTIPOLYGON(((9.709402218587984 63.30039254186645,9.701171884267962 63.34507539003943,9.800651853408768 63.348744508671736,9.808729384599419 63.304054564742415,9.709402218587984 63.30039254186645)))"
22400007030000,2863,1440,1423,39.4,"MULTIPOLYGON(((9.808729384599419 63.304054564742415,9.800651853408768 63.348744508671736,9.900160106552066 63.35234438258888,9.908084693950535 63.30764747506063,9.808729384599419 63.304054564742415)))"
22450007030000,502,255,247,38.9,"MULTIPOLYGON(((9.908084693950535 63.30764747506063,9.900160106552066 63.35234438258888,9.9996961158832 63.355874974939674,10.00746762139773 63.311171236140794,9.908084693950535 63.30764747506063)))"
22500007030000,2212,1100,1112,39.7,"MULTIPOLYGON(((10.00746762139773 63.311171236140794,9.9996961158832 63.355874974939674,10.09925935266255 63.35933624956334,10.106877640780082 63.3146258119901,10.00746762139773 63.311171236140794)))"
22550007030000,1212,604,608,41.5,"MULTIPOLYGON(((10.106877640780082 63.3146258119901,10.09925935266255 63.35933624956334,10.198849287242371 63.36272817099115,10.206314225036076 63.318011167304434,10.106877640780082 63.3146258119901)))"
22600007030000,1276,677,599,41.6,"MULTIPOLYGON(((10.206314225036076 63.318011167304434,10.198849287242371 63.36272817099115,10.298465389083715 63.36605070444765,10.305776846220361 63.32132726747003,10.206314225036076 63.318011167304434)))"
22650007030000,29503,14743,14760,38.6,"MULTIPOLYGON(((10.305776846220361 63.32132726747003,10.298465389083715 63.36605070444765,10.39810712677341 63.36930381585224,10.405264975520602 63.3245740785647,10.305776846220361 63.32132726747003)))"
22700007030000,3198,1607,1591,38.3,"MULTIPOLYGON(((10.405264975520602 63.3245740785647,10.39810712677341 63.36930381585224,10.497773968041125 63.37248747182043,10.504778083274417 63.32775156735921,10.405264975520602 63.3245740785647)))"
22750007030000,225,111,114,44,"MULTIPOLYGON(((10.504778083274417 63.32775156735921,10.497773968041125 63.37248747182043,10.597465379776489 63.375601639665234,10.60431563898635 63.3308597013187,10.504778083274417 63.32775156735921)))"
22800007030000,25,16,9,55.5,"MULTIPOLYGON(((10.60431563898635 63.3308597013187,10.597465379776489 63.375601639665234,10.6971808280463 63.378646287398446,10.703877111344937 63.33389844860387,10.60431563898635 63.3308597013187)))"
22850007030000,161,85,76,45.1,"MULTIPOLYGON(((10.703877111344937 63.33389844860387,10.6971808280463 63.378646287398446,10.796919778111798 63.381621383731975,10.80346196823985 63.336867778072346,10.703877111344937 63.33389844860387)))"
22900007030000,46,21,25,43,"MULTIPOLYGON(((10.80346196823985 63.336867778072346,10.796919778111798 63.381621383731975,10.896681694445983 63.384526898079116,10.903069676779062 63.3397676592799,10.80346196823985 63.336867778072346)))"
23000007030000,161,83,78,40.2,"MULTIPOLYGON(((11.002699703306137 63.34259806248171,10.996466040751033 63.38736280055569,11.096272279975773 63.390129061981376,11.102351513417537 63.34535895863346,11.002699703306137 63.34259806248171)))"
23050007030000,13,6,7,26.1,"MULTIPOLYGON(((11.102351513417537 63.34535895863346,11.096272279975773 63.390129061981376,11.196099874333182 63.3928256538808,11.202024571980013 63.34805031939266,11.102351513417537 63.34535895863346)))"
23100007030000,2,2,0,0,"MULTIPOLYGON(((11.202024571980013 63.34805031939266,11.196099874333182 63.3928256538808,11.295948285318008 63.395452548484755,11.30171834314805 63.35067211711969,11.202024571980013 63.34805031939266)))"
23150007030000,5,2,3,60.2,"MULTIPOLYGON(((11.30171834314805 63.35067211711969,11.295948285318008 63.395452548484755,11.3958169737244 63.39800971873125,11.401432290381377 63.353224324878894,11.30171834314805 63.35067211711969)))"
23350007030000,411,219,192,46.2,"MULTIPOLYGON(((11.700689813018236 63.36046314957599,11.695539301277956 63.40526262333815,11.795483693921364 63.40754063971821,11.800479085830764 63.36273674222522,11.700689813018236 63.36046314957599)))"
23400007030000,231,127,104,44.6,"MULTIPOLYGON(((11.800479085830764 63.36273674222522,11.795483693921364 63.40754063971821,11.895445658070056 63.40974880707727,11.900285842202557 63.36494062082572,11.800479085830764 63.36273674222522)))"
23450007030000,5,2,3,75.8,"MULTIPOLYGON(((11.900285842202557 63.36494062082572,11.895445658070056 63.40974880707727,11.995424650688495 63.411887102619026,12.000109541795583 63.36707476268771,11.900285842202557 63.36494062082572)))"
21500007035000,25,13,12,53.8,"MULTIPOLYGON(((8.014846495545113 63.27214495476321,8.004004873055269 63.31668582414047,8.103074769665811 63.32153514500396,8.11376585723575 63.27698493376927,8.014846495545113 63.27214495476321)))"
21550007035000,45,27,18,43.3,"MULTIPOLYGON(((8.11376585723575 63.27698493376927,8.103074769665811 63.32153514500396,8.202181949972188 63.3263158225776,8.2127223183344 63.28175639864791,8.11376585723575 63.27698493376927)))"
21600007035000,6,3,3,58,"MULTIPOLYGON(((8.2127223183344 63.28175639864791,8.202181949972188 63.3263158225776,8.301325901944606 63.33102780829485,8.31171536924781 63.28645930105609,8.2127223183344 63.28175639864791)))"
21700007035000,134,70,64,46.7,"MULTIPOLYGON(((8.410744499184267 63.29109359331276,8.400506112344898 63.33567105425413,8.499722066742024 63.340245513220495,8.509809196168929 63.29565922840066,8.410744499184267 63.29109359331276)))"
21750007035000,105,57,48,44.9,"MULTIPOLYGON(((8.509809196168929 63.29565922840066,8.499722066742024 63.340245513220495,8.598973249527651 63.34475113862771,8.608908947059332 63.300156159968246,8.509809196168929 63.29565922840066)))"
21800007035000,140,74,66,41.9,"MULTIPOLYGON(((8.608908947059332 63.300156159968246,8.598973249527651 63.34475113862771,8.698259143931827 63.34918788457995,8.708043237560924 63.304584342331474,8.608908947059332 63.300156159968246)))"
21850007035000,56,30,26,45.3,"MULTIPOLYGON(((8.708043237560924 63.304584342331474,8.698259143931827 63.34918788457995,8.797579232038768 63.35355570585369,8.807211552242743 63.308943730475576,8.708043237560924 63.304584342331474)))"
21900007035000,63,32,31,48.4,"MULTIPOLYGON(((8.807211552242743 63.308943730475576,8.797579232038768 63.35355570585369,8.89693299480272 63.35785455789951,8.906413374553129 63.31323428005693,8.807211552242743 63.308943730475576)))"
22000007035000,69,36,33,38.4,"MULTIPOLYGON(((9.005648186835595 63.31745594740473,8.996319912063932 63.362084396843784,9.095739462564698 63.36624517949052,9.104915470344737 63.32160868952274,9.005648186835595 63.31745594740473)))"
22050007035000,91,49,42,41.4,"MULTIPOLYGON(((9.104915470344737 63.32160868952274,9.095739462564698 63.36624517949052,9.195191123965502 63.37033686332301,9.204214705262244 63.32569246409109,9.104915470344737 63.32160868952274)))"
22100007035000,150,78,72,44.4,"MULTIPOLYGON(((9.204214705262244 63.32569246409109,9.195191123965502 63.37033686332301,9.294674372861248 63.374359406505576,9.303545370713021 63.32970722946775,9.204214705262244 63.32569246409109)))"
22150007035000,55,28,27,47.3,"MULTIPOLYGON(((9.303545370713021 63.32970722946775,9.294674372861248 63.374359406505576,9.394188684797578 63.37831276788522,9.402906944781357 63.33365294469041,9.303545370713021 63.32970722946775)))"
22200007035000,43,23,20,42.8,"MULTIPOLYGON(((9.402906944781357 63.33365294469041,9.394188684797578 63.37831276788522,9.493733534287292 63.382196906993215,9.502298904527219 63.33752956947798,9.402906944781357 63.33365294469041)))"
22250007035000,19,10,9,52.4,"MULTIPOLYGON(((9.502298904527219 63.33752956947798,9.493733534287292 63.382196906993215,9.593308394826806 63.38601178404686,9.6017207260026 63.341337064232256,9.502298904527219 63.33752956947798)))"
22400007035000,34,19,15,45.2,"MULTIPOLYGON(((9.800651853408768 63.348744508671736,9.792546038058662 63.39343359629918,9.892207762811601 63.397040455376285,9.900160106552066 63.35234438258888,9.800651853408768 63.348744508671736)))"
22450007035000,81,47,34,44.2,"MULTIPOLYGON(((9.900160106552066 63.35234438258888,9.892207762811601 63.397040455376285,9.991897382769103 63.40057790015884,9.9996961158832 63.355874974939674,9.900160106552066 63.35234438258888)))"
22500007035000,257,133,124,40.3,"MULTIPOLYGON(((9.9996961158832 63.355874974939674,9.991897382769103 63.40057790015884,10.091614366596005 63.40404589431717,10.09925935266255 63.35933624956334,9.9996961158832 63.355874974939674)))"
22550007035000,627,322,305,41.3,"MULTIPOLYGON(((10.09925935266255 63.35933624956334,10.091614366596005 63.40404589431717,10.191358182041434 63.407444402216704,10.198849287242371 63.36272817099115,10.09925935266255 63.35933624956334)))"
22600007035000,41,23,18,45.7,"MULTIPOLYGON(((10.198849287242371 63.36272817099115,10.191358182041434 63.407444402216704,10.291128295955854 63.410773388919374,10.298465389083715 63.36605070444765,10.198849287242371 63.36272817099115)))"
22650007035000,41642,20930,20712,38.5,"MULTIPOLYGON(((10.298465389083715 63.36605070444765,10.291128295955854 63.410773388919374,10.390924174308193 63.41403282018512,10.39810712677341 63.36930381585224,10.298465389083715 63.36605070444765)))"
22700007035000,37777,19402,18375,38,"MULTIPOLYGON(((10.39810712677341 63.36930381585224,10.390924174308193 63.41403282018512,10.490745282203042 63.41722266247311,10.497773968041125 63.37248747182043,10.39810712677341 63.36930381585224)))"
22750007035000,4765,2418,2347,35.3,"MULTIPOLYGON(((10.497773968041125 63.37248747182043,10.490745282203042 63.41722266247311,10.590591083897918 63.42034288294333,10.597465379776489 63.375601639665234,10.497773968041125 63.37248747182043)))"
22800007035000,380,196,184,40.3,"MULTIPOLYGON(((10.597465379776489 63.375601639665234,10.590591083897918 63.42034288294333,10.690461042820603 63.423393449457684,10.6971808280463 63.378646287398446,10.597465379776489 63.375601639665234)))"
22850007035000,2038,1097,941,35.1,"MULTIPOLYGON(((10.6971808280463 63.378646287398446,10.690461042820603 63.423393449457684,10.790354621586577 63.42637433058141,10.796919778111798 63.381621383731975,10.6971808280463 63.378646287398446)))"
22900007035000,2669,1302,1367,42.9,"MULTIPOLYGON(((10.796919778111798 63.381621383731975,10.790354621586577 63.42637433058141,10.890271282016466 63.42928549558432,10.896681694445983 63.384526898079116,10.796919778111798 63.381621383731975)))"
22950007035000,487,253,234,39,"MULTIPOLYGON(((10.896681694445983 63.384526898079116,10.890271282016466 63.42928549558432,10.990210485153602 63.43212691444207,10.996466040751033 63.38736280055569,10.896681694445983 63.384526898079116)))"
23000007035000,242,133,109,37.1,"MULTIPOLYGON(((10.996466040751033 63.38736280055569,10.990210485153602 63.43212691444207,11.090171691281625 63.434898557837386,11.096272279975773 63.390129061981376,10.996466040751033 63.38736280055569)))"
23050007035000,37,22,15,45,"MULTIPOLYGON(((11.096272279975773 63.390129061981376,11.090171691281625 63.434898557837386,11.190154359942166 63.437600397161205,11.196099874333182 63.3928256538808,11.096272279975773 63.390129061981376)))"
23100007035000,41,23,18,47,"MULTIPOLYGON(((11.196099874333182 63.3928256538808,11.190154359942166 63.437600397161205,11.290157949952581 63.44023240451382,11.295948285318008 63.395452548484755,11.196099874333182 63.3928256538808)))"
23300007035000,194,107,87,46.7,"MULTIPOLYGON(((11.595613022581864 63.4029147814469,11.590288825766503 63.44770916641265,11.690370675488444 63.45006158111105,11.695539301277956 63.40526262333815,11.595613022581864 63.4029147814469)))"
23350007035000,1488,754,734,43.8,"MULTIPOLYGON(((11.695539301277956 63.40526262333815,11.690370675488444 63.45006158111105,11.790470730407762 63.452344035019664,11.795483693921364 63.40754063971821,11.695539301277956 63.40526262333815)))"
21400007040000,8,4,4,45.1,"MULTIPOLYGON(((7.805978972906763 63.306781450122784,7.794798030543419 63.351301874438164,7.893942495973306 63.35629796247698,7.904972770946593 63.31176790921661,7.805978972906763 63.306781450122784)))"
21450007040000,16,10,6,38.9,"MULTIPOLYGON(((7.904972770946593 63.31176790921661,7.893942495973306 63.35629796247698,7.993125455857053 63.361225377263224,8.004004873055269 63.31668582414047,7.904972770946593 63.31176790921661)))"
21500007040000,165,84,81,47.7,"MULTIPOLYGON(((8.004004873055269 63.31668582414047,7.993125455857053 63.361225377263224,8.092346398196081 63.366084068675775,8.103074769665811 63.32153514500396,8.004004873055269 63.31668582414047)))"
21550007040000,174,99,75,39.8,"MULTIPOLYGON(((8.103074769665811 63.32153514500396,8.092346398196081 63.366084068675775,8.191604809742545 63.370873987257255,8.202181949972188 63.3263158225776,8.103074769665811 63.32153514500396)))"
21600007040000,2,1,1,0,"MULTIPOLYGON(((8.202181949972188 63.3263158225776,8.191604809742545 63.370873987257255,8.290900176014707 63.37559508421633,8.301325901944606 63.33102780829485,8.202181949972188 63.3263158225776)))"
21700007040000,11,6,5,57.5,"MULTIPOLYGON(((8.400506112344898 63.33567105425413,8.390231981312477 63.38024731142929,8.489599708733023 63.38483062144222,8.499722066742024 63.340245513220495,8.400506112344898 63.33567105425413)))"
21750007040000,16,8,8,43.1,"MULTIPOLYGON(((8.499722066742024 63.340245513220495,8.489599708733023 63.38483062144222,8.589002840186447 63.38934496747278,8.598973249527651 63.34475113862771,8.499722066742024 63.340245513220495)))"
21800007040000,207,106,101,40.5,"MULTIPOLYGON(((8.598973249527651 63.34475113862771,8.589002840186447 63.38934496747278,8.688440856411633 63.39379030341202,8.698259143931827 63.34918788457995,8.598973249527651 63.34475113862771)))"
21850007040000,36,23,13,39.8,"MULTIPOLYGON(((8.698259143931827 63.34918788457995,8.688440856411633 63.39379030341202,8.787913236992107 63.398166583826296,8.797579232038768 63.35355570585369,8.698259143931827 63.34918788457995)))"
21950007040000,142,62,80,41.6,"MULTIPOLYGON(((8.89693299480272 63.35785455789951,8.887419460372058 63.40247376395904,8.986959003872418 63.40671179973255,8.996319912063932 63.362084396843784,8.89693299480272 63.35785455789951)))"
22000007040000,70,37,33,40.1,"MULTIPOLYGON(((8.996319912063932 63.362084396843784,8.986959003872418 63.40671179973255,9.086531343707032 63.410880647749735,9.095739462564698 63.36624517949052,8.996319912063932 63.362084396843784)))"
22050007040000,31,17,14,47.5,"MULTIPOLYGON(((9.095739462564698 63.36624517949052,9.086531343707032 63.410880647749735,9.18613595499894 63.414980265295874,9.195191123965502 63.37033686332301,9.095739462564698 63.36624517949052)))"
22100007040000,18,11,7,52.1,"MULTIPOLYGON(((9.195191123965502 63.37033686332301,9.18613595499894 63.414980265295874,9.285772311796745 63.419010610340294,9.294674372861248 63.374359406505576,9.195191123965502 63.37033686332301)))"
22200007040000,7,4,3,41.6,"MULTIPOLYGON(((9.394188684797578 63.37831276788522,9.38543988709103 63.42297164153808,9.485138152830926 63.42686331823172,9.493733534287292 63.382196906993215,9.394188684797578 63.37831276788522)))"
22250007040000,221,116,105,44.5,"MULTIPOLYGON(((9.493733534287292 63.382196906993215,9.485138152830926 63.42686331823172,9.584866579940718 63.43068560045273,9.593308394826806 63.38601178404686,9.493733534287292 63.382196906993215)))"
22300007040000,14,7,7,63.4,"MULTIPOLYGON(((9.593308394826806 63.38601178404686,9.584866579940718 63.43068560045273,9.68462463833656 63.43443844892326,9.692912738912764 63.38975735995087,9.593308394826806 63.38601178404686)))"
22450007040000,105,55,50,40.1,"MULTIPOLYGON(((9.892207762811601 63.397040455376285,9.884227523711123 63.44173569096426,9.984071285632986 63.44528000944635,9.991897382769103 63.40057790015884,9.892207762811601 63.397040455376285)))"
22500007040000,20,13,7,47.1,"MULTIPOLYGON(((9.991897382769103 63.40057790015884,9.984071285632986 63.44528000944635,10.083942548761158 63.448754744004226,10.091614366596005 63.40404589431717,9.991897382769103 63.40057790015884)))"
22550007040000,1106,586,520,39.5,"MULTIPOLYGON(((10.091614366596005 63.40404589431717,10.083942548761158 63.448754744004226,10.183840778224585 63.45215985883641,10.191358182041434 63.407444402216704,10.091614366596005 63.40404589431717)))"
22600007040000,247,125,122,43.6,"MULTIPOLYGON(((10.191358182041434 63.407444402216704,10.183840778224585 63.45215985883641,10.283765438246018 63.455495318841216,10.291128295955854 63.410773388919374,10.191358182041434 63.407444402216704)))"
22650007040000,14601,7353,7248,39.5,"MULTIPOLYGON(((10.291128295955854 63.410773388919374,10.283765438246018 63.455495318841216,10.383715992159292 63.45876108961797,10.390924174308193 63.41403282018512,10.291128295955854 63.410773388919374)))"
22700007040000,55019,28254,26765,38.6,"MULTIPOLYGON(((10.390924174308193 63.41403282018512,10.383715992159292 63.45876108961797,10.483691902426644 63.46195713746866,10.490745282203042 63.41722266247311,10.390924174308193 63.41403282018512)))"
22750007040000,15388,7690,7698,38.7,"MULTIPOLYGON(((10.490745282203042 63.41722266247311,10.483691902426644 63.46195713746866,10.58369263065614 63.4650834293991,10.590591083897918 63.42034288294333,10.490745282203042 63.41722266247311)))"
22800007040000,6754,3416,3338,39.3,"MULTIPOLYGON(((10.590591083897918 63.42034288294333,10.58369263065614 63.4650834293991,10.683717637619148 63.46813993312035,10.690461042820603 63.423393449457684,10.590591083897918 63.42034288294333)))"
22850007040000,1871,968,903,33.9,"MULTIPOLYGON(((10.690461042820603 63.423393449457684,10.683717637619148 63.46813993312035,10.783766383267897 63.47112661705002,10.790354621586577 63.42637433058141,10.690461042820603 63.423393449457684)))"
22900007040000,574,278,296,37.8,"MULTIPOLYGON(((10.790354621586577 63.42637433058141,10.783766383267897 63.47112661705002,10.883838326753096 63.47404345031357,10.890271282016466 63.42928549558432,10.790354621586577 63.42637433058141)))"
22950007040000,9852,4841,5011,43.2,"MULTIPOLYGON(((10.890271282016466 63.42928549558432,10.883838326753096 63.47404345031357,10.983932926441613 63.47689040274554,10.990210485153602 63.43212691444207,10.890271282016466 63.42928549558432)))"
23000007040000,681,364,317,40.2,"MULTIPOLYGON(((10.990210485153602 63.43212691444207,10.983932926441613 63.47689040274554,11.084049639934248 63.479667444890765,11.090171691281625 63.434898557837386,10.990210485153602 63.43212691444207)))"
23050007040000,1262,632,630,39.3,"MULTIPOLYGON(((11.090171691281625 63.434898557837386,11.084049639934248 63.479667444890765,11.184187924083536 63.48237454800561,11.190154359942166 63.437600397161205,11.090171691281625 63.434898557837386)))"
23100007040000,165,91,74,39.7,"MULTIPOLYGON(((11.190154359942166 63.437600397161205,11.184187924083536 63.48237454800561,11.284347235011644 63.485011684059124,11.290157949952581 63.44023240451382,11.190154359942166 63.437600397161205)))"
23150007040000,158,90,68,41.6,"MULTIPOLYGON(((11.290157949952581 63.44023240451382,11.284347235011644 63.485011684059124,11.384527028128293 63.48757882573418,11.39018191942373 63.44279455270615,11.290157949952581 63.44023240451382)))"
23200007040000,89,45,44,41.8,"MULTIPOLYGON(((11.39018191942373 63.44279455270615,11.384527028128293 63.48757882573418,11.484726758148785 63.490075946428625,11.490225725777861 63.44528681526067,11.39018191942373 63.44279455270615)))"
23250007040000,8,4,4,41.9,"MULTIPOLYGON(((11.490225725777861 63.44528681526067,11.484726758148785 63.490075946428625,11.584945879112055 63.492503020256244,11.590288825766503 63.44770916641265,11.490225725777861 63.44528681526067)))"
23300007040000,1,0,1,0,"MULTIPOLYGON(((11.590288825766503 63.44770916641265,11.584945879112055 63.492503020256244,11.685183844398786 63.49486002204805,11.690370675488444 63.45006158111105,11.590288825766503 63.44770916641265)))"
23350007040000,3,2,1,0,"MULTIPOLYGON(((11.690370675488444 63.45006158111105,11.685183844398786 63.49486002204805,11.785440106749595 63.49714692735305,11.790470730407762 63.452344035019664,11.690370675488444 63.45006158111105)))"
23400007040000,1,1,0,0,"MULTIPOLYGON(((11.790470730407762 63.452344035019664,11.785440106749595 63.49714692735305,11.885714118283259 63.49936371243941,11.890588445371888 63.45455650451804,11.790470730407762 63.452344035019664)))"
21350007045000,13,3,10,33.6,"MULTIPOLYGON(((7.69569257030136 63.34623716392997,7.684321638496386 63.390746420548155,7.783578082778932 63.39582091881756,7.794798030543419 63.351301874438164,7.69569257030136 63.34623716392997)))"
21400007045000,139,75,64,43.4,"MULTIPOLYGON(((7.794798030543419 63.351301874438164,7.783578082778932 63.39582091881756,7.88287372633539 63.40082666539248,7.893942495973306 63.35629796247698,7.794798030543419 63.351301874438164)))"
21450007045000,11,6,5,45.6,"MULTIPOLYGON(((7.893942495973306 63.35629796247698,7.88287372633539 63.40082666539248,7.982208055995328 63.40576360925469,7.993125455857053 63.361225377263224,7.893942495973306 63.35629796247698)))"
21500007045000,13,8,5,40.5,"MULTIPOLYGON(((7.993125455857053 63.361225377263224,7.982208055995328 63.40576360925469,8.08158055731327 63.41063170005077,8.092346398196081 63.366084068675775,7.993125455857053 63.361225377263224)))"
21550007045000,67,33,34,38.6,"MULTIPOLYGON(((8.092346398196081 63.366084068675775,8.08158055731327 63.41063170005077,8.180990714584132 63.4154308880941,8.191604809742545 63.370873987257255,8.092346398196081 63.366084068675775)))"
21600007045000,31,15,16,55.8,"MULTIPOLYGON(((8.191604809742545 63.370873987257255,8.180990714584132 63.4154308880941,8.280438010858731 63.42016112436696,8.290900176014707 63.37559508421633,8.191604809742545 63.370873987257255)))"
21700007045000,2,1,1,0,"MULTIPOLYGON(((8.390231981312477 63.38024731142929,8.379921927959444 63.42482236052223,8.479441946495923 63.42941454888553,8.489599708733023 63.38483062144222,8.390231981312477 63.38024731142929)))"
21750007045000,3,2,1,0,"MULTIPOLYGON(((8.489599708733023 63.38483062144222,8.479441946495923 63.42941454888553,8.578997545880929 63.43393764245702,8.589002840186447 63.38934496747278,8.489599708733023 63.38483062144222)))"
21850007045000,105,55,50,40.3,"MULTIPOLYGON(((8.688440856411633 63.39379030341202,8.678588204346255 63.43839159491327,8.77821339895876 63.4427763606092,8.787913236992107 63.398166583826296,8.688440856411633 63.39379030341202)))"
21900007045000,26,15,11,43.3,"MULTIPOLYGON(((8.787913236992107 63.398166583826296,8.77821339895876 63.4427763606092,8.877872605636473 63.44709189457973,8.887419460372058 63.40247376395904,8.787913236992107 63.398166583826296)))"
21950007045000,26,16,10,43.1,"MULTIPOLYGON(((8.887419460372058 63.40247376395904,8.877872605636473 63.44709189457973,8.977565299164837 63.451338152541716,8.986959003872418 63.40671179973255,8.887419460372058 63.40247376395904)))"
22000007045000,68,39,29,47.5,"MULTIPOLYGON(((8.986959003872418 63.40671179973255,8.977565299164837 63.451338152541716,9.077290953212987 63.45551509089572,9.086531343707032 63.410880647749735,8.986959003872418 63.40671179973255)))"
22050007045000,34,17,17,54.4,"MULTIPOLYGON(((9.086531343707032 63.410880647749735,9.077290953212987 63.45551509089572,9.177049040350154 63.4596226667277,9.18613595499894 63.414980265295874,9.086531343707032 63.410880647749735)))"
22100007045000,19,9,10,53.4,"MULTIPOLYGON(((9.18613595499894 63.414980265295874,9.177049040350154 63.4596226667277,9.276839032062178 63.46366083781075,9.285772311796745 63.419010610340294,9.18613595499894 63.414980265295874)))"
22150007045000,32,21,11,49.6,"MULTIPOLYGON(((9.285772311796745 63.419010610340294,9.276839032062178 63.46366083781075,9.376660398768056 63.467629562606774,9.38543988709103 63.42297164153808,9.285772311796745 63.419010610340294)))"
22200007045000,32,17,15,34.3,"MULTIPOLYGON(((9.38543988709103 63.42297164153808,9.376660398768056 63.467629562606774,9.476512609836636 63.47152880026825,9.485138152830926 63.42686331823172,9.38543988709103 63.42297164153808)))"
22250007045000,5,2,3,66.4,"MULTIPOLYGON(((9.485138152830926 63.42686331823172,9.476512609836636 63.47152880026825,9.576395133603354 63.47535851063973,9.584866579940718 63.43068560045273,9.485138152830926 63.42686331823172)))"
22350007045000,66,37,29,39.5,"MULTIPOLYGON(((9.68462463833656 63.43443844892326,9.67630743738709 63.479118654259594,9.776248987507067 63.482809192361586,9.78441179694325 63.43812182505774,9.68462463833656 63.43443844892326)))"
22400007045000,78,40,38,42.9,"MULTIPOLYGON(((9.78441179694325 63.43812182505774,9.776248987507067 63.482809192361586,9.876219249299902 63.48643008687633,9.884227523711123 63.44173569096426,9.78441179694325 63.43812182505774)))"
22450007045000,105,59,46,47.3,"MULTIPOLYGON(((9.884227523711123 63.44173569096426,9.876219249299902 63.48643008687633,9.976217687136653 63.489981300432966,9.984071285632986 63.44528000944635,9.884227523711123 63.44173569096426)))"
22500007045000,26,16,10,45.1,"MULTIPOLYGON(((9.984071285632986 63.44528000944635,9.976217687136653 63.489981300432966,10.076243764440017 63.49346279636056,10.083942548761158 63.448754744004226,9.984071285632986 63.44528000944635)))"
22850007045000,69,37,32,40.5,"MULTIPOLYGON(((10.683717637619148 63.46813993312035,10.676950493598362 63.51288573671252,10.77715494698213 63.51587824155519,10.783766383267897 63.47112661705002,10.683717637619148 63.46813993312035)))"
22900007045000,2119,1055,1064,39.2,"MULTIPOLYGON(((10.783766383267897 63.47112661705002,10.77715494698213 63.51587824155519,10.877382715158715 63.51880076077348,10.883838326753096 63.47404345031357,10.783766383267897 63.47112661705002)))"
22950007045000,6946,3498,3448,39.8,"MULTIPOLYGON(((10.883838326753096 63.47404345031357,10.877382715158715 63.51880076077348,10.977633253800791 63.52165326405984,10.983932926441613 63.47689040274554,10.883838326753096 63.47404345031357)))"
23000007045000,338,172,166,38.7,"MULTIPOLYGON(((10.983932926441613 63.47689040274554,10.977633253800791 63.52165326405984,11.077906017808479 63.524435721820396,11.084049639934248 63.479667444890765,10.983932926441613 63.47689040274554)))"
23050007045000,691,358,333,38.2,"MULTIPOLYGON(((11.084049639934248 63.479667444890765,11.077906017808479 63.524435721820396,11.178200461327346 63.52714810517601,11.184187924083536 63.48237454800561,11.084049639934248 63.479667444890765)))"
23100007045000,75,40,35,39.2,"MULTIPOLYGON(((11.184187924083536 63.48237454800561,11.178200461327346 63.52714810517601,11.27851603776642 63.52979038596361,11.284347235011644 63.485011684059124,11.184187924083536 63.48237454800561)))"
23150007045000,161,87,74,39.6,"MULTIPOLYGON(((11.284347235011644 63.485011684059124,11.27851603776642 63.52979038596361,11.378852199816281 63.532362536737246,11.384527028128293 63.48757882573418,11.284347235011644 63.485011684059124)))"
23200007045000,39,22,17,46.6,"MULTIPOLYGON(((11.384527028128293 63.48757882573418,11.378852199816281 63.532362536737246,11.479208399467224 63.53486453076923,11.484726758148785 63.490075946428625,11.384527028128293 63.48757882573418)))"
23400007045000,2,0,2,0,"MULTIPOLYGON(((11.785440106749595 63.49714692735305,11.780391733807983 63.54194931593506,11.88082259039902 63.544170430126556,11.885714118283259 63.49936371243941,11.785440106749595 63.49714692735305)))"
21400007050000,297,154,143,43.3,"MULTIPOLYGON(((7.783578082778932 63.39582091881756,7.772318935525472 63.44033857805712,7.871766270381484 63.44535401290665,7.88287372633539 63.40082666539248,7.783578082778932 63.39582091881756)))"
21450007050000,60,29,31,46,"MULTIPOLYGON(((7.88287372633539 63.40082666539248,7.871766270381484 63.44535401290665,7.971252484265663 63.45030051520393,7.982208055995328 63.40576360925469,7.88287372633539 63.40082666539248)))"
21500007050000,103,52,51,42.7,"MULTIPOLYGON(((7.982208055995328 63.40576360925469,7.971252484265663 63.45030051520393,8.070777060270196 63.455178034361865,8.08158055731327 63.41063170005077,7.982208055995328 63.40576360925469)))"
21550007050000,255,140,115,49.8,"MULTIPOLYGON(((8.08158055731327 63.41063170005077,8.070777060270196 63.455178034361865,8.170339480217228 63.45998652046306,8.180990714584132 63.4154308880941,8.08158055731327 63.41063170005077)))"
21650007050000,12,8,4,37.2,"MULTIPOLYGON(((8.280438010858731 63.42016112436696,8.269939224674518 63.46472592426189,8.369575772971158 63.469396197186505,8.379921927959444 63.42482236052223,8.280438010858731 63.42016112436696)))"
21700007050000,19,11,8,58.2,"MULTIPOLYGON(((8.379921927959444 63.42482236052223,8.369575772971158 63.469396197186505,8.469248603213472 63.47399729134055,8.479441946495923 63.42941454888553,8.379921927959444 63.42482236052223)))"
21750007050000,13,8,5,41,"MULTIPOLYGON(((8.479441946495923 63.42941454888553,8.469248603213472 63.47399729134055,8.568957192300932 63.478529159505335,8.578997545880929 63.43393764245702,8.479441946495923 63.42941454888553)))"
21800007050000,10,5,5,73.3,"MULTIPOLYGON(((8.578997545880929 63.43393764245702,8.568957192300932 63.478529159505335,8.668701015942228 63.48299175514157,8.678588204346255 63.43839159491327,8.578997545880929 63.43393764245702)))"
21850007050000,16,8,8,57.5,"MULTIPOLYGON(((8.678588204346255 63.43839159491327,8.668701015942228 63.48299175514157,8.768479548671422 63.48738503239129,8.77821339895876 63.4427763606092,8.678588204346255 63.43839159491327)))"
21900007050000,20,11,9,44,"MULTIPOLYGON(((8.77821339895876 63.4427763606092,8.768479548671422 63.48738503239129,8.868292263864186 63.491708946079605,8.877872605636473 63.44709189457973,8.77821339895876 63.4427763606092)))"
21950007050000,2,1,1,0,"MULTIPOLYGON(((8.877872605636473 63.44709189457973,8.868292263864186 63.491708946079605,8.968138633754155 63.49596345171666,8.977565299164837 63.451338152541716,8.877872605636473 63.44709189457973)))"
22000007050000,4,2,2,0,"MULTIPOLYGON(((8.977565299164837 63.451338152541716,8.968138633754155 63.49596345171666,9.068018129449346 63.500148505499304,9.077290953212987 63.45551509089572,8.977565299164837 63.451338152541716)))"
22050007050000,126,78,48,42.5,"MULTIPOLYGON(((9.077290953212987 63.45551509089572,9.068018129449346 63.500148505499304,9.167930220948707 63.50426406431286,9.177049040350154 63.4596226667277,9.077290953212987 63.45551509089572)))"
22100007050000,125,63,62,40.4,"MULTIPOLYGON(((9.177049040350154 63.4596226667277,9.167930220948707 63.50426406431286,9.267874377158726 63.50831008573292,9.276839032062178 63.46366083781075,9.177049040350154 63.4596226667277)))"
22150007050000,3,3,0,0,"MULTIPOLYGON(((9.276839032062178 63.46366083781075,9.267874377158726 63.50831008573292,9.367850065910147 63.512286528027026,9.376660398768056 63.467629562606774,9.276839032062178 63.46366083781075)))"
22200007050000,22,14,8,59.5,"MULTIPOLYGON(((9.376660398768056 63.467629562606774,9.367850065910147 63.512286528027026,9.467856753974779 63.5161933501563,9.476512609836636 63.47152880026825,9.376660398768056 63.467629562606774)))"
22250007050000,4,3,1,0,"MULTIPOLYGON(((9.476512609836636 63.47152880026825,9.467856753974779 63.5161933501563,9.567893907082368 63.520030511777215,9.576395133603354 63.47535851063973,9.476512609836636 63.47152880026825)))"
22350007050000,9,5,4,54.1,"MULTIPOLYGON(((9.67630743738709 63.479118654259594,9.667960989937592 63.523797973243134,9.768057466237106 63.52749569560594,9.776248987507067 63.482809192361586,9.67630743738709 63.479118654259594)))"
22400007050000,861,424,437,44.5,"MULTIPOLYGON(((9.776248987507067 63.482809192361586,9.768057466237106 63.52749569560594,9.868182798686705 63.531123640617636,9.876219249299902 63.48643008687633,9.776248987507067 63.482809192361586)))"
22450007050000,231,126,105,37.9,"MULTIPOLYGON(((9.876219249299902 63.48643008687633,9.868182798686705 63.531123640617636,9.968336449018526 63.534681770731844,9.976217687136653 63.489981300432966,9.876219249299902 63.48643008687633)))"
22500007050000,1288,654,634,41.3,"MULTIPOLYGON(((9.976217687136653 63.489981300432966,9.968336449018526 63.534681770731844,10.068517878008397 63.53817004910542,10.076243764440017 63.49346279636056,9.976217687136653 63.489981300432966)))"
22550007050000,210,102,108,40.3,"MULTIPOLYGON(((10.076243764440017 63.49346279636056,10.068517878008397 63.53817004910542,10.168726545493183 63.54158843959981,10.176296943701566 63.49687453868971,10.076243764440017 63.49346279636056)))"
22600007050000,3,2,1,0,"MULTIPOLYGON(((10.176296943701566 63.49687453868971,10.168726545493183 63.54158843959981,10.268961910388288 63.54493690678272,10.276376686499077 63.5002164921539,10.176296943701566 63.49687453868971)))"
22800007050000,86,47,39,46.8,"MULTIPOLYGON(((10.576769898544324 63.509823277265305,10.56982276523647 63.55456242476116,10.670159491113136 63.55763085854733,10.676950493598362 63.51288573671252,10.576769898544324 63.509823277265305)))"
22850007050000,163,85,78,37.6,"MULTIPOLYGON(((10.676950493598362 63.51288573671252,10.670159491113136 63.55763085854733,10.770520195771796 63.56062920250194,10.77715494698213 63.51587824155519,10.676950493598362 63.51288573671252)))"
22900007050000,458,238,220,44.1,"MULTIPOLYGON(((10.77715494698213 63.51587824155519,10.770520195771796 63.56062920250194,10.870904332970097 63.56355742545887,10.877382715158715 63.51880076077348,10.77715494698213 63.51587824155519)))"
22950007050000,64,37,27,42.1,"MULTIPOLYGON(((10.877382715158715 63.51880076077348,10.870904332970097 63.56355742545887,10.971311355668593 63.5664154969676,10.977633253800791 63.52165326405984,10.877382715158715 63.51880076077348)))"
23000007050000,152,81,71,41.6,"MULTIPOLYGON(((10.977633253800791 63.52165326405984,10.971311355668593 63.5664154969676,11.07174071604878 63.56920338729457,11.077906017808479 63.524435721820396,10.977633253800791 63.52165326405984)))"
23050007050000,25,15,10,36.4,"MULTIPOLYGON(((11.077906017808479 63.524435721820396,11.07174071604878 63.56920338729457,11.172191865531211 63.57192106742434,11.178200461327346 63.52714810517601,11.077906017808479 63.524435721820396)))"
23450007050000,6,3,3,56.3,"MULTIPOLYGON(((11.88082259039902 63.544170430126556,11.87591377472879 63.58897665685812,11.976519402884481 63.591131697409594,11.981270734677683 63.54632126474931,11.88082259039902 63.544170430126556)))"
21500007055000,278,140,138,42.9,"MULTIPOLYGON(((7.971252484265663 63.45030051520393,7.96025855020396 63.49483609016572,8.059935719075545 63.49972306680855,8.070777060270196 63.455178034361865,7.971252484265663 63.45030051520393)))"
21550007055000,133,61,72,48.9,"MULTIPOLYGON(((8.070777060270196 63.455178034361865,8.059935719075545 63.49972306680855,8.159650921133634 63.50454087970651,8.170339480217228 63.45998652046306,8.070777060270196 63.455178034361865)))"
21650007055000,15,9,6,48.4,"MULTIPOLYGON(((8.269939224674518 63.46472592426189,8.259403634447146 63.509289479384734,8.359193335836064 63.513968817044976,8.369575772971158 63.469396197186505,8.269939224674518 63.46472592426189)))"
21700007055000,3,2,1,0,"MULTIPOLYGON(((8.369575772971158 63.469396197186505,8.359193335836064 63.513968817044976,8.459019500887406 63.51857884456768,8.469248603213472 63.47399729134055,8.369575772971158 63.469396197186505)))"
21950007055000,8,2,6,46.1,"MULTIPOLYGON(((8.868292263864186 63.491708946079605,8.858678267207102 63.53632491475052,8.958678842353402 63.540587693677395,8.968138633754155 63.49596345171666,8.868292263864186 63.491708946079605)))"
22000007055000,133,71,62,47.3,"MULTIPOLYGON(((8.968138633754155 63.49596345171666,8.958678842353402 63.540587693677395,9.05871270969946 63.54478088810673,9.068018129449346 63.500148505499304,8.968138633754155 63.49596345171666)))"
22050007055000,400,220,180,42.7,"MULTIPOLYGON(((9.068018129449346 63.500148505499304,9.05871270969946 63.54478088810673,9.158779336657306 63.54890445472196,9.167930220948707 63.50426406431286,9.068018129449346 63.500148505499304)))"
22100007055000,19,9,10,52,"MULTIPOLYGON(((9.167930220948707 63.50426406431286,9.158779336657306 63.54890445472196,9.258878189537374 63.55295835089989,9.267874377158726 63.50831008573292,9.167930220948707 63.50426406431286)))"
22150007055000,53,33,20,43.4,"MULTIPOLYGON(((9.267874377158726 63.50831008573292,9.258878189537374 63.55295835089989,9.35900873356535 63.55694253471237,9.367850065910147 63.512286528027026,9.267874377158726 63.50831008573292)))"
22200007055000,4,1,3,0,"MULTIPOLYGON(((9.367850065910147 63.512286528027026,9.35900873356535 63.55694253471237,9.459170432899112 63.56085696492804,9.467856753974779 63.5161933501563,9.367850065910147 63.512286528027026)))"
22250007055000,8,5,3,46.8,"MULTIPOLYGON(((9.467856753974779 63.5161933501563,9.459170432899112 63.56085696492804,9.559362750645743 63.56470160101395,9.567893907082368 63.520030511777215,9.467856753974779 63.5161933501563)))"
22300007055000,7,4,3,72.6,"MULTIPOLYGON(((9.567893907082368 63.520030511777215,9.559362750645743 63.56470160101395,9.659585148878655 63.56847640313731,9.667960989937592 63.523797973243134,9.567893907082368 63.520030511777215)))"
22350007055000,5,1,4,34.6,"MULTIPOLYGON(((9.667960989937592 63.523797973243134,9.659585148878655 63.56847640313731,9.759837088654791 63.57218133216693,9.768057466237106 63.52749569560594,9.667960989937592 63.523797973243134)))"
22400007055000,53,27,26,56.2,"MULTIPOLYGON(((9.768057466237106 63.52749569560594,9.759837088654791 63.57218133216693,9.860118030031884 63.57581634967502,9.868182798686705 63.531123640617636,9.768057466237106 63.52749569560594)))"
22450007055000,535,284,251,41.6,"MULTIPOLYGON(((9.868182798686705 63.531123640617636,9.860118030031884 63.57581634967502,9.960427432085863 63.579381417938585,9.968336449018526 63.534681770731844,9.868182798686705 63.531123640617636)))"
22500007055000,160,85,75,41,"MULTIPOLYGON(((9.968336449018526 63.534681770731844,9.960427432085863 63.579381417938585,10.060764752928273 63.58287649994106,10.068517878008397 63.53817004910542,9.968336449018526 63.534681770731844)))"
22550007055000,146,76,70,43.9,"MULTIPOLYGON(((10.068517878008397 63.53817004910542,10.060764752928273 63.58287649994106,10.161129449723822 63.58630155937374,10.168726545493183 63.54158843959981,10.068517878008397 63.53817004910542)))"
22600007055000,910,447,463,43,"MULTIPOLYGON(((10.168726545493183 63.54158843959981,10.161129449723822 63.58630155937374,10.261520978707987 63.58965656063736,10.268961910388288 63.54493690678272,10.168726545493183 63.54158843959981)))"
22650007055000,24,11,13,47.5,"MULTIPOLYGON(((10.268961910388288 63.54493690678272,10.261520978707987 63.58965656063736,10.361938795204704 63.592941468843506,10.36922343070519 63.54821541592936,10.268961910388288 63.54493690678272)))"
22700007055000,197,96,101,42.3,"MULTIPOLYGON(((10.36922343070519 63.54821541592936,10.361938795204704 63.592941468843506,10.46238235364414 63.59615624981597,10.469510563569065 63.55142393302397,10.36922343070519 63.54821541592936)))"
22800007055000,61,22,39,53.1,"MULTIPOLYGON(((10.56982276523647 63.55456242476116,10.562851107580519 63.59930087009229,10.663344509710067 63.60237529692496,10.670159491113136 63.55763085854733,10.56982276523647 63.55456242476116)))"
22850007055000,1480,723,757,44,"MULTIPOLYGON(((10.670159491113136 63.55763085854733,10.663344509710067 63.60237529692496,10.763862011888966 63.605379498282936,10.770520195771796 63.56062920250194,10.670159491113136 63.55763085854733)))"
22900007055000,410,208,202,41.1,"MULTIPOLYGON(((10.770520195771796 63.56062920250194,10.763862011888966 63.605379498282936,10.864403065151441 63.60831344285286,10.870904332970097 63.56355742545887,10.770520195771796 63.56062920250194)))"
22950007055000,269,145,124,45.6,"MULTIPOLYGON(((10.870904332970097 63.56355742545887,10.864403065151441 63.60831344285286,10.96496711972788 63.61117710004029,10.971311355668593 63.5664154969676,10.870904332970097 63.56355742545887)))"
23000007055000,1113,552,561,42.1,"MULTIPOLYGON(((10.971311355668593 63.5664154969676,10.96496711972788 63.61117710004029,11.065553625063032 63.61397043997109,11.07174071604878 63.56920338729457,10.971311355668593 63.5664154969676)))"
23050007055000,107,48,59,37.5,"MULTIPOLYGON(((11.07174071604878 63.56920338729457,11.065553625063032 63.61397043997109,11.166162029834272 63.61669343349254,11.172191865531211 63.57192106742434,11.07174071604878 63.56920338729457)))"
23100007055000,17,9,8,42.1,"MULTIPOLYGON(((11.172191865531211 63.57192106742434,11.166162029834272 63.61669343349254,11.266791781969927 63.61934605217469,11.272664254793693 63.57456850906079,11.172191865531211 63.57192106742434)))"
23150007055000,46,23,23,37.9,"MULTIPOLYGON(((11.272664254793693 63.57456850906079,11.266791781969927 63.61934605217469,11.367442328667684 63.62192826831133,11.373157333789507 63.577145684628285,11.272664254793693 63.57456850906079)))"
21450007060000,137,70,67,45.8,"MULTIPOLYGON(((7.860619935185148 63.48987999992769,7.84943452653431 63.534404621328164,7.949226062076052 63.5393703291601,7.96025855020396 63.49483609016572,7.860619935185148 63.48987999992769)))"
21500007060000,178,80,98,46.9,"MULTIPOLYGON(((7.96025855020396 63.49483609016572,7.949226062076052 63.5393703291601,8.049056344483589 63.54426679255655,8.059935719075545 63.49972306680855,7.96025855020396 63.49483609016572)))"
21700007060000,148,80,68,53.1,"MULTIPOLYGON(((8.359193335836064 63.513968817044976,8.348774434835727 63.558540215689675,8.448754460328656 63.56315920429727,8.459019500887406 63.51857884456768,8.359193335836064 63.513968817044976)))"
21750007060000,37,23,14,53.3,"MULTIPOLYGON(((8.459019500887406 63.51857884456768,8.448754460328656 63.56315920429727,8.548770604242295 63.56770870334923,8.558881603971317 63.52311951451377,8.459019500887406 63.51857884456768)))"
21800007060000,2,1,1,0,"MULTIPOLYGON(((8.558881603971317 63.52311951451377,8.548770604242295 63.56770870334923,8.648822337190545 63.57218866587032,8.658779118257232 63.52759078012674,8.558881603971317 63.52311951451377)))"
21850007060000,32,14,18,37.2,"MULTIPOLYGON(((8.658779118257232 63.52759078012674,8.648822337190545 63.57218866587032,8.748909128593008 63.57659904557268,8.758711515730173 63.53199259533431,8.658779118257232 63.52759078012674)))"
21900007060000,15,7,8,48.9,"MULTIPOLYGON(((8.758711515730173 63.53199259533431,8.748909128593008 63.57659904557268,8.849030446691463 63.58093979685781,8.858678267207102 63.53632491475052,8.758711515730173 63.53199259533431)))"
22000007060000,27,13,14,42.6,"MULTIPOLYGON(((8.958678842353402 63.540587693677395,8.949185758566502 63.58521087481821,9.049374530154191 63.589412235239415,9.05871270969946 63.54478088810673,8.958678842353402 63.540587693677395)))"
22050007060000,115,60,55,42.3,"MULTIPOLYGON(((9.05871270969946 63.54478088810673,9.049374530154191 63.589412235239415,9.149596226262892 63.59354383460162,9.158779336657306 63.54890445472196,9.05871270969946 63.54478088810673)))"
22100007060000,368,188,180,37.7,"MULTIPOLYGON(((9.158779336657306 63.54890445472196,9.149596226262892 63.59354383460162,9.249850310590146 63.59760563008152,9.258878189537374 63.55295835089989,9.158779336657306 63.54890445472196)))"
22150007060000,12,6,6,64.9,"MULTIPOLYGON(((9.258878189537374 63.55295835089989,9.249850310590146 63.59760563008152,9.35013624573964 63.60159757955401,9.35900873356535 63.55694253471237,9.258878189537374 63.55295835089989)))"
22200007060000,4,2,2,0,"MULTIPOLYGON(((9.35900873356535 63.55694253471237,9.35013624573964 63.60159757955401,9.450453493238294 63.605519641593986,9.459170432899112 63.56085696492804,9.35900873356535 63.55694253471237)))"
22250007060000,20,12,8,63.6,"MULTIPOLYGON(((9.459170432899112 63.56085696492804,9.450453493238294 63.605519641593986,9.550801513553422 63.609371775477875,9.559362750645743 63.56470160101395,9.459170432899112 63.56085696492804)))"
22300007060000,54,27,27,52.7,"MULTIPOLYGON(((9.559362750645743 63.56470160101395,9.550801513553422 63.609371775477875,9.651179766109973 63.61315394118544,9.659585148878655 63.56847640313731,9.559362750645743 63.56470160101395)))"
22350007060000,121,60,61,50.4,"MULTIPOLYGON(((9.659585148878655 63.56847640313731,9.651179766109973 63.61315394118544,9.751587709307872 63.61686609940134,9.759837088654791 63.57218133216693,9.659585148878655 63.56847640313731)))"
22400007060000,32,22,10,34.8,"MULTIPOLYGON(((9.759837088654791 63.57218133216693,9.751587709307872 63.61686609940134,9.852024800539454 63.62050821151674,9.860118030031884 63.57581634967502,9.759837088654791 63.57218133216693)))"
22450007060000,1139,551,588,46.4,"MULTIPOLYGON(((9.860118030031884 63.57581634967502,9.852024800539454 63.62050821151674,9.952490496206961 63.62408023963085,9.960427432085863 63.579381417938585,9.860118030031884 63.57581634967502)))"
22500007060000,918,463,455,42.3,"MULTIPOLYGON(((9.960427432085863 63.579381417938585,9.952490496206961 63.62408023963085,10.052984251740142 63.6275821465526,10.060764752928273 63.58287649994106,9.960427432085863 63.579381417938585)))"
22550007060000,138,76,62,40.5,"MULTIPOLYGON(((10.060764752928273 63.58287649994106,10.052984251740142 63.6275821465526,10.153505521613923 63.631013895802,10.161129449723822 63.58630155937374,10.060764752928273 63.58287649994106)))"
22600007060000,68,36,32,45.8,"MULTIPOLYGON(((10.161129449723822 63.58630155937374,10.153505521613923 63.631013895802,10.25405375936617 63.634375451611774,10.261520978707987 63.58965656063736,10.161129449723822 63.58630155937374)))"
22700007060000,2,1,1,0,"MULTIPOLYGON(((10.361938795204704 63.592941468843506,10.354628417615512 63.63766677892871,10.455228948079263 63.640887843415186,10.46238235364414 63.59615624981597,10.361938795204704 63.592941468843506)))"
22750007060000,17,7,10,45.2,"MULTIPOLYGON(((10.46238235364414 63.59615624981597,10.455228948079263 63.640887843415186,10.555854801591401 63.64403861145057,10.562851107580519 63.59930087009229,10.46238235364414 63.59615624981597)))"
22800007060000,24,13,11,42.2,"MULTIPOLYGON(((10.562851107580519 63.59930087009229,10.555854801591401 63.64403861145057,10.656505428120647 63.6471190501325,10.663344509710067 63.60237529692496,10.562851107580519 63.59930087009229)))"
22850007060000,100,49,51,42.2,"MULTIPOLYGON(((10.663344509710067 63.60237529692496,10.656505428120647 63.6471190501325,10.757180276788585 63.650129127278404,10.763862011888966 63.605379498282936,10.663344509710067 63.60237529692496)))"
22900007060000,373,192,181,44,"MULTIPOLYGON(((10.763862011888966 63.605379498282936,10.757180276788585 63.650129127278404,10.857878795887881 63.65306881142668,10.864403065151441 63.60831344285286,10.763862011888966 63.605379498282936)))"
22950007060000,89,54,35,43.6,"MULTIPOLYGON(((10.864403065151441 63.60831344285286,10.857878795887881 63.65306881142668,10.95860043290056 63.65593807183807,10.96496711972788 63.61117710004029,10.864403065151441 63.60831344285286)))"
23000007060000,86,48,38,42.3,"MULTIPOLYGON(((10.96496711972788 63.61117710004029,10.95860043290056 63.65593807183807,11.059344634516359 63.65873687849694,11.065553625063032 63.61397043997109,10.96496711972788 63.61117710004029)))"
23050007060000,273,143,130,41.1,"MULTIPOLYGON(((11.065553625063032 63.61397043997109,11.059344634516359 63.65873687849694,11.160110846651138 63.66146520211242,11.166162029834272 63.61669343349254,11.065553625063032 63.61397043997109)))"
23100007060000,330,171,159,41.2,"MULTIPOLYGON(((11.166162029834272 63.61669343349254,11.160110846651138 63.66146520211242,11.260898514465362 63.664123014119745,11.266791781969927 63.61934605217469,11.166162029834272 63.61669343349254)))"
23150007060000,222,114,108,41.6,"MULTIPOLYGON(((11.266791781969927 63.61934605217469,11.260898514465362 63.664123014119745,11.361707082382658 63.66671028668134,11.367442328667684 63.62192826831133,11.266791781969927 63.61934605217469)))"
23500007060000,40,23,17,52.7,"MULTIPOLYGON(((11.97175125033038 63.6359416516157,11.966966191633867 63.68075112670093,12.067905446162476 63.68284390501167,12.072531823014288 63.6380303351962,11.97175125033038 63.6359416516157)))"
23600007060000,6,2,4,27.2,"MULTIPOLYGON(((12.173328743765547 63.64004842077106,12.168861131902498 63.68486594748819,12.269832687490469 63.686817232886185,12.27414145404352 63.64199588719658,12.173328743765547 63.64004842077106)))"
21750007065000,21,14,7,47,"MULTIPOLYGON(((8.448754460328656 63.56315920429727,8.438453301147407 63.60773836622948,8.538624015279595 63.61229672184932,8.548770604242295 63.56770870334923,8.448754460328656 63.56315920429727)))"
21800007065000,68,42,26,47.9,"MULTIPOLYGON(((8.548770604242295 63.56770870334923,8.538624015279595 63.61229672184932,8.638830497473338 63.61678540834552,8.648822337190545 63.57218866587032,8.548770604242295 63.56770870334923)))"
21850007065000,50,25,25,40.5,"MULTIPOLYGON(((8.648822337190545 63.57218866587032,8.638830497473338 63.61678540834552,8.739072214566304 63.62120437921324,8.748909128593008 63.57659904557268,8.648822337190545 63.57218866587032)))"
21900007065000,11,6,5,35.3,"MULTIPOLYGON(((8.748909128593008 63.57659904557268,8.739072214566304 63.62120437921324,8.839348632208496 63.62555358864004,8.849030446691463 63.58093979685781,8.748909128593008 63.57659904557268)))"
21950007065000,180,96,84,40.6,"MULTIPOLYGON(((8.849030446691463 63.58093979685781,8.839348632208496 63.62555358864004,8.939659214878992 63.62983299150761,8.949185758566502 63.58521087481821,8.849030446691463 63.58093979685781)))"
22000007065000,1443,694,749,42.2,"MULTIPOLYGON(((8.949185758566502 63.58521087481821,8.939659214878992 63.62983299150761,9.040003425902762 63.634042543393825,9.049374530154191 63.589412235239415,8.949185758566502 63.58521087481821)))"
22050007065000,47,23,24,44.5,"MULTIPOLYGON(((9.049374530154191 63.589412235239415,9.040003425902762 63.634042543393825,9.140380727467619 63.63818220057426,9.149596226262892 63.59354383460162,9.049374530154191 63.589412235239415)))"
22100007065000,37,23,14,41.1,"MULTIPOLYGON(((9.149596226262892 63.59354383460162,9.140380727467619 63.63818220057426,9.240790580641205 63.6422519200243,9.249850310590146 63.59760563008152,9.149596226262892 63.59354383460162)))"
22150007065000,32,16,16,39.7,"MULTIPOLYGON(((9.249850310590146 63.59760563008152,9.240790580641205 63.6422519200243,9.341232445388156 63.64625165942058,9.35013624573964 63.60159757955401,9.249850310590146 63.59760563008152)))"
22250007065000,165,81,84,44.9,"MULTIPOLYGON(((9.450453493238294 63.605519641593986,9.441705780587274 63.650181377142935,9.54221004404884 63.65404103227595,9.550801513553422 63.609371775477875,9.450453493238294 63.605519641593986)))"
22300007065000,154,77,77,52.9,"MULTIPOLYGON(((9.550801513553422 63.609371775477875,9.54221004404884 63.65404103227595,9.642744692532 63.65783058461075,9.651179766109973 63.61315394118544,9.550801513553422 63.609371775477875)))"
22350007065000,161,85,76,46.8,"MULTIPOLYGON(((9.651179766109973 63.61315394118544,9.642744692532 63.65783058461075,9.743309181762251 63.66154999464656,9.751587709307872 63.61686609940134,9.651179766109973 63.61315394118544)))"
22400007065000,267,143,124,47.1,"MULTIPOLYGON(((9.751587709307872 63.61686609940134,9.743309181762251 63.66154999464656,9.84390296644901 63.66519922359235,9.852024800539454 63.62050821151674,9.751587709307872 63.61686609940134)))"
22450007065000,85,45,40,49.6,"MULTIPOLYGON(((9.852024800539454 63.62050821151674,9.84390296644901 63.66519922359235,9.94452550030324 63.66877823336844,9.952490496206961 63.62408023963085,9.852024800539454 63.62050821151674)))"
22550007065000,130,72,58,44.3,"MULTIPOLYGON(((10.052984251740142 63.6275821465526,10.045176236055223 63.672286986608015,10.145854625472351 63.6757254466587,10.153505521613923 63.631013895802,10.052984251740142 63.6275821465526)))"
22600007065000,115,66,49,41.7,"MULTIPOLYGON(((10.153505521613923 63.631013895802,10.145854625472351 63.6757254466587,10.246560119377035 63.67909357758411,10.25405375936617 63.634375451611774,10.153505521613923 63.631013895802)))"
22650007065000,37,19,18,42.1,"MULTIPOLYGON(((10.25405375936617 63.634375451611774,10.246560119377035 63.67909357758411,10.347292167664687 63.682391344165175,10.354628417615512 63.63766677892871,10.25405375936617 63.634375451611774)))"
22750007065000,11,5,6,42.7,"MULTIPOLYGON(((10.455228948079263 63.640887843415186,10.44805021932178 63.68561871190178,10.548833722443987 63.68877564701407,10.555854801591401 63.64403861145057,10.455228948079263 63.640887843415186)))"
22800007065000,1546,769,777,45.6,"MULTIPOLYGON(((10.555854801591401 63.64403861145057,10.548833722443987 63.68877564701407,10.64964212425438 63.69186211644382,10.656505428120647 63.6471190501325,10.555854801591401 63.64403861145057)))"
22850007065000,91,48,43,47.8,"MULTIPOLYGON(((10.656505428120647 63.6471190501325,10.64964212425438 63.69186211644382,10.750474871121737 63.694878087855926,10.757180276788585 63.650129127278404,10.656505428120647 63.6471190501325)))"
22950007065000,8,4,4,40.6,"MULTIPOLYGON(((10.857878795887881 63.65306881142668,10.851331408578885 63.697823529639614,10.952211181341136 63.70069841090982,10.95860043290056 63.65593807183807,10.857878795887881 63.65306881142668)))"
23000007065000,288,140,148,39.5,"MULTIPOLYGON(((10.95860043290056 63.65593807183807,10.952211181341136 63.70069841090982,11.053113633324806 63.70350270150845,11.059344634516359 63.65873687849694,10.95860043290056 63.65593807183807)))"
23050007065000,569,303,266,37.9,"MULTIPOLYGON(((11.059344634516359 63.65873687849694,11.053113633324806 63.70350270150845,11.154038207665746 63.706236372005556,11.160110846651138 63.66146520211242,11.059344634516359 63.65873687849694)))"
23100007065000,2124,1064,1060,40.9,"MULTIPOLYGON(((11.160110846651138 63.66146520211242,11.154038207665746 63.706236372005556,11.254984346738018 63.70889939370077,11.260898514465362 63.664123014119745,11.160110846651138 63.66146520211242)))"
23150007065000,53,30,23,38.9,"MULTIPOLYGON(((11.260898514465362 63.664123014119745,11.254984346738018 63.70889939370077,11.355951492172576 63.7114917386242,11.361707082382658 63.66671028668134,11.260898514465362 63.664123014119745)))"
23200007065000,39,23,16,47.4,"MULTIPOLYGON(((11.361707082382658 63.66671028668134,11.355951492172576 63.7114917386242,11.45693908487603 63.714013379537825,11.462535994108409 63.66922699268801,11.361707082382658 63.66671028668134)))"
23250007065000,40,19,21,45.8,"MULTIPOLYGON(((11.462535994108409 63.66922699268801,11.45693908487603 63.714013379537825,11.55794656504949 63.716464289936496,11.563384692648448 63.671673105760064,11.462535994108409 63.66922699268801)))"
23400007065000,4,2,2,0,"MULTIPOLYGON(((11.765139218809312 63.67635345123555,11.76001894519668 63.721153816839774,11.861082722215366 63.72339238400846,11.866043929112857 63.67858763453673,11.765139218809312 63.67635345123555)))"
23450007065000,4,2,2,0,"MULTIPOLYGON(((11.866043929112857 63.67858763453673,11.861082722215366 63.72339238400846,11.962164140832027 63.72556012199249,11.966966191633867 63.68075112670093,11.866043929112857 63.67858763453673)))"
21850007070000,212,112,100,40.2,"MULTIPOLYGON(((8.638830497473338 63.61678540834552,8.62880342265896 63.6613810034967,8.729200599795215 63.66580859233494,8.739072214566304 63.62120437921324,8.638830497473338 63.61678540834552)))"
21900007070000,484,275,209,40.8,"MULTIPOLYGON(((8.739072214566304 63.62120437921324,8.729200599795215 63.66580859233494,8.829632652504873 63.67016628630881,8.839348632208496 63.62555358864004,8.739072214566304 63.62120437921324)))"
21950007070000,172,88,84,37.3,"MULTIPOLYGON(((8.839348632208496 63.62555358864004,8.829632652504873 63.67016628630881,8.930099042648672 63.67445404008795,8.939659214878992 63.62983299150761,8.839348632208496 63.62555358864004)))"
22000007070000,223,128,95,40.3,"MULTIPOLYGON(((8.939659214878992 63.62983299150761,8.930099042648672 63.67445404008795,9.030599230923562 63.67867180904106,9.040003425902762 63.634042543393825,8.939659214878992 63.62983299150761)))"
22050007070000,550,302,248,41,"MULTIPOLYGON(((9.040003425902762 63.634042543393825,9.030599230923562 63.67867180904106,9.131132676879762 63.68281954923794,9.140380727467619 63.63818220057426,9.040003425902762 63.634042543393825)))"
22100007070000,22,13,9,45.1,"MULTIPOLYGON(((9.140380727467619 63.63818220057426,9.131132676879762 63.68281954923794,9.23169883893793 63.68689721745118,9.240790580641205 63.6422519200243,9.140380727467619 63.63818220057426)))"
22150007070000,13,10,3,50.5,"MULTIPOLYGON(((9.240790580641205 63.6422519200243,9.23169883893793 63.68689721745118,9.332297174406422 63.69090477115793,9.341232445388156 63.64625165942058,9.240790580641205 63.6422519200243)))"
22200007070000,130,63,67,49.6,"MULTIPOLYGON(((9.341232445388156 63.64625165942058,9.332297174406422 63.69090477115793,9.432927139498618 63.69484216854168,9.441705780587274 63.650181377142935,9.341232445388156 63.64625165942058)))"
22250007070000,3,2,1,0,"MULTIPOLYGON(((9.441705780587274 63.650181377142935,9.432927139498618 63.69484216854168,9.533588189350379 63.698709368493965,9.54221004404884 63.65404103227595,9.441705780587274 63.650181377142935)))"
22300007070000,130,78,52,45.5,"MULTIPOLYGON(((9.54221004404884 63.65404103227595,9.533588189350379 63.698709368493965,9.634279778037582 63.70250633061598,9.642744692532 63.65783058461075,9.54221004404884 63.65404103227595)))"
22350007070000,2452,1234,1218,40.5,"MULTIPOLYGON(((9.642744692532 63.65783058461075,9.634279778037582 63.70250633061598,9.735001358593724 63.7062330152203,9.743309181762251 63.66154999464656,9.642744692532 63.65783058461075)))"
22400007070000,188,99,89,48.4,"MULTIPOLYGON(((9.743309181762251 63.66154999464656,9.735001358593724 63.7062330152203,9.835752383027637 63.70988938333255,9.84390296644901 63.66519922359235,9.743309181762251 63.66154999464656)))"
22450007070000,242,130,112,45.9,"MULTIPOLYGON(((9.84390296644901 63.66519922359235,9.835752383027637 63.70988938333255,9.93653230234129 63.71347539669289,9.94452550030324 63.66877823336844,9.84390296644901 63.66519922359235)))"
22500007070000,35,16,19,55.4,"MULTIPOLYGON(((9.94452550030324 63.66877823336844,9.93653230234129 63.71347539669289,10.037340566547666 63.71699101775773,10.045176236055223 63.672286986608015,9.94452550030324 63.66877823336844)))"
22550007070000,12,6,6,43.5,"MULTIPOLYGON(((10.045176236055223 63.672286986608015,10.037340566547666 63.71699101775773,10.138176624688718 63.720436209701134,10.145854625472351 63.6757254466587,10.045176236055223 63.672286986608015)))"
22600007070000,22,11,11,31.3,"MULTIPOLYGON(((10.145854625472351 63.6757254466587,10.138176624688718 63.720436209701134,10.239039924853437 63.72381093641645,10.246560119377035 63.67909357758411,10.145854625472351 63.6757254466587)))"
22650007070000,103,61,42,44.6,"MULTIPOLYGON(((10.246560119377035 63.67909357758411,10.239039924853437 63.72381093641645,10.339929914195947 63.727115162517705,10.347292167664687 63.682391344165175,10.246560119377035 63.67909357758411)))"
22700007070000,9,5,4,52.8,"MULTIPOLYGON(((10.347292167664687 63.682391344165175,10.339929914195947 63.727115162517705,10.440846038953756 63.730348853341184,10.44805021932178 63.68561871190178,10.347292167664687 63.682391344165175)))"
22750007070000,5,4,1,22.6,"MULTIPOLYGON(((10.44805021932178 63.68561871190178,10.440846038953756 63.730348853341184,10.541787744465996 63.73351197494679,10.548833722443987 63.68877564701407,10.44805021932178 63.68561871190178)))"
22800007070000,196,106,90,43.7,"MULTIPOLYGON(((10.548833722443987 63.68877564701407,10.541787744465996 63.73351197494679,10.642754475191824 63.73660449411943,10.64964212425438 63.69186211644382,10.548833722443987 63.68877564701407)))"
22850007070000,140,72,68,36.8,"MULTIPOLYGON(((10.64964212425438 63.69186211644382,10.642754475191824 63.73660449411943,10.743745674728844 63.7396263783704,10.750474871121737 63.694878087855926,10.64964212425438 63.69186211644382)))"
22900007070000,37,17,20,43.8,"MULTIPOLYGON(((10.750474871121737 63.694878087855926,10.743745674728844 63.7396263783704,10.844760785831609 63.74257759593882,10.851331408578885 63.697823529639614,10.750474871121737 63.694878087855926)))"
22950007070000,9,6,3,42.9,"MULTIPOLYGON(((10.851331408578885 63.697823529639614,10.844760785831609 63.74257759593882,10.945799250430229 63.74545811579282,10.952211181341136 63.70069841090982,10.851331408578885 63.697823529639614)))"
23000007070000,181,101,80,44,"MULTIPOLYGON(((10.952211181341136 63.70069841090982,10.945799250430229 63.74545811579282,11.046860509649008 63.748267907630904,11.053113633324806 63.70350270150845,10.952211181341136 63.70069841090982)))"
23050007070000,23,12,11,55.7,"MULTIPOLYGON(((11.053113633324806 63.70350270150845,11.046860509649008 63.748267907630904,11.147944003825174 63.751006941883226,11.154038207665746 63.706236372005556,11.053113633324806 63.70350270150845)))"
23100007070000,1303,643,660,38.9,"MULTIPOLYGON(((11.154038207665746 63.706236372005556,11.147944003825174 63.751006941883226,11.249049172527664 63.753675189712766,11.254984346738018 63.70889939370077,11.154038207665746 63.706236372005556)))"
23150007070000,9690,4764,4926,41.8,"MULTIPOLYGON(((11.254984346738018 63.70889939370077,11.249049172527664 63.753675189712766,11.350175454576007 63.75627262301655,11.355951492172576 63.7114917386242,11.254984346738018 63.70889939370077)))"
23200007070000,917,478,439,39.6,"MULTIPOLYGON(((11.355951492172576 63.7114917386242,11.350175454576007 63.75627262301655,11.451322288059208 63.75879921442683,11.45693908487603 63.714013379537825,11.355951492172576 63.7114917386242)))"
23250007070000,319,160,159,42.4,"MULTIPOLYGON(((11.45693908487603 63.714013379537825,11.451322288059208 63.75879921442683,11.552489110354763 63.76125493731221,11.55794656504949 63.716464289936496,11.45693908487603 63.714013379537825)))"
23300007070000,331,178,153,39.4,"MULTIPOLYGON(((11.55794656504949 63.716464289936496,11.552489110354763 63.76125493731221,11.653675358147696 63.763639765778805,11.658973372207436 63.718844444049175,11.55794656504949 63.716464289936496)))"
23350007070000,215,111,104,40.8,"MULTIPOLYGON(((11.658973372207436 63.718844444049175,11.653675358147696 63.763639765778805,11.754880467449672 63.76595367467126,11.76001894519668 63.721153816839774,11.658973372207436 63.718844444049175)))"
23400007070000,222,117,105,39.4,"MULTIPOLYGON(((11.76001894519668 63.721153816839774,11.754880467449672 63.76595367467126,11.85610387361815 63.76819663957383,11.861082722215366 63.72339238400846,11.76001894519668 63.721153816839774)))"
21650007075000,100,58,42,48,"MULTIPOLYGON(((8.227574190953424 63.64297263047711,8.21688952979461 63.68753116070637,8.317297113144265 63.69224703979141,8.327826508270883 63.64767933154942,8.227574190953424 63.64297263047711)))"
21700007075000,68,43,25,42,"MULTIPOLYGON(((8.327826508270883 63.64767933154942,8.317297113144265 63.69224703979141,8.417741899294304 63.69689307934919,8.428115841743097 63.65231632603388,8.327826508270883 63.64767933154942)))"
21750007075000,98,56,42,40.7,"MULTIPOLYGON(((8.428115841743097 63.65231632603388,8.417741899294304 63.69689307934919,8.51822335233445 63.70146923104509,8.528441658054627 63.656883565821914,8.428115841743097 63.65231632603388)))"
21800007075000,190,112,78,40.6,"MULTIPOLYGON(((8.528441658054627 63.656883565821914,8.51822335233445 63.70146923104509,8.618740935113065 63.705975447239275,8.62880342265896 63.6613810034967,8.528441658054627 63.656883565821914)))"
21850007075000,29,16,13,43.1,"MULTIPOLYGON(((8.62880342265896 63.6613810034967,8.618740935113065 63.705975447239275,8.719294109253928 63.71041168098863,8.729200599795215 63.66580859233494,8.62880342265896 63.6613810034967)))"
21900007075000,903,467,436,36,"MULTIPOLYGON(((8.729200599795215 63.66580859233494,8.719294109253928 63.71041168098863,8.819882335173142 63.71477788604862,8.829632652504873 63.67016628630881,8.729200599795215 63.66580859233494)))"
21950007075000,256,137,119,36.7,"MULTIPOLYGON(((8.829632652504873 63.67016628630881,8.819882335173142 63.71477788604862,8.920505072096146 63.71907401687524,8.930099042648672 63.67445404008795,8.829632652504873 63.67016628630881)))"
22300007075000,504,250,254,44,"MULTIPOLYGON(((9.533588189350379 63.698709368493965,9.524935795642756 63.743376781196325,9.625784871503452 63.74718117638326,9.634279778037582 63.70250633061598,9.533588189350379 63.698709368493965)))"
22350007075000,1645,829,816,41,"MULTIPOLYGON(((9.634279778037582 63.70250633061598,9.625784871503452 63.74718117638326,9.72666409137961 63.75091515842046,9.735001358593724 63.7062330152203,9.634279778037582 63.70250633061598)))"
22400007075000,538,268,270,39.5,"MULTIPOLYGON(((9.735001358593724 63.7062330152203,9.72666409137961 63.75091515842046,9.827572904561691 63.75457868814893,9.835752383027637 63.70988938333255,9.735001358593724 63.7062330152203)))"
22450007075000,220,116,104,41.9,"MULTIPOLYGON(((9.835752383027637 63.70988938333255,9.827572904561691 63.75457868814893,9.928510759324778 63.75817172712753,9.93653230234129 63.71347539669289,9.835752383027637 63.70988938333255)))"
22500007075000,83,43,40,50.3,"MULTIPOLYGON(((9.93653230234129 63.71347539669289,9.928510759324778 63.75817172712753,10.029477102946597 63.76169423763468,10.037340566547666 63.71699101775773,9.93653230234129 63.71347539669289)))"
22550007075000,383,194,189,46.7,"MULTIPOLYGON(((10.037340566547666 63.71699101775773,10.029477102946597 63.76169423763468,10.13047138172562 63.76514618266976,10.138176624688718 63.720436209701134,10.037340566547666 63.71699101775773)))"
22600007075000,163,85,78,48.7,"MULTIPOLYGON(((10.138176624688718 63.720436209701134,10.13047138172562 63.76514618266976,10.231493040999268 63.76852752595473,10.239039924853437 63.72381093641645,10.138176624688718 63.720436209701134)))"
22650007075000,2,1,1,0,"MULTIPOLYGON(((10.239039924853437 63.72381093641645,10.231493040999268 63.76852752595473,10.332541525162194 63.77183823193566,10.339929914195947 63.727115162517705,10.239039924853437 63.72381093641645)))"
22700007075000,57,35,22,41.7,"MULTIPOLYGON(((10.339929914195947 63.727115162517705,10.332541525162194 63.77183823193566,10.433616277684628 63.775078265784124,10.440846038953756 63.730348853341184,10.339929914195947 63.727115162517705)))"
22750007075000,28,12,16,42.4,"MULTIPOLYGON(((10.440846038953756 63.730348853341184,10.433616277684628 63.775078265784124,10.534716741130826 63.77824759339869,10.541787744465996 63.73351197494679,10.440846038953756 63.730348853341184)))"
22800007075000,34,19,15,40.5,"MULTIPOLYGON(((10.541787744465996 63.73351197494679,10.534716741130826 63.77824759339869,10.635842357177575 63.78134618140638,10.642754475191824 63.73660449411943,10.541787744465996 63.73351197494679)))"
22850007075000,9,4,5,55.9,"MULTIPOLYGON(((10.642754475191824 63.73660449411943,10.635842357177575 63.78134618140638,10.73699256663279 63.78437399716392,10.743745674728844 63.7396263783704,10.642754475191824 63.73660449411943)))"
22950007075000,1,1,0,0,"MULTIPOLYGON(((10.844760785831609 63.74257759593882,10.83816680945418 63.78733100875927,10.939364524767981 63.79021718501282,10.945799250430229 63.74545811579282,10.844760785831609 63.74257759593882)))"
23000007075000,95,52,43,44.2,"MULTIPOLYGON(((10.945799250430229 63.74545811579282,10.939364524767981 63.79021718501282,11.040585150887777 63.793032495478734,11.046860509649008 63.748267907630904,10.945799250430229 63.74545811579282)))"
23050007075000,279,136,143,44.8,"MULTIPOLYGON(((11.046860509649008 63.748267907630904,11.040585150887777 63.793032495478734,11.141828125333364 63.795776910446286,11.147944003825174 63.751006941883226,11.046860509649008 63.748267907630904)))"
23100007075000,55,23,32,39.6,"MULTIPOLYGON(((11.147944003825174 63.751006941883226,11.141828125333364 63.795776910446286,11.243092884849718 63.79845040094094,11.249049172527664 63.753675189712766,11.147944003825174 63.751006941883226)))"
23150007075000,1400,657,743,38.1,"MULTIPOLYGON(((11.249049172527664 63.753675189712766,11.243092884849718 63.79845040094094,11.344378865425993 63.80105293872574,11.350175454576007 63.75627262301655,11.249049172527664 63.753675189712766)))"
23200007075000,440,232,208,41,"MULTIPOLYGON(((11.350175454576007 63.75627262301655,11.344378865425993 63.80105293872574,11.445685502314618 63.80358449630238,11.451322288059208 63.75879921442683,11.350175454576007 63.75627262301655)))"
23250007075000,8579,4243,4336,44.4,"MULTIPOLYGON(((11.451322288059208 63.75879921442683,11.445685502314618 63.80358449630238,11.547012230050429 63.80604504691237,11.552489110354763 63.76125493731221,11.451322288059208 63.75879921442683)))"
23300007075000,818,444,374,40,"MULTIPOLYGON(((11.552489110354763 63.76125493731221,11.547012230050429 63.80604504691237,11.648358482469886 63.80843456453817,11.653675358147696 63.763639765778805,11.552489110354763 63.76125493731221)))"
23350007075000,585,307,278,40.9,"MULTIPOLYGON(((11.653675358147696 63.763639765778805,11.648358482469886 63.80843456453817,11.749723692730333 63.81075302390431,11.754880467449672 63.76595367467126,11.653675358147696 63.763639765778805)))"
23400007075000,326,165,161,39,"MULTIPOLYGON(((11.754880467449672 63.76595367467126,11.749723692730333 63.81075302390431,11.85110729332933 63.81300040047838,11.85610387361815 63.76819663957383,11.754880467449672 63.76595367467126)))"
23450007075000,51,31,20,42.4,"MULTIPOLYGON(((11.85610387361815 63.76819663957383,11.85110729332933 63.81300040047838,11.95250871612403 63.81517667047212,11.957345011375612 63.77036863681133,11.85610387361815 63.76819663957383)))"
23500007075000,10,5,5,49.4,"MULTIPOLYGON(((11.957345011375612 63.77036863681133,11.95250871612403 63.81517667047212,12.053927392350632 63.81728181084239,12.058603314828845 63.772469643450314,11.957345011375612 63.77036863681133)))"
23550007075000,9,6,3,64.2,"MULTIPOLYGON(((12.058603314828845 63.772469643450314,12.053927392350632 63.81728181084239,12.155362752643859 63.819315799292106,12.159878217488265 63.77449963729982,12.058603314828845 63.772469643450314)))"
23600007075000,5,2,3,38.8,"MULTIPOLYGON(((12.159878217488265 63.77449963729982,12.155362752643859 63.819315799292106,12.25681422705651 63.82127861427128,12.261169152287295 63.77645859691242,12.159878217488265 63.77449963729982)))"
23650007075000,2,2,0,0,"MULTIPOLYGON(((12.261169152287295 63.77645859691242,12.25681422705651 63.82127861427128,12.358281245079068 63.823170234977795,12.362475551601811 63.77834650158506,12.261169152287295 63.77645859691242)))"
23700007075000,14,6,8,52.1,"MULTIPOLYGON(((12.362475551601811 63.77834650158506,12.358281245079068 63.823170234977795,12.45976323565932 63.824990641358404,12.463796847269604 63.78016333136002,12.362475551601811 63.77834650158506)))"
21750007080000,45,26,19,40.2,"MULTIPOLYGON(((8.417741899294304 63.69689307934919,8.407331289748495 63.741468621783184,8.507968916671702 63.746053713266775,8.51822335233445 63.70146923104509,8.417741899294304 63.69689307934919)))"
21800007080000,341,192,149,38.6,"MULTIPOLYGON(((8.51822335233445 63.70146923104509,8.507968916671702 63.746053713266775,8.608642856003632 63.75056873545949,8.618740935113065 63.705975447239275,8.51822335233445 63.70146923104509)))"
21850007080000,306,163,143,36.1,"MULTIPOLYGON(((8.618740935113065 63.705975447239275,8.608642856003632 63.75056873545949,8.709352566735836 63.755013641196925,8.719294109253928 63.71041168098863,8.618740935113065 63.705975447239275)))"
21950007080000,1448,721,727,40.2,"MULTIPOLYGON(((8.819882335173142 63.71477788604862,8.810097506642029 63.75938838401643,8.910877132295239 63.76369291815901,8.920505072096146 63.71907401687524,8.819882335173142 63.71477788604862)))"
22300007080000,152,80,72,41,"MULTIPOLYGON(((9.524935795642756 63.743376781196325,9.516252708068262 63.78804326742595,9.617259820781634 63.79185511907411,9.625784871503452 63.74718117638326,9.524935795642756 63.743376781196325)))"
22350007080000,253,121,132,37.3,"MULTIPOLYGON(((9.625784871503452 63.74718117638326,9.617259820781634 63.79185511907411,9.71829723069033 63.79559642152503,9.72666409137961 63.75091515842046,9.625784871503452 63.74718117638326)))"
22400007080000,1927,946,981,43,"MULTIPOLYGON(((9.72666409137961 63.75091515842046,9.71829723069033 63.79559642152503,9.819364384348505 63.79926713543395,9.827572904561691 63.75457868814893,9.72666409137961 63.75091515842046)))"
22450007080000,121,60,61,39.2,"MULTIPOLYGON(((9.827572904561691 63.75457868814893,9.819364384348505 63.79926713543395,9.920460727286326 63.80286722217723,9.928510759324778 63.75817172712753,9.827572904561691 63.75457868814893)))"
22500007080000,62,30,32,40.2,"MULTIPOLYGON(((9.928510759324778 63.75817172712753,9.920460727286326 63.80286722217723,10.021585704028142 63.80639664385407,10.029477102946597 63.76169423763468,9.928510759324778 63.75817172712753)))"
22550007080000,127,62,65,52.7,"MULTIPOLYGON(((10.029477102946597 63.76169423763468,10.021585704028142 63.80639664385407,10.122738758110755 63.80985536328807,10.13047138172562 63.76514618266976,10.029477102946597 63.76169423763468)))"
22600007080000,18,10,8,41.1,"MULTIPOLYGON(((10.13047138172562 63.76514618266976,10.122738758110755 63.80985536328807,10.223919332101747 63.81324334402869,10.231493040999268 63.76852752595473,10.13047138172562 63.76514618266976)))"
22650007080000,13,10,3,54.5,"MULTIPOLYGON(((10.231493040999268 63.76852752595473,10.223919332101747 63.81324334402869,10.325126867617925 63.81656055035285,10.332541525162194 63.77183823193566,10.231493040999268 63.76852752595473)))"
22750007080000,3,2,1,0,"MULTIPOLYGON(((10.433616277684628 63.775078265784124,10.426360805343823 63.81980694726638,10.527620585050286 63.82298250050549,10.534716741130826 63.77824759339869,10.433616277684628 63.775078265784124)))"
22800007080000,31,20,11,44.8,"MULTIPOLYGON(((10.534716741130826 63.77824759339869,10.527620585050286 63.82298250050549,10.628905645613152 63.826087176538174,10.635842357177575 63.78134618140638,10.534716741130826 63.77824759339869)))"
22850007080000,5,3,2,66.6,"MULTIPOLYGON(((10.635842357177575 63.78134618140638,10.628905645613152 63.826087176538174,10.730215425031979 63.829120942565645,10.73699256663279 63.78437399716392,10.635842357177575 63.78134618140638)))"
22900007080000,11,6,5,37,"MULTIPOLYGON(((10.73699256663279 63.78437399716392,10.730215425031979 63.829120942565645,10.831549360448891 63.832083766523645,10.83816680945418 63.78733100875927,10.73699256663279 63.78437399716392)))"
23000007080000,472,250,222,48.1,"MULTIPOLYGON(((10.939364524767981 63.79021718501282,10.932906888167443 63.83497561708387,11.034287443671609 63.837796463655216,11.040585150887777 63.793032495478734,10.939364524767981 63.79021718501282)))"
23050007080000,66,29,37,46.6,"MULTIPOLYGON(((11.040585150887777 63.793032495478734,11.034287443671609 63.837796463655216,11.135690461644815 63.84054627638507,11.141828125333364 63.795776910446286,11.040585150887777 63.793032495478734)))"
23100007080000,119,62,57,42.9,"MULTIPOLYGON(((11.141828125333364 63.795776910446286,11.135690461644815 63.84054627638507,11.23711537598905 63.843225026160546,11.243092884849718 63.79845040094094,11.141828125333364 63.795776910446286)))"
23150007080000,24,11,13,39.4,"MULTIPOLYGON(((11.243092884849718 63.79845040094094,11.23711537598905 63.843225026160546,11.338561619844027 63.845832684609796,11.344378865425993 63.80105293872574,11.243092884849718 63.79845040094094)))"
23200007080000,919,466,453,40.2,"MULTIPOLYGON(((11.344378865425993 63.80105293872574,11.338561619844027 63.845832684609796,11.44002862560644 63.84836922410305,11.445685502314618 63.80358449630238,11.344378865425993 63.80105293872574)))"
23250007080000,1639,827,812,36.5,"MULTIPOLYGON(((11.445685502314618 63.80358449630238,11.44002862560644 63.84836922410305,11.541515824949263 63.85083461775388,11.547012230050429 63.80604504691237,11.445685502314618 63.80358449630238)))"
23300007080000,797,406,391,37,"MULTIPOLYGON(((11.547012230050429 63.80604504691237,11.541515824949263 63.85083461775388,11.643022648841116 63.85322883942036,11.648358482469886 63.80843456453817,11.547012230050429 63.80604504691237)))"
23350007080000,372,199,173,40.4,"MULTIPOLYGON(((11.648358482469886 63.80843456453817,11.643022648841116 63.85322883942036,11.744548527565707 63.855551863706,11.749723692730333 63.81075302390431,11.648358482469886 63.80843456453817)))"
23400007080000,1,1,0,0,"MULTIPOLYGON(((11.749723692730333 63.81075302390431,11.744548527565707 63.855551863706,11.846092890741305 63.85780366596103,11.85110729332933 63.81300040047838,11.749723692730333 63.81075302390431)))"
23450007080000,148,80,68,43.6,"MULTIPOLYGON(((11.85110729332933 63.81300040047838,11.846092890741305 63.85780366596103,11.947655167340299 63.85998422228324,11.95250871612403 63.81517667047212,11.85110729332933 63.81300040047838)))"
23500007080000,78,36,42,43.1,"MULTIPOLYGON(((11.95250871612403 63.81517667047212,11.947655167340299 63.85998422228324,12.049234785708803 63.86209350951916,12.053927392350632 63.81728181084239,11.95250871612403 63.81517667047212)))"
23550007080000,9,5,4,39.3,"MULTIPOLYGON(((12.053927392350632 63.81728181084239,12.049234785708803 63.86209350951916,12.150831173586301 63.86413150526491,12.155362752643859 63.819315799292106,12.053927392350632 63.81728181084239)))"
21850007085000,372,194,178,42.5,"MULTIPOLYGON(((8.608642856003632 63.75056873545949,8.598509005290959 63.795160864014036,8.699375794843636 63.799614468953806,8.709352566735836 63.755013641196925,8.608642856003632 63.75056873545949)))"
21900007085000,374,199,175,38.2,"MULTIPOLYGON(((8.709352566735836 63.755013641196925,8.699375794843636 63.799614468953806,8.800277992166658 63.80399777634155,8.810097506642029 63.75938838401643,8.709352566735836 63.755013641196925)))"
21950007085000,502,266,236,38.2,"MULTIPOLYGON(((8.810097506642029 63.75938838401643,8.800277992166658 63.80399777634155,8.9012150511634 63.80831074020191,8.910877132295239 63.76369291815901,8.810097506642029 63.75938838401643)))"
22250007085000,15,8,7,48.7,"MULTIPOLYGON(((9.41527644495398 63.78416090664495,9.406404075311787 63.8288188471715,9.507538770718 63.83270882420395,9.516252708068262 63.78804326742595,9.41527644495398 63.78416090664495)))"
22300007085000,5,3,2,53.2,"MULTIPOLYGON(((9.516252708068262 63.78804326742595,9.507538770718 63.83270882420395,9.608704472690818 63.836528155828944,9.617259820781634 63.79185511907411,9.516252708068262 63.78804326742595)))"
22350007085000,369,201,168,43.4,"MULTIPOLYGON(((9.617259820781634 63.79185511907411,9.608704472690818 63.836528155828944,9.70990062608091 63.84027680179176,9.71829723069033 63.79559642152503,9.617259820781634 63.79185511907411)))"
22400007085000,54,30,24,33.4,"MULTIPOLYGON(((9.71829723069033 63.79559642152503,9.70990062608091 63.84027680179176,9.81112667468804 63.84395472256058,9.819364384348505 63.79926713543395,9.71829723069033 63.79559642152503)))"
22450007085000,71,43,28,41.4,"MULTIPOLYGON(((9.819364384348505 63.79926713543395,9.81112667468804 63.84395472256058,9.912382061279285 63.847561879328104,9.920460727286326 63.80286722217723,9.819364384348505 63.79926713543395)))"
22550007085000,9,4,5,41.8,"MULTIPOLYGON(((10.021585704028142 63.80639664385407,10.013666227607363 63.85109823401318,10.114978614429047 63.85456374926236,10.122738758110755 63.80985536328807,10.021585704028142 63.80639664385407)))"
22600007085000,11,3,8,44.1,"MULTIPOLYGON(((10.122738758110755 63.80985536328807,10.114978614429047 63.85456374926236,10.216318661523664 63.857958388451515,10.223919332101747 63.81324334402869,10.122738758110755 63.80985536328807)))"
22650007085000,15,6,9,29.6,"MULTIPOLYGON(((10.223919332101747 63.81324334402869,10.216318661523664 63.857958388451515,10.317685807711662 63.861282115687295,10.325126867617925 63.81656055035285,10.223919332101747 63.81324334402869)))"
22750007085000,3,2,1,0,"MULTIPOLYGON(((10.426360805343823 63.81980694726638,10.419079490873283 63.864534895808696,10.520499147967302 63.86771669438848,10.527620585050286 63.82298250050549,10.426360805343823 63.81980694726638)))"
22850007085000,25,11,14,49.6,"MULTIPOLYGON(((10.628905645613152 63.826087176538174,10.621944215049856 63.870827477734565,10.723414127293331 63.873867212891604,10.730215425031979 63.829120942565645,10.628905645613152 63.826087176538174)))"
22900007085000,17,7,10,36.1,"MULTIPOLYGON(((10.730215425031979 63.829120942565645,10.723414127293331 63.873867212891604,10.824908319005363 63.87683586764215,10.831549360448891 63.832083766523645,10.730215425031979 63.829120942565645)))"
22950007085000,3,2,1,0,"MULTIPOLYGON(((10.831549360448891 63.832083766523645,10.824908319005363 63.87683586764215,10.926426223647862 63.879733410508194,10.932906888167443 63.83497561708387,10.831549360448891 63.832083766523645)))"
23000007085000,45,22,23,46.1,"MULTIPOLYGON(((10.932906888167443 63.83497561708387,10.926426223647862 63.879733410508194,11.027967273856161 63.88255981075237,11.034287443671609 63.837796463655216,10.932906888167443 63.83497561708387)))"
23050007085000,276,148,128,40.1,"MULTIPOLYGON(((11.034287443671609 63.837796463655216,11.027967273856161 63.88255981075237,11.129530901458201 63.88531503837932,11.135690461644815 63.84054627638507,11.034287443671609 63.837796463655216)))"
23100007085000,576,300,276,40.4,"MULTIPOLYGON(((11.135690461644815 63.84054627638507,11.129530901458201 63.88531503837932,11.231116537493804 63.88799906413682,11.23711537598905 63.843225026160546,11.135690461644815 63.84054627638507)))"
23150007085000,2146,1010,1136,44.1,"MULTIPOLYGON(((11.23711537598905 63.843225026160546,11.231116537493804 63.88799906413682,11.332723612234005 63.890611859517215,11.338561619844027 63.845832684609796,11.23711537598905 63.843225026160546)))"
23200007085000,856,440,416,40,"MULTIPOLYGON(((11.338561619844027 63.845832684609796,11.332723612234005 63.890611859517215,11.434351555200463 63.893153396758414,11.44002862560644 63.84836922410305,11.338561619844027 63.845832684609796)))"
23250007085000,54,30,24,47.6,"MULTIPOLYGON(((11.44002862560644 63.84836922410305,11.434351555200463 63.893153396758414,11.535999795184908 63.895623648845266,11.541515824949263 63.85083461775388,11.44002862560644 63.84836922410305)))"
23300007085000,83,45,38,44.6,"MULTIPOLYGON(((11.541515824949263 63.85083461775388,11.535999795184908 63.895623648845266,11.637667760268707 63.898022589510504,11.643022648841116 63.85322883942036,11.541515824949263 63.85083461775388)))"
23350007085000,2,1,1,0,"MULTIPOLYGON(((11.643022648841116 63.85322883942036,11.637667760268707 63.898022589510504,11.739354877842427 63.900350193235965,11.744548527565707 63.855551863706,11.643022648841116 63.85322883942036)))"
21850007090000,51,23,28,36.6,"MULTIPOLYGON(((8.598509005290959 63.795160864014036,8.588339201717451 63.83975182872992,8.689363614979287 63.84421416022448,8.699375794843636 63.799614468953806,8.598509005290959 63.795160864014036)))"
21950007090000,2,1,1,0,"MULTIPOLYGON(((8.800277992166658 63.80399777634155,8.79042361581865 63.84860605912545,8.891518655451906 63.85292747923965,8.9012150511634 63.80831074020191,8.800277992166658 63.80399777634155)))"
22350007090000,33,16,17,37.5,"MULTIPOLYGON(((9.608704472690818 63.836528155828944,9.600118673007566 63.881200283767164,9.701474126082339 63.884956296458114,9.70990062608091 63.84027680179176,9.608704472690818 63.836528155828944)))"
22400007090000,508,250,258,43.9,"MULTIPOLYGON(((9.70990062608091 63.84027680179176,9.701474126082339 63.884956296458114,9.802859626874397 63.88864144688235,9.81112667468804 63.84395472256058,9.70990062608091 63.84027680179176)))"
22450007090000,533,284,249,46.6,"MULTIPOLYGON(((9.81112667468804 63.84395472256058,9.802859626874397 63.88864144688235,9.90427461536941 63.89225569604764,9.912382061279285 63.847561879328104,9.81112667468804 63.84395472256058)))"
22500007090000,99,54,45,38.7,"MULTIPOLYGON(((9.912382061279285 63.847561879328104,9.90427461536941 63.89225569604764,10.005718530530059 63.89579900569128,10.013666227607363 63.85109823401318,9.912382061279285 63.847561879328104)))"
22950007090000,64,36,28,57,"MULTIPOLYGON(((10.824908319005363 63.87683586764215,10.818243564493596 63.921587310512535,10.919922413427914 63.92449056377617,10.926426223647862 63.879733410508194,10.824908319005363 63.87683586764215)))"
23000007090000,91,52,39,50,"MULTIPOLYGON(((10.926426223647862 63.879733410508194,10.919922413427914 63.92449056377617,11.021624526515613 63.92732253535107,11.027967273856161 63.88255981075237,10.926426223647862 63.879733410508194)))"
23050007090000,35,18,17,43.2,"MULTIPOLYGON(((11.027967273856161 63.88255981075237,11.021624526515613 63.92732253535107,11.12334933270989 63.93008319509809,11.129530901458201 63.88531503837932,11.027967273856161 63.88255981075237)))"
23100007090000,453,232,221,41.3,"MULTIPOLYGON(((11.129530901458201 63.88531503837932,11.12334933270989 63.93008319509809,11.22509626016906 63.93277251362485,11.231116537493804 63.88799906413682,11.129530901458201 63.88531503837932)))"
23150007090000,422,213,209,39.2,"MULTIPOLYGON(((11.231116537493804 63.88799906413682,11.22509626016906 63.93277251362485,11.326864736276079 63.93539046228697,11.332723612234005 63.890611859517215,11.231116537493804 63.88799906413682)))"
23200007090000,471,243,228,40.9,"MULTIPOLYGON(((11.332723612234005 63.890611859517215,11.326864736276079 63.93539046228697,11.42865418765809 63.93793701318918,11.434351555200463 63.893153396758414,11.332723612234005 63.890611859517215)))"
23250007090000,1009,496,513,42.1,"MULTIPOLYGON(((11.434351555200463 63.893153396758414,11.42865418765809 63.93793701318918,11.53046404020607 63.94041213918664,11.535999795184908 63.895623648845266,11.434351555200463 63.893153396758414)))"
23300007090000,311,176,135,39.7,"MULTIPOLYGON(((11.535999795184908 63.895623648845266,11.53046404020607 63.94041213918664,11.632293719094516 63.94281581388596,11.637667760268707 63.898022589510504,11.535999795184908 63.895623648845266)))"
21750007095000,62,35,27,62.3,"MULTIPOLYGON(((8.386399326938312 63.830616056281016,8.37587759932005 63.87518793940256,8.47698699712349 63.879800018944316,8.487350923595745 63.83521911154498,8.386399326938312 63.830616056281016)))"
21800007095000,12,7,5,52.3,"MULTIPOLYGON(((8.487350923595745 63.83521911154498,8.47698699712349 63.879800018944316,8.578133262797406 63.88434162540415,8.588339201717451 63.83975182872992,8.487350923595745 63.83521911154498)))"
21850007095000,190,106,84,52.2,"MULTIPOLYGON(((8.588339201717451 63.83975182872992,8.578133262797406 63.88434162540415,8.679315847333898 63.888812710945054,8.689363614979287 63.84421416022448,8.588339201717451 63.83975182872992)))"
22450007095000,28,12,16,39.8,"MULTIPOLYGON(((9.802859626874397 63.88864144688235,9.794563091187298 63.933327305733,9.896138242626499 63.93694866978428,9.90427461536941 63.89225569604764,9.802859626874397 63.88864144688235)))"
22500007095000,50,28,22,49,"MULTIPOLYGON(((9.90427461536941 63.89225569604764,9.896138242626499 63.93694866978428,9.99774246866457 63.940498956449446,10.005718530530059 63.89579900569128,9.90427461536941 63.89225569604764)))"
22550007095000,91,46,45,48,"MULTIPOLYGON(((10.005718530530059 63.89579900569128,9.99774246866457 63.940498956449446,10.099375204442598 63.94397812801756,10.107190810314592 63.899271338281686,10.005718530530059 63.89579900569128)))"
22600007095000,48,27,21,37.8,"MULTIPOLYGON(((10.107190810314592 63.899271338281686,10.099375204442598 63.94397812801756,10.201035884107485 63.94738614751375,10.208690891695495 63.90267265701989,10.107190810314592 63.899271338281686)))"
22650007095000,61,31,30,38.1,"MULTIPOLYGON(((10.208690891695495 63.90267265701989,10.201035884107485 63.94738614751375,10.30272394083083 63.95072297870078,10.310218210678192 63.906002925841236,10.208690891695495 63.90267265701989)))"
22700007095000,25,12,13,46.6,"MULTIPOLYGON(((10.310218210678192 63.906002925841236,10.30272394083083 63.95072297870078,10.404438806827905 63.953988586080605,10.4117722023199 63.909262109416694,10.310218210678192 63.906002925841236)))"
22750007095000,73,37,36,35.4,"MULTIPOLYGON(((10.4117722023199 63.909262109416694,10.404438806827905 63.953988586080605,10.506179913376718 63.95718293489578,10.513352300748492 63.91245017315451,10.4117722023199 63.909262109416694)))"
22800007095000,12,7,5,45.4,"MULTIPOLYGON(((10.513352300748492 63.91245017315451,10.506179913376718 63.95718293489578,10.607946690837132 63.96030599113108,10.614957939181505 63.91556708320154,10.513352300748492 63.91245017315451)))"
22850007095000,3,1,2,0,"MULTIPOLYGON(((10.614957939181505 63.91556708320154,10.607946690837132 63.96030599113108,10.709738568670113 63.96335772151469,10.716588549945177 63.91861280644474,10.614957939181505 63.91556708320154)))"
23000007095000,18,8,10,44.5,"MULTIPOLYGON(((10.919922413427914 63.92449056377617,10.913395338918864 63.96924707536607,11.015259085936012 63.97208463602061,11.021624526515613 63.92732253535107,10.919922413427914 63.92449056377617)))"
23100007095000,1,0,1,0,"MULTIPOLYGON(((11.12334933270989 63.93008319509809,11.11714564256745 63.97485074519962,11.219054434070502 63.97754537336955,11.22509626016906 63.93277251362485,11.12334933270989 63.93008319509809)))"
23150007095000,471,233,238,39.4,"MULTIPOLYGON(((11.22509626016906 63.93277251362485,11.219054434070502 63.97754537336955,11.320984884920462 63.98016849174839,11.326864736276079 63.93539046228697,11.22509626016906 63.93277251362485)))"
23200007095000,801,409,392,42.4,"MULTIPOLYGON(((11.326864736276079 63.93539046228697,11.320984884920462 63.98016849174839,11.42293641883034 63.98272007230679,11.42865418765809 63.93793701318918,11.326864736276079 63.93539046228697)))"
23250007095000,506,249,257,40.4,"MULTIPOLYGON(((11.42865418765809 63.93793701318918,11.42293641883034 63.98272007230679,11.524908458770645 63.98520008776942,11.53046404020607 63.94041213918664,11.42865418765809 63.93793701318918)))"
23300007095000,380,191,189,39.1,"MULTIPOLYGON(((11.53046404020607 63.94041213918664,11.524908458770645 63.98520008776942,11.626900426989257 63.987608511615946,11.632293719094516 63.94281581388596,11.53046404020607 63.94041213918664)))"
23350007095000,94,44,50,38,"MULTIPOLYGON(((11.632293719094516 63.94281581388596,11.626900426989257 63.987608511615946,11.72891174503136 63.98994531808228,11.734142648801212 63.945148011646474,11.632293719094516 63.94281581388596)))"
23450007095000,73,39,34,40.7,"MULTIPOLYGON(((11.836010253127053 63.947408707581125,11.830941833759404 63.9922104821616,11.932990113373192 63.99440397960553,11.937895955215907 63.94959787755771,11.836010253127053 63.947408707581125)))"
23550007095000,32,15,17,44.1,"MULTIPOLYGON(((12.039799177574572 63.951715498199725,12.035056003429954 63.996525786924956,12.137138922864528 63.99857588139128,12.141719342092768 63.95376154688756,12.039799177574572 63.951715498199725)))"
22000007100000,8,8,0,54.9,"MULTIPOLYGON(((8.881787770736036 63.89754313148066,8.87202222140513 63.94215769310588,8.973469716217124 63.94642530942292,8.983076005411608 63.90180237436582,8.881787770736036 63.89754313148066)))"
22500007100000,24,11,13,58,"MULTIPOLYGON(((9.896138242626499 63.93694866978428,9.887972795115877 63.98164079796735,9.98973789689342 63.9851980838304,9.99774246866457 63.940498956449446,9.896138242626499 63.93694866978428)))"
22550007100000,97,49,48,46.6,"MULTIPOLYGON(((9.99774246866457 63.940498956449446,9.98973789689342 63.9851980838304,10.091531654521196 63.988684116123984,10.099375204442598 63.94397812801756,9.99774246866457 63.940498956449446)))"
22600007100000,690,348,342,40.7,"MULTIPOLYGON(((10.099375204442598 63.94397812801756,10.091531654521196 63.988684116123984,10.19335349930163 63.992098857696135,10.201035884107485 63.94738614751375,10.099375204442598 63.94397812801756)))"
22650007100000,944,451,493,44.3,"MULTIPOLYGON(((10.201035884107485 63.94738614751375,10.19335349930163 63.992098857696135,10.295202861553518 63.995442272136,10.30272394083083 63.95072297870078,10.201035884107485 63.94738614751375)))"
22700007100000,133,75,58,41.1,"MULTIPOLYGON(((10.30272394083083 63.95072297870078,10.295202861553518 63.995442272136,10.39707917063115 63.99871432377528,10.404438806827905 63.953988586080605,10.30272394083083 63.95072297870078)))"
22750007100000,211,111,100,41,"MULTIPOLYGON(((10.404438806827905 63.953988586080605,10.39707917063115 63.99871432377528,10.498981854943509 64.00191497768981,10.506179913376718 63.95718293489578,10.404438806827905 63.953988586080605)))"
22900007100000,6,2,4,42.7,"MULTIPOLYGON(((10.709738568670113 63.96335772151469,10.70286405829777 64.00810195637766,10.804842429605262 64.0110882150364,10.811554975456994 63.96633809351984,10.709738568670113 63.96335772151469)))"
22950007100000,20,10,10,38.2,"MULTIPOLYGON(((10.811554975456994 63.96633809351984,10.804842429605262 64.0110882150364,10.906844880717651 64.01400294374415,10.913395338918864 63.96924707536607,10.811554975456994 63.96633809351984)))"
23000007100000,3,2,1,0,"MULTIPOLYGON(((10.913395338918864 63.96924707536607,10.906844880717651 64.01400294374415,11.008870835608509 64.01684611131891,11.015259085936012 63.97208463602061,10.913395338918864 63.96924707536607)))"
23050007100000,338,164,174,46.7,"MULTIPOLYGON(((11.015259085936012 63.97208463602061,11.008870835608509 64.01684611131891,11.110919717423062 64.01961768733128,11.11714564256745 63.97485074519962,11.015259085936012 63.97208463602061)))"
23100007100000,110,58,52,40.1,"MULTIPOLYGON(((11.11714564256745 63.97485074519962,11.110919717423062 64.01961768733128,11.212990948497982 64.02231764210552,11.219054434070502 63.97754537336955,11.11714564256745 63.97485074519962)))"
23150007100000,14,7,7,45.4,"MULTIPOLYGON(((11.219054434070502 63.97754537336955,11.212990948497982 64.02231764210552,11.315083950381176 64.02494594672109,11.320984884920462 63.98016849174839,11.219054434070502 63.97754537336955)))"
23200007100000,10,6,4,49,"MULTIPOLYGON(((11.320984884920462 63.98016849174839,11.315083950381176 64.02494594672109,11.417198143851719 64.02750257301372,11.42293641883034 63.98272007230679,11.320984884920462 63.98016849174839)))"
23250007100000,10537,5112,5425,46,"MULTIPOLYGON(((11.42293641883034 63.98272007230679,11.417198143851719 64.02750257301372,11.51933294893979 64.02998749357658,11.524908458770645 63.98520008776942,11.42293641883034 63.98272007230679)))"
23300007100000,1174,621,553,37.1,"MULTIPOLYGON(((11.524908458770645 63.98520008776942,11.51933294893979 64.02998749357658,11.621487784946726 64.03240068176166,11.626900426989257 63.987608511615946,11.524908458770645 63.98520008776942)))"
23350007100000,376,199,177,40.2,"MULTIPOLYGON(((11.626900426989257 63.987608511615946,11.621487784946726 64.03240068176166,11.723662070465107 64.0347421116806,11.72891174503136 63.98994531808228,11.626900426989257 63.987608511615946)))"
23400007100000,77,44,33,40.5,"MULTIPOLYGON(((11.72891174503136 63.98994531808228,11.723662070465107 64.0347421116806,11.82585522339892 64.03701175820599,11.830941833759404 63.9922104821616,11.72891174503136 63.98994531808228)))"
23450007100000,171,96,75,40.7,"MULTIPOLYGON(((11.830941833759404 63.9922104821616,11.82585522339892 64.03701175820599,11.928066660983765 64.03920959697248,11.932990113373192 63.99440397960553,11.830941833759404 63.9922104821616)))"
23550007100000,1,1,0,0,"MULTIPOLYGON(((12.035056003429954 63.996525786924956,12.030295799807154 64.04133560437765,12.132542055828829 64.04338975758314,12.137138922864528 63.99857588139128,12.035056003429954 63.996525786924956)))"
22100007105000,22,13,9,39.8,"MULTIPOLYGON(((9.074951495609305 63.950622084091115,9.065470913666958 63.99525221424111,9.167146584320799 63.999386228671405,9.176467001753103 63.95474797263854,9.074951495609305 63.950622084091115)))"
22500007105000,67,35,32,50.6,"MULTIPOLYGON(((9.887972795115877 63.98164079796735,9.879778123889865 64.02633207800689,9.981704669104925 64.02989638535827,9.98973789689342 63.9851980838304,9.887972795115877 63.98164079796735)))"
22550007105000,144,84,60,45.8,"MULTIPOLYGON(((9.98973789689342 63.9851980838304,9.981704669104925 64.02989638535827,10.083660017283185 64.03338930023709,10.091531654521196 63.988684116123984,9.98973789689342 63.9851980838304)))"
22600007105000,10,7,3,54.3,"MULTIPOLYGON(((10.091531654521196 63.988684116123984,10.083660017283185 64.03338930023709,10.185643596863567 64.03681078531308,10.19335349930163 63.992098857696135,10.091531654521196 63.988684116123984)))"
22650007105000,77,44,33,39.9,"MULTIPOLYGON(((10.19335349930163 63.992098857696135,10.185643596863567 64.03681078531308,10.287654835292917 64.04016080400056,10.295202861553518 63.995442272136,10.19335349930163 63.992098857696135)))"
22700007105000,30,14,16,50.2,"MULTIPOLYGON(((10.295202861553518 63.995442272136,10.287654835292917 64.04016080400056,10.389693159045326 64.04343932045991,10.39707917063115 63.99871432377528,10.295202861553518 63.995442272136)))"
22750007105000,9,4,5,41,"MULTIPOLYGON(((10.39707917063115 63.99871432377528,10.389693159045326 64.04343932045991,10.491757993641471 64.04664629959915,10.498981854943509 64.00191497768981,10.39707917063115 63.99871432377528)))"
22800007105000,63,32,31,43.3,"MULTIPOLYGON(((10.498981854943509 64.00191497768981,10.491757993641471 64.04664629959915,10.593848763668086 64.04978170707537,10.60091034197359 64.0050441997011,10.498981854943509 64.00191497768981)))"
22950007105000,2,2,0,0,"MULTIPOLYGON(((10.804842429605262 64.0110882150364,10.798105803807298 64.05583767342159,10.90027091859992 64.05875816736432,10.906844880717651 64.01400294374415,10.804842429605262 64.0110882150364)))"
23050007105000,25,16,9,37.1,"MULTIPOLYGON(((11.008870835608509 64.01684611131891,11.002459658222536 64.06160695979227,11.10467144288685 64.06438402012941,11.110919717423062 64.01961768733128,11.008870835608509 64.01684611131891)))"
23100007105000,102,58,44,42.1,"MULTIPOLYGON(((11.110919717423062 64.01961768733128,11.10467144288685 64.06438402012941,11.206905691989038 64.06708931855694,11.212990948497982 64.02231764210552,11.110919717423062 64.01961768733128)))"
23150007105000,621,325,296,45.9,"MULTIPOLYGON(((11.212990948497982 64.02231764210552,11.206905691989038 64.06708931855694,11.309161824129728 64.06972282601485,11.315083950381176 64.02494594672109,11.212990948497982 64.02231764210552)))"
23200007105000,319,160,159,41.5,"MULTIPOLYGON(((11.315083950381176 64.02494594672109,11.309161824129728 64.06972282601485,11.411439257134086 64.07228451420302,11.417198143851719 64.02750257301372,11.315083950381176 64.02494594672109)))"
23250007105000,1335,662,673,39.9,"MULTIPOLYGON(((11.417198143851719 64.02750257301372,11.411439257134086 64.07228451420302,11.513737408071941 64.07477435558235,11.51933294893979 64.02998749357658,11.417198143851719 64.02750257301372)))"
23300007105000,515,276,239,38.9,"MULTIPOLYGON(((11.51933294893979 64.02998749357658,11.513737408071941 64.07477435558235,11.61605569327798 64.07719232337611,11.621487784946726 64.03240068176166,11.51933294893979 64.02998749357658)))"
23350007105000,206,111,95,40.9,"MULTIPOLYGON(((11.621487784946726 64.03240068176166,11.61605569327798 64.07719232337611,11.718393528372031 64.07953839157092,11.723662070465107 64.0347421116806,11.621487784946726 64.03240068176166)))"
23400007105000,60,34,26,44.1,"MULTIPOLYGON(((11.723662070465107 64.0347421116806,11.718393528372031 64.07953839157092,11.82075032827938 64.08181253491806,11.82585522339892 64.03701175820599,11.723662070465107 64.0347421116806)))"
24450007105000,2,1,1,0,"MULTIPOLYGON(((13.87277878067305 64.0672982589978,13.870962646177846 64.11215911232412,13.973581543860107 64.11291836551334,13.975232682770912 64.06805600742877,13.87277878067305 64.0672982589978)))"
24500007105000,31,20,11,39.6,"MULTIPOLYGON(((13.975232682770912 64.06805600742877,13.973581543860107 64.11291836551334,14.076206400825505 64.11360533365357,14.077692513433398 64.06874161400127,13.975232682770912 64.06805600742877)))"
22500007110000,99,54,45,45,"MULTIPOLYGON(((9.879778123889865 64.02633207800689,9.871554078979111 64.07102250729346,9.973642638184682 64.07459385853856,9.981704669104925 64.02989638535827,9.879778123889865 64.02633207800689)))"
22550007110000,278,151,127,52.1,"MULTIPOLYGON(((9.981704669104925 64.02989638535827,9.973642638184682 64.07459385853856,10.075760148477713 64.07809367797512,10.083660017283185 64.03338930023709,9.981704669104925 64.02989638535827)))"
22600007110000,18,9,9,51.1,"MULTIPOLYGON(((10.083660017283185 64.03338930023709,10.075760148477713 64.07809367797512,10.177906035414397 64.08152192809342,10.185643596863567 64.03681078531308,10.083660017283185 64.03338930023709)))"
22750007110000,19,9,10,47,"MULTIPOLYGON(((10.389693159045326 64.04343932045991,10.382280636460115 64.08816357407802,10.48450819675656 64.09137689867129,10.491757993641471 64.04664629959915,10.389693159045326 64.04343932045991)))"
22800007110000,10,5,5,39.3,"MULTIPOLYGON(((10.491757993641471 64.04664629959915,10.48450819675656 64.09137689867129,10.586761826110646 64.09451851140322,10.593848763668086 64.04978170707537,10.491757993641471 64.04664629959915)))"
23100007110000,63,27,36,42.9,"MULTIPOLYGON(((11.10467144288685 64.06438402012941,11.098400703780179 64.10914974221922,11.200798552312344 64.11186040143748,11.206905691989038 64.06708931855694,11.10467144288685 64.06438402012941)))"
23150007110000,985,503,482,46.3,"MULTIPOLYGON(((11.206905691989038 64.06708931855694,11.200798552312344 64.11186040143748,11.303218396888724 64.11449912842956,11.309161824129728 64.06972282601485,11.206905691989038 64.06708931855694)))"
23200007110000,739,376,363,39.8,"MULTIPOLYGON(((11.309161824129728 64.06972282601485,11.303218396888724 64.11449912842956,11.40565965236044 64.1170658947585,11.411439257134086 64.07228451420302,11.309161824129728 64.06972282601485)))"
23250007110000,367,191,176,37.9,"MULTIPOLYGON(((11.411439257134086 64.07228451420302,11.40565965236044 64.1170658947585,11.508121732816761 64.11956067275207,11.513737408071941 64.07477435558235,11.411439257134086 64.07228451420302)))"
23300007110000,320,166,154,39,"MULTIPOLYGON(((11.513737408071941 64.07477435558235,11.508121732816761 64.11956067275207,11.610604051605467 64.121983435504,11.61605569327798 64.07719232337611,11.513737408071941 64.07477435558235)))"
23350007110000,571,303,268,39.9,"MULTIPOLYGON(((11.61605569327798 64.07719232337611,11.610604051605467 64.121983435504,11.713106021353301 64.12433415687511,11.718393528372031 64.07953839157092,11.61605569327798 64.07719232337611)))"
23400007110000,291,155,136,36.3,"MULTIPOLYGON(((11.718393528372031 64.07953839157092,11.713106021353301 64.12433415687511,11.815627053986457 64.12661281149435,11.82075032827938 64.08181253491806,11.718393528372031 64.07953839157092)))"
23450007110000,2,1,1,0,"MULTIPOLYGON(((11.82075032827938 64.08181253491806,11.815627053986457 64.12661281149435,11.918166560751159 64.12881937476001,11.923125507251166 64.08401472893429,11.82075032827938 64.08181253491806)))"
24050007110000,1,1,0,0,"MULTIPOLYGON(((13.05029735689324 64.10348397446741,13.04715142583061 64.14832727832818,13.149866480189765 64.14966710778441,13.15284717891923 64.10482114684784,13.05029735689324 64.10348397446741)))"
24450007110000,18,10,8,48.1,"MULTIPOLYGON(((13.870962646177846 64.11215911232412,13.86913995725484 64.1570196589904,13.971924445630556 64.15778042179402,13.973581543860107 64.11291836551334,13.870962646177846 64.11215911232412)))"
24500007110000,20,13,7,43.3,"MULTIPOLYGON(((13.973581543860107 64.11291836551334,13.971924445630556 64.15778042179402,14.074714924221542 64.15846875589642,14.076206400825505 64.11360533365357,13.973581543860107 64.11291836551334)))"
24550007110000,5,2,3,47,"MULTIPOLYGON(((14.076206400825505 64.11360533365357,14.074714924221542 64.15846875589642,14.177510794620764 64.15908465382948,14.178836621754932 64.11422000931286,14.076206400825505 64.11360533365357)))"
22550007115000,35,18,17,39.3,"MULTIPOLYGON(((9.973642638184682 64.07459385853856,9.965551656006994 64.11929050085791,10.067831902861812 64.12279724693828,10.075760148477713 64.07809367797512,9.973642638184682 64.07459385853856)))"
22600007115000,26,15,11,52,"MULTIPOLYGON(((10.075760148477713 64.07809367797512,10.067831902861812 64.12279724693828,10.170140672602416 64.12623228374868,10.177906035414397 64.08152192809342,10.075760148477713 64.07809367797512)))"
22650007115000,28,18,10,50.7,"MULTIPOLYGON(((10.177906035414397 64.08152192809342,10.170140672602416 64.12623228374868,10.272477386873753 64.12959557435023,10.280079723550365 64.08487857213174,10.177906035414397 64.08152192809342)))"
22700007115000,4,2,2,0,"MULTIPOLYGON(((10.280079723550365 64.08487857213174,10.272477386873753 64.12959557435023,10.374841466331207 64.13288708255725,10.382280636460115 64.08816357407802,10.280079723550365 64.08487857213174)))"
22800007115000,54,31,23,45.3,"MULTIPOLYGON(((10.48450819675656 64.09137689867129,10.477232330660296 64.13610677293867,10.57964939859647 64.13925461081965,10.586761826110646 64.09451851140322,10.48450819675656 64.09137689867129)))"
23100007115000,2,2,0,0,"MULTIPOLYGON(((11.098400703780179 64.10914974221922,11.09210738412884 64.15391485221484,11.194669416461071 64.15663088945033,11.200798552312344 64.11186040143748,11.098400703780179 64.10914974221922)))"
23150007115000,185,99,86,42.9,"MULTIPOLYGON(((11.200798552312344 64.11186040143748,11.194669416461071 64.15663088945033,11.297253558625398 64.1592748527551,11.303218396888724 64.11449912842956,11.200798552312344 64.11186040143748)))"
23200007115000,239,125,114,38.1,"MULTIPOLYGON(((11.303218396888724 64.11449912842956,11.297253558625398 64.1592748527551,11.399859222478604 64.16184671355454,11.40565965236044 64.1170658947585,11.303218396888724 64.11449912842956)))"
23250007115000,125,67,58,33.2,"MULTIPOLYGON(((11.40565965236044 64.1170658947585,11.399859222478604 64.16184671355454,11.502485819109014 64.16434644404237,11.508121732816761 64.11956067275207,11.40565965236044 64.1170658947585)))"
23300007115000,65,35,30,38,"MULTIPOLYGON(((11.508121732816761 64.11956067275207,11.502485819109014 64.16434644404237,11.605132758857069 64.16677401718188,11.610604051605467 64.121983435504,11.508121732816761 64.11956067275207)))"
23350007115000,196,99,97,42.4,"MULTIPOLYGON(((11.610604051605467 64.121983435504,11.605132758857069 64.16677401718188,11.707799451335912 64.16912940670721,11.713106021353301 64.12433415687511,11.610604051605467 64.121983435504)))"
23400007115000,174,89,85,49.9,"MULTIPOLYGON(((11.713106021353301 64.12433415687511,11.707799451335912 64.16912940670721,11.810485305452092 64.17141258712425,11.815627053986457 64.12661281149435,11.713106021353301 64.12433415687511)))"
23450007115000,19,12,7,36.2,"MULTIPOLYGON(((11.815627053986457 64.12661281149435,11.810485305452092 64.17141258712425,11.913189729426284 64.17362353371195,11.918166560751159 64.12881937476001,11.815627053986457 64.12661281149435)))"
23500007115000,6,4,2,46.7,"MULTIPOLYGON(((11.918166560751159 64.12881937476001,11.913189729426284 64.17362353371195,12.015912130814097 64.1757622225233,12.020723952234274 64.13095382284078,11.918166560751159 64.12881937476001)))"
23550007115000,8,3,5,60.6,"MULTIPOLYGON(((12.020723952234274 64.13095382284078,12.015912130814097 64.1757622225233,12.118651916526954 64.17782863038633,12.123298638384014 64.13301613267657,12.020723952234274 64.13095382284078)))"
23600007115000,5,4,1,59.2,"MULTIPOLYGON(((12.123298638384014 64.13301613267657,12.118651916526954 64.17782863038633,12.221408492852976 64.17982273490523,12.225890028530658 64.1350062819798,12.123298638384014 64.13301613267657)))"
23650007115000,10,6,4,37.9,"MULTIPOLYGON(((12.225890028530658 64.1350062819798,12.221408492852976 64.17982273490523,12.324181265477991 64.18174451446114,12.328497531407367 64.13692424923617,12.225890028530658 64.1350062819798)))"
23750007115000,21,10,11,45.3,"MULTIPOLYGON(((12.431120555171017 64.13877001370561,12.426969639506545 64.18359394821331,12.529773019482995 64.18537101609972,12.533758507423114 64.14054355542322,12.431120555171017 64.13877001370561)))"
24350007115000,16,11,5,35,"MULTIPOLYGON(((13.663591343678553 64.15528088107595,13.661429794402832 64.20013766010598,13.764366625283138 64.20104505737265,13.76636205728596 64.15618647573851,13.663591343678553 64.15528088107595)))"
24400007115000,96,50,46,48.6,"MULTIPOLYGON(((13.76636205728596 64.15618647573851,13.764366625283138 64.20104505737265,13.867310679885502 64.20187989919656,13.86913995725484 64.1570196589904,13.76636205728596 64.15618647573851)))"
24450007115000,31,18,13,44.1,"MULTIPOLYGON(((13.86913995725484 64.1570196589904,13.867310679885502 64.20187989919656,13.970261357149827 64.20264217649614,13.971924445630556 64.15778042179402,13.86913995725484 64.1570196589904)))"
24500007115000,3,1,2,0,"MULTIPOLYGON(((13.971924445630556 64.15778042179402,13.970261357149827 64.20264217649614,14.07321805577701 64.20333188097814,14.074714924221542 64.15846875589642,13.971924445630556 64.15778042179402)))"
22600007120000,68,37,31,57.4,"MULTIPOLYGON(((10.067831902861812 64.12279724693828,10.059875134191934 64.1675000047084,10.162347365094778 64.1709418499728,10.170140672602416 64.12623228374868,10.067831902861812 64.12279724693828)))"
22650007120000,141,78,63,44.9,"MULTIPOLYGON(((10.170140672602416 64.12623228374868,10.162347365094778 64.1709418499728,10.264847684849382 64.1743118084599,10.272477386873753 64.12959557435023,10.170140672602416 64.12623228374868)))"
22700007120000,30,17,13,41.3,"MULTIPOLYGON(((10.272477386873753 64.12959557435023,10.264847684849382 64.1743118084599,10.367375511172314 64.17760984380918,10.374841466331207 64.13288708255725,10.272477386873753 64.12959557435023)))"
22750007120000,38,19,19,42.3,"MULTIPOLYGON(((10.374841466331207 64.13288708255725,10.367375511172314 64.17760984380918,10.469930260801918 64.18083592041835,10.477232330660296 64.13610677293867,10.374841466331207 64.13288708255725)))"
22800007120000,30,14,16,35.4,"MULTIPOLYGON(((10.477232330660296 64.13610677293867,10.469930260801918 64.18083592041835,10.57251134951827 64.18399000344489,10.57964939859647 64.13925461081965,10.477232330660296 64.13610677293867)))"
23150007120000,295,156,139,44.5,"MULTIPOLYGON(((11.194669416461071 64.15663088945033,11.188518170646216 64.20140078128777,11.291267198545128 64.20404999777121,11.297253558625398 64.1592748527551,11.194669416461071 64.15663088945033)))"
23350007120000,1,1,0,0,"MULTIPOLYGON(((11.605132758857069 64.16677401718188,11.599641713260109 64.21156406743775,11.70247371956688 64.21392414017335,11.707799451335912 64.16912940670721,11.605132758857069 64.16677401718188)))"
23400007120000,18,9,9,33.7,"MULTIPOLYGON(((11.707799451335912 64.16912940670721,11.70247371956688 64.21392414017335,11.805324986948873 64.21621186098966,11.810485305452092 64.17141258712425,11.707799451335912 64.16912940670721)))"
23450007120000,115,57,58,46.3,"MULTIPOLYGON(((11.810485305452092 64.17141258712425,11.805324986948873 64.21621186098966,11.908194920580417 64.21842720504544,11.913189729426284 64.17362353371195,11.810485305452092 64.17141258712425)))"
23500007120000,55,31,24,45.3,"MULTIPOLYGON(((11.913189729426284 64.17362353371195,11.908194920580417 64.21842720504544,12.011082924965008 64.22057014827726,12.015912130814097 64.1757622225233,11.913189729426284 64.17362353371195)))"
23550007120000,21,10,11,58,"MULTIPOLYGON(((12.015912130814097 64.1757622225233,12.011082924965008 64.22057014827726,12.113988403956341 64.22264066740047,12.118651916526954 64.17782863038633,12.015912130814097 64.1757622225233)))"
23600007120000,28,15,13,44.2,"MULTIPOLYGON(((12.118651916526954 64.17782863038633,12.113988403956341 64.22264066740047,12.21691076077942 64.22463873991025,12.221408492852976 64.17982273490523,12.118651916526954 64.17782863038633)))"
23650007120000,349,187,162,42.2,"MULTIPOLYGON(((12.221408492852976 64.17982273490523,12.21691076077942 64.22463873991025,12.31984939805171 64.2265643440826,12.324181265477991 64.18174451446114,12.221408492852976 64.17982273490523)))"
23700007120000,133,69,64,40.2,"MULTIPOLYGON(((12.324181265477991 64.18174451446114,12.31984939805171 64.2265643440826,12.42280371780434 64.22841745897523,12.426969639506545 64.18359394821331,12.324181265477991 64.18174451446114)))"
23750007120000,6,3,3,40.3,"MULTIPOLYGON(((12.426969639506545 64.18359394821331,12.42280371780434 64.22841745897523,12.525773121503383 64.23019806442854,12.529773019482995 64.18537101609972,12.426969639506545 64.18359394821331)))"
24300007120000,30,15,15,43.1,"MULTIPOLYGON(((13.558500788044048 64.19915771726615,13.55616473686985 64.2440122259295,13.659260420558546 64.2449941216626,13.661429794402832 64.20013766010598,13.558500788044048 64.19915771726615)))"
24350007120000,8,6,2,31.5,"MULTIPOLYGON(((13.661429794402832 64.20013766010598,13.659260420558546 64.2449941216626,13.76236396951482 64.24590332737273,13.764366625283138 64.20104505737265,13.661429794402832 64.20013766010598)))"
24400007120000,203,104,99,43.3,"MULTIPOLYGON(((13.764366625283138 64.20104505737265,13.76236396951482 64.24590332737273,13.865474779814377 64.24673983314209,13.867310679885502 64.20187989919656,13.764366625283138 64.20104505737265)))"
22550007125000,2,1,1,0,"MULTIPOLYGON(((9.95743157342619 64.1639863097839,9.949282240267882 64.20868128276491,10.051889695215305 64.21220194884897,10.059875134191934 64.1675000047084,9.95743157342619 64.1639863097839)))"
22600007125000,4,2,2,0,"MULTIPOLYGON(((10.059875134191934 64.1675000047084,10.051889695215305 64.21220194884897,10.15452596856903 64.2156506244422,10.162347365094778 64.1709418499728,10.059875134191934 64.1675000047084)))"
22650007125000,177,84,93,46.4,"MULTIPOLYGON(((10.162347365094778 64.1709418499728,10.15452596856903 64.2156506244422,10.257190476093642 64.2190272722478,10.264847684849382 64.1743118084599,10.162347365094778 64.1709418499728)))"
22700007125000,52,27,25,52.3,"MULTIPOLYGON(((10.264847684849382 64.1743118084599,10.257190476093642 64.2190272722478,10.359882632547032 64.2223318557293,10.367375511172314 64.17760984380918,10.264847684849382 64.1743118084599)))"
22750007125000,81,38,43,39.2,"MULTIPOLYGON(((10.367375511172314 64.17760984380918,10.359882632547032 64.2223318557293,10.462601851700418 64.225564339112,10.469930260801918 64.18083592041835,10.367375511172314 64.17760984380918)))"
23050007125000,4,2,2,0,"MULTIPOLYGON(((10.983087378437425 64.19588572954885,10.976583303435207 64.24064405594906,11.079452535276326 64.2434432303229,11.085791367156219 64.19867934871894,10.983087378437425 64.19588572954885)))"
23150007125000,550,289,261,48.3,"MULTIPOLYGON(((11.188518170646216 64.20140078128777,11.182344700289816 64.24617007563148,11.2852592050848 64.24882456224748,11.291267198545128 64.20404999777121,11.188518170646216 64.20140078128777)))"
23200007125000,23,12,11,39.1,"MULTIPOLYGON(((11.291267198545128 64.20404999777121,11.2852592050848 64.24882456224748,11.388195455467764 64.25140666131799,11.39403785969491 64.20662696945594,11.291267198545128 64.20404999777121)))"
23250007125000,7,3,4,33.4,"MULTIPOLYGON(((11.39403785969491 64.20662696945594,11.388195455467764 64.25140666131799,11.49115285646335 64.25391634476593,11.496829562162413 64.20913166840079,11.39403785969491 64.20662696945594)))"
23600007125000,10,7,3,61.3,"MULTIPOLYGON(((12.113988403956341 64.22264066740047,12.109308013452722 64.26745224310835,12.21239674815893 64.26945429645114,12.21691076077942 64.22463873991025,12.113988403956341 64.22264066740047)))"
23650007125000,78,36,42,42.5,"MULTIPOLYGON(((12.21691076077942 64.22463873991025,12.21239674815893 64.26945429645114,12.315501848050905 64.27138373762126,12.31984939805171 64.2265643440826,12.21691076077942 64.22463873991025)))"
23700007125000,900,439,461,46.4,"MULTIPOLYGON(((12.31984939805171 64.2265643440826,12.315501848050905 64.27138373762126,12.418622712065098 64.2732405455743,12.42280371780434 64.22841745897523,12.31984939805171 64.2265643440826)))"
23750007125000,254,128,126,40.8,"MULTIPOLYGON(((12.42280371780434 64.22841745897523,12.418622712065098 64.2732405455743,12.521758738567978 64.27502470005224,12.525773121503383 64.23019806442854,12.42280371780434 64.22841745897523)))"
23800007125000,64,29,35,44.8,"MULTIPOLYGON(((12.525773121503383 64.23019806442854,12.521758738567978 64.27502470005224,12.624909325377521 64.27673618158448,12.628757010071146 64.23190614106643,12.525773121503383 64.23019806442854)))"
24300007125000,16,8,8,51.6,"MULTIPOLYGON(((13.55616473686985 64.2440122259295,13.553820216737403 64.28886641092167,13.657083181399232 64.28985026588614,13.659260420558546 64.2449941216626,13.55616473686985 64.2440122259295)))"
24350007125000,99,56,43,43.7,"MULTIPOLYGON(((13.659260420558546 64.2449941216626,13.657083181399232 64.28985026588614,13.760354052359402 64.29076128590974,13.76236396951482 64.24590332737273,13.659260420558546 64.2449941216626)))"
22650007130000,1,1,0,0,"MULTIPOLYGON(((10.15452596856903 64.2156506244422,10.146676337704612 64.2603586048154,10.249505618244685 64.26374196348388,10.257190476093642 64.2190272722478,10.15452596856903 64.2156506244422)))"
22700007130000,161,83,78,47.6,"MULTIPOLYGON(((10.257190476093642 64.2190272722478,10.249505618244685 64.26374196348388,10.352362691060664 64.26705311619672,10.359882632547032 64.2223318557293,10.257190476093642 64.2190272722478)))"
22750007130000,19,9,10,48.9,"MULTIPOLYGON(((10.359882632547032 64.2223318557293,10.352362691060664 64.26705311619672,10.455246966936524 64.2702920270057,10.462601851700418 64.225564339112,10.359882632547032 64.2223318557293)))"
22850007130000,138,79,59,44.7,"MULTIPOLYGON(((10.565347546358462 64.22872468738461,10.558157855681326 64.27345866072955,10.661094766149587 64.27655298295555,10.668119128379498 64.2318128663007,10.565347546358462 64.22872468738461)))"
22900007130000,18,10,8,65.3,"MULTIPOLYGON(((10.668119128379498 64.2318128663007,10.661094766149587 64.27655298295555,10.764057106261749 64.27957496004097,10.770916008695785 64.23482884238014,10.668119128379498 64.2318128663007)))"
23100007130000,21,11,10,57.1,"MULTIPOLYGON(((11.079452535276326 64.2434432303229,11.073090770086838 64.28820649560649,11.176148890018139 64.29093877115218,11.182344700289816 64.24617007563148,11.079452535276326 64.2434432303229)))"
23150007130000,106,57,49,46.6,"MULTIPOLYGON(((11.182344700289816 64.24617007563148,11.176148890018139 64.29093877115218,11.279229465906194 64.29359854494321,11.2852592050848 64.24882456224748,11.182344700289816 64.24617007563148)))"
23200007130000,9,5,4,34.8,"MULTIPOLYGON(((11.2852592050848 64.24882456224748,11.279229465906194 64.29359854494321,11.38233190050117 64.2961857879862,11.388195455467764 64.25140666131799,11.2852592050848 64.24882456224748)))"
23650007130000,3,2,1,0,"MULTIPOLYGON(((12.21239674815893 64.26945429645114,12.207866370254106 64.31426940397859,12.311138533832883 64.31620269459275,12.315501848050905 64.27138373762126,12.21239674815893 64.26945429645114)))"
23700007130000,3,1,2,0,"MULTIPOLYGON(((12.315501848050905 64.27138373762126,12.311138533832883 64.31620269459275,12.414426543745753 64.3180632075886,12.418622712065098 64.2732405455743,12.315501848050905 64.27138373762126)))"
23750007130000,28,13,15,37.4,"MULTIPOLYGON(((12.418622712065098 64.2732405455743,12.414426543745753 64.3180632075886,12.517729795238086 64.31985092260909,12.521758738567978 64.27502470005224,12.418622712065098 64.2732405455743)))"
23800007130000,97,52,45,46.8,"MULTIPOLYGON(((12.521758738567978 64.27502470005224,12.517729795238086 64.31985092260909,12.621047683001972 64.32156582008847,12.624909325377521 64.27673618158448,12.521758738567978 64.27502470005224)))"
24300007130000,28,14,14,54.4,"MULTIPOLYGON(((13.553820216737403 64.28886641092167,13.551467183471365 64.33372027234878,13.65489803589371 64.33470609291606,13.657083181399232 64.28985026588614,13.553820216737403 64.28886641092167)))"
22700007135000,14,10,4,66.5,"MULTIPOLYGON(((10.249505618244685 64.26374196348388,10.241792967953948 64.30845587992093,10.344815546351922 64.31177362307419,10.352362691060664 64.26705311619672,10.249505618244685 64.26374196348388)))"
22750007135000,32,20,12,50.1,"MULTIPOLYGON(((10.352362691060664 64.26705311619672,10.344815546351922 64.31177362307419,10.447865469144599 64.31501898206977,10.455246966936524 64.2702920270057,10.352362691060664 64.26705311619672)))"
22800007135000,327,169,158,46.5,"MULTIPOLYGON(((10.455246966936524 64.2702920270057,10.447865469144599 64.31501898206977,10.550942143125045 64.31819192155541,10.558157855681326 64.27345866072955,10.455246966936524 64.2702920270057)))"
22850007135000,22,13,9,27.1,"MULTIPOLYGON(((10.558157855681326 64.27345866072955,10.550942143125045 64.31819192155541,10.654044974123517 64.32129240695096,10.661094766149587 64.27655298295555,10.558157855681326 64.27345866072955)))"
23000007135000,9,6,3,50.1,"MULTIPOLYGON(((10.867044283024716 64.28252455911452,10.860326725805356 64.32727588102092,10.963504453521265 64.33015880440922,10.970055702552484 64.28540174807773,10.867044283024716 64.28252455911452)))"
23150007135000,135,72,63,44.4,"MULTIPOLYGON(((11.176148890018139 64.29093877115218,11.16993062365477 64.3357068665096,11.273177867889224 64.33837194460735,11.279229465906194 64.29359854494321,11.176148890018139 64.29093877115218)))"
23200007135000,1,0,1,0,"MULTIPOLYGON(((11.279229465906194 64.29359854494321,11.273177867889224 64.33837194460735,11.37644708473818 64.34096434829637,11.38233190050117 64.2961857879862,11.279229465906194 64.29359854494321)))"
23300007135000,69,34,35,40.3,"MULTIPOLYGON(((11.485455595764616 64.29870047206725,11.479737673079006 64.34348404922503,11.583049031014836 64.3459310198262,11.588599952890528 64.30114256975321,11.485455595764616 64.29870047206725)))"
23700007135000,8,4,4,33.8,"MULTIPOLYGON(((12.311138533832883 64.31620269459275,12.306759373184939 64.36102121450759,12.410215133754734 64.36288544459161,12.414426543745753 64.3180632075886,12.311138533832883 64.31620269459275)))"
24300007135000,1,0,1,0,"MULTIPOLYGON(((13.551467183471365 64.33372027234878,13.549105592587203 64.37857381031596,13.652704942723595 64.37956160289109,13.65489803589371 64.33470609291606,13.551467183471365 64.33372027234878)))"
22750007140000,1,1,0,0,"MULTIPOLYGON(((10.344815546351922 64.31177362307419,10.337241057084595 64.35649337420772,10.440457220004435 64.35974520225872,10.447865469144599 64.31501898206977,10.344815546351922 64.31177362307419)))"
22800007140000,322,161,161,48.6,"MULTIPOLYGON(((10.447865469144599 64.31501898206977,10.440457220004435 64.35974520225872,10.543700273393705 64.36292446792282,10.550942143125045 64.31819192155541,10.447865469144599 64.31501898206977)))"
22950007140000,21,11,10,61.7,"MULTIPOLYGON(((10.757173367028084 64.32432040444992,10.750264661771606 64.36906517387287,10.853584799500727 64.37202654699497,10.860326725805356 64.32727588102092,10.757173367028084 64.32432040444992)))"
23000007140000,18,8,10,54.6,"MULTIPOLYGON(((10.860326725805356 64.32727588102092,10.853584799500727 64.37202654699497,10.956929433222122 64.37491522340541,10.963504453521265 64.33015880440922,10.860326725805356 64.32727588102092)))"
23150007140000,28,15,13,32.7,"MULTIPOLYGON(((11.16993062365477 64.3357068665096,11.163689784213647 64.38047436035232,11.267104297125169 64.3831447599783,11.273177867889224 64.33837194460735,11.16993062365477 64.3357068665096)))"
23200007140000,79,37,42,41.3,"MULTIPOLYGON(((11.273177867889224 64.33837194460735,11.267104297125169 64.3831447599783,11.37054089735428 64.38574234107433,11.37644708473818 64.34096434829637,11.273177867889224 64.33837194460735)))"
23250007140000,221,120,101,38.9,"MULTIPOLYGON(((11.37644708473818 64.34096434829637,11.37054089735428 64.38574234107433,11.473998980672905 64.38826707515018,11.479737673079006 64.34348404922503,11.37644708473818 64.34096434829637)))"
23300007140000,124,66,58,38.9,"MULTIPOLYGON(((11.479737673079006 64.34348404922503,11.473998980672905 64.38826707515018,11.577477942071987 64.39071893450381,11.583049031014836 64.3459310198262,11.479737673079006 64.34348404922503)))"
23700007140000,46,23,23,37.1,"MULTIPOLYGON(((12.306759373184939 64.36102121450759,12.302364283319394 64.40583929687104,12.40598840244717 64.40770725615208,12.410215133754734 64.36288544459161,12.306759373184939 64.36102121450759)))"
24350007140000,9,5,4,55.4,"MULTIPOLYGON(((13.652704942723595 64.37956160289109,13.650503860280782 64.42441679594907,13.754280352396968 64.42533329444325,13.756312282083973 64.3804762692755,13.652704942723595 64.37956160289109)))"
22800007145000,35,20,15,61.2,"MULTIPOLYGON(((10.440457220004435 64.35974520225872,10.433022080232968 64.40447068551107,10.536432110249173 64.40765629787712,10.543700273393705 64.36292446792282,10.440457220004435 64.35974520225872)))"
22850007145000,4,3,1,0,"MULTIPOLYGON(((10.543700273393705 64.36292446792282,10.536432110249173 64.40765629787712,10.639868570707327 64.41076916960651,10.646969620037767 64.36603113645131,10.543700273393705 64.36292446792282)))"
22950007145000,3,2,1,0,"MULTIPOLYGON(((10.750264661771606 64.36906517387287,10.743330860368431 64.4138092665619,10.846818377055909 64.41677655538858,10.853584799500727 64.37202654699497,10.750264661771606 64.36906517387287)))"
23150007145000,30,19,11,42.8,"MULTIPOLYGON(((11.163689784213647 64.38047436035232,11.157426253891986 64.42524125131783,11.261008638909786 64.42791698978395,11.267104297125169 64.3831447599783,11.163689784213647 64.38047436035232)))"
23200007145000,1,1,0,0,"MULTIPOLYGON(((11.267104297125169 64.3831447599783,11.261008638909786 64.42791698978395,11.364613226750697 64.43051976513608,11.37054089735428 64.38574234107433,11.267104297125169 64.3831447599783)))"
23250007145000,740,376,364,41.3,"MULTIPOLYGON(((11.37054089735428 64.38574234107433,11.364613226750697 64.43051976513608,11.468239410059766 64.43304954874432,11.473998980672905 64.38826707515018,11.37054089735428 64.38574234107433)))"
23300007145000,353,177,176,37.8,"MULTIPOLYGON(((11.473998980672905 64.38826707515018,11.468239410059766 64.43304954874432,11.571886580694228 64.43550631277093,11.577477942071987 64.39071893450381,11.473998980672905 64.38826707515018)))"
23450007145000,32,14,18,43.1,"MULTIPOLYGON(((11.78449607529948 64.39540392218508,11.779241447559455 64.44020067469573,11.882947923761229 64.44243822088963,11.88803403339878 64.39763699906081,11.78449607529948 64.39540392218508)))"
23500007145000,37,18,19,44.8,"MULTIPOLYGON(((11.88803403339878 64.39763699906081,11.882947923761229 64.44243822088963,11.986672947274158 64.44460264409547,11.991590442163671 64.39979709831276,11.88803403339878 64.39763699906081)))"
23650007145000,7,4,3,60.6,"MULTIPOLYGON(((12.198756176679396 64.40389826976795,12.194176188556742 64.4487120269031,12.297953180868557 64.45065694118323,12.302364283319394 64.40583929687104,12.198756176679396 64.40389826976795)))"
23700007145000,232,120,112,42.8,"MULTIPOLYGON(((12.302364283319394 64.40583929687104,12.297953180868557 64.45065694118323,12.40174626962006 64.45252864183395,12.40598840244717 64.40770725615208,12.302364283319394 64.40583929687104)))"
23750007145000,5,3,2,69.2,"MULTIPOLYGON(((12.40598840244717 64.40770725615208,12.40174626962006 64.45252864183395,12.505554840562471 64.45432710819715,12.509627923000654 64.40950212705404,12.40598840244717 64.40770725615208)))"
23800007145000,7,3,4,50,"MULTIPOLYGON(((12.509627923000654 64.40950212705404,12.505554840562471 64.45432710819715,12.609378278879054 64.45605232041754,12.61328223335477 64.41122388981874,12.509627923000654 64.40950212705404)))"
23850007145000,1,1,0,0,"MULTIPOLYGON(((12.61328223335477 64.41122388981874,12.609378278879054 64.45605232041754,12.71321596920744 64.4577042594434,12.71695072134356 64.41287252548776,12.61328223335477 64.41122388981874)))"
24250007145000,37,19,18,39.6,"MULTIPOLYGON(((13.442975585768899 64.42236399229868,13.440427063164256 64.46721475197657,13.544356558464301 64.46827991628581,13.54673539928852 64.42342702492728,13.442975585768899 64.42236399229868)))"
24300007145000,260,121,139,53.1,"MULTIPOLYGON(((13.54673539928852 64.42342702492728,13.544356558464301 64.46827991628581,13.648294746664908 64.46927167222715,13.650503860280782 64.42441679594907,13.54673539928852 64.42342702492728)))"
24350007145000,52,28,24,44.3,"MULTIPOLYGON(((13.650503860280782 64.42441679594907,13.648294746664908 64.46927167222715,13.752241008184196 64.47019000882597,13.754280352396968 64.42533329444325,13.650503860280782 64.42441679594907)))"
24400007145000,5,3,2,57.4,"MULTIPOLYGON(((13.754280352396968 64.42533329444325,13.752241008184196 64.47019000882597,13.856194723142874 64.47103491591861,13.858064258993545 64.42617651029602,13.754280352396968 64.42533329444325)))"
22850007150000,21,11,10,60,"MULTIPOLYGON(((10.536432110249173 64.40765629787712,10.529137516502916 64.45238740944826,10.632741692017666 64.45550650455172,10.639868570707327 64.41076916960651,10.536432110249173 64.40765629787712)))"
22900007150000,10,5,5,47.5,"MULTIPOLYGON(((10.639868570707327 64.41076916960651,10.632741692017666 64.45550650455172,10.736371831786135 64.45855268075513,10.743330860368431 64.4138092665619,10.639868570707327 64.41076916960651)))"
22950007150000,99,48,51,47,"MULTIPOLYGON(((10.743330860368431 64.4138092665619,10.736371831786135 64.45855268075513,10.840027330528514 64.46152590454041,10.846818377055909 64.41677655538858,10.743330860368431 64.4138092665619)))"
23000007150000,13,7,6,53.3,"MULTIPOLYGON(((10.846818377055909 64.41677655538858,10.840027330528514 64.46152590454041,10.943707582040565 64.46442614317728,10.950330517676761 64.41967100351582,10.846818377055909 64.41677655538858)))"
23050007150000,19,11,8,56.1,"MULTIPOLYGON(((10.950330517676761 64.41967100351582,10.943707582040565 64.46442614317728,11.047411979215045 64.46725336472468,11.053866678242805 64.42249257915837,10.950330517676761 64.41967100351582)))"
23100007150000,25,12,13,44.7,"MULTIPOLYGON(((11.053866678242805 64.42249257915837,11.047411979215045 64.46725336472468,11.151139914063206 64.47000753803222,11.157426253891986 64.42524125131783,11.053866678242805 64.42249257915837)))"
23150007150000,43,22,21,50.4,"MULTIPOLYGON(((11.157426253891986 64.42524125131783,11.151139914063206 64.47000753803222,11.254890777736387 64.47268863274147,11.261008638909786 64.42791698978395,11.157426253891986 64.42524125131783)))"
23250007150000,666,325,341,34,"MULTIPOLYGON(((11.364613226750697 64.43051976513608,11.358663960547648 64.4752966192874,11.462458851993542 64.47783146889957,11.468239410059766 64.43304954874432,11.364613226750697 64.43051976513608)))"
23300007150000,8551,4145,4406,42.7,"MULTIPOLYGON(((11.468239410059766 64.43304954874432,11.462458851993542 64.47783146889957,11.5662748407759 64.4802931536035,11.571886580694228 64.43550631277093,11.468239410059766 64.43304954874432)))"
23350007150000,114,60,54,42.1,"MULTIPOLYGON(((11.571886580694228 64.43550631277093,11.5662748407759 64.4802931536035,11.670111314823721 64.48268164622182,11.675554129745205 64.43789003017139,11.571886580694228 64.43550631277093)))"
23400007150000,942,466,476,37.3,"MULTIPOLYGON(((11.675554129745205 64.43789003017139,11.670111314823721 64.48268164622182,11.773967661315135 64.48499692037555,11.779241447559455 64.44020067469573,11.675554129745205 64.43789003017139)))"
23450007150000,393,207,186,41.4,"MULTIPOLYGON(((11.779241447559455 64.44020067469573,11.773967661315135 64.48499692037555,11.877843266699415 64.48723895048524,11.882947923761229 64.44243822088963,11.779241447559455 64.44020067469573)))"
23500007150000,342,172,170,44.5,"MULTIPOLYGON(((11.882947923761229 64.44243822088963,11.877843266699415 64.48723895048524,11.981737516719072 64.48940771177197,11.986672947274158 64.44460264409547,11.882947923761229 64.44243822088963)))"
23550007150000,305,169,136,37.9,"MULTIPOLYGON(((11.986672947274158 64.44460264409547,11.981737516719072 64.48940771177197,12.08564979643201 64.49150318025872,12.09041590634321 64.44669392045357,11.986672947274158 64.44460264409547)))"
23600007150000,194,95,99,46.5,"MULTIPOLYGON(((12.09041590634321 64.44669392045357,12.08564979643201 64.49150318025872,12.189579490233738 64.49352533277118,12.194176188556742 64.4487120269031,12.09041590634321 64.44669392045357)))"
23650007150000,396,218,178,43.4,"MULTIPOLYGON(((12.194176188556742 64.4487120269031,12.189579490233738 64.49352533277118,12.29352598187966 64.49547414693892,12.297953180868557 64.45065694118323,12.194176188556742 64.4487120269031)))"
23700007150000,933,423,510,43.9,"MULTIPOLYGON(((12.297953180868557 64.45065694118323,12.29352598187966 64.49547414693892,12.397488654507391 64.49734960119625,12.40174626962006 64.45252864183395,12.297953180868557 64.45065694118323)))"
24150007150000,7,3,4,57.4,"MULTIPOLYGON(((13.23259662796987 64.46486424620488,13.229698341307502 64.50970995692165,13.333778793157656 64.51092433477325,13.336506880026494 64.46607619108458,13.23259662796987 64.46486424620488)))"
24200007150000,52,29,23,53.6,"MULTIPOLYGON(((13.336506880026494 64.46607619108458,13.333778793157656 64.51092433477325,13.437869228340181 64.51206518151628,13.440427063164256 64.46721475197657,13.336506880026494 64.46607619108458)))"
24250007150000,36,15,21,46.6,"MULTIPOLYGON(((13.440427063164256 64.46721475197657,13.437869228340181 64.51206518151628,13.54196902468616 64.51313248449347,13.544356558464301 64.46827991628581,13.440427063164256 64.46721475197657)))"
24300007150000,14,9,5,42.6,"MULTIPOLYGON(((13.544356558464301 64.46827991628581,13.54196902468616 64.51313248449347,13.646077559680782 64.51412623186154,13.648294746664908 64.46927167222715,13.544356558464301 64.46827991628581)))"
24350007150000,10,7,3,51.4,"MULTIPOLYGON(((13.648294746664908 64.46927167222715,13.646077559680782 64.51412623186154,13.750194210486258 64.51504641259164,13.752241008184196 64.47019000882597,13.648294746664908 64.46927167222715)))"
24400007150000,37,20,17,35.1,"MULTIPOLYGON(((13.752241008184196 64.47019000882597,13.750194210486258 64.51504641259164,13.85431835396477 64.51589301646995,13.856194723142874 64.47103491591861,13.752241008184196 64.47019000882597)))"
24450007150000,11,8,3,41.9,"MULTIPOLYGON(((13.856194723142874 64.47103491591861,13.85431835396477 64.51589301646995,13.958449366701434 64.51666603409805,13.960155271387015 64.47180638415286,13.856194723142874 64.47103491591861)))"
24500007150000,6,4,2,50.8,"MULTIPOLYGON(((13.960155271387015 64.47180638415286,13.958449366701434 64.51666603409805,14.06258662502731 64.51736545689332,14.064122032510843 64.47250440498831,13.960155271387015 64.47180638415286)))"
22900007155000,42,24,18,56.7,"MULTIPOLYGON(((10.632741692017666 64.45550650455172,10.625588848916664 64.50024313940727,10.729387444075863 64.50329541467649,10.736371831786135 64.45855268075513,10.632741692017666 64.45550650455172)))"
22950007155000,121,68,53,49.2,"MULTIPOLYGON(((10.736371831786135 64.45855268075513,10.729387444075863 64.50329541467649,10.833211531080947 64.50627459277567,10.840027330528514 64.46152590454041,10.736371831786135 64.45855268075513)))"
23000007155000,590,284,306,43.1,"MULTIPOLYGON(((10.840027330528514 64.46152590454041,10.833211531080947 64.50627459277567,10.93706050059502 64.50918064081387,10.943707582040565 64.46442614317728,10.840027330528514 64.46152590454041)))"
23050007155000,14,7,7,33.2,"MULTIPOLYGON(((10.943707582040565 64.46442614317728,10.93706050059502 64.50918064081387,11.040933742370282 64.5120135266932,11.047411979215045 64.46725336472468,10.943707582040565 64.46442614317728)))"
23100007155000,76,38,38,44.4,"MULTIPOLYGON(((11.047411979215045 64.46725336472468,11.040933742370282 64.5120135266932,11.144830645269705 64.5147732191102,11.151139914063206 64.47000753803222,11.047411979215045 64.46725336472468)))"
23150007155000,88,43,45,51.6,"MULTIPOLYGON(((11.151139914063206 64.47000753803222,11.144830645269705 64.5147732191102,11.248750597288812 64.51745968755726,11.254890777736387 64.47268863274147,11.151139914063206 64.47000753803222)))"
23200007155000,107,56,51,45.7,"MULTIPOLYGON(((11.254890777736387 64.47268863274147,11.248750597288812 64.51745968755726,11.35269298557752 64.52007290232399,11.358663960547648 64.4752966192874,11.254890777736387 64.47268863274147)))"
23250007155000,66,32,34,50,"MULTIPOLYGON(((11.358663960547648 64.4752966192874,11.35269298557752 64.52007290232399,11.456657196462054 64.52261283449845,11.462458851993542 64.47783146889957,11.358663960547648 64.4752966192874)))"
23300007155000,941,475,466,37.9,"MULTIPOLYGON(((11.462458851993542 64.47783146889957,11.456657196462054 64.52261283449845,11.56064261546696 64.52507945596848,11.5662748407759 64.4802931536035,11.462458851993542 64.47783146889957)))"
23350007155000,62,32,30,40.3,"MULTIPOLYGON(((11.5662748407759 64.4802931536035,11.56064261546696 64.52507945596848,11.664648627337172 64.52747273942299,11.670111314823721 64.48268164622182,11.5662748407759 64.4802931536035)))"
23400007155000,37,21,16,42.6,"MULTIPOLYGON(((11.670111314823721 64.48268164622182,11.664648627337172 64.52747273942299,11.768674616060157 64.52979265835305,11.773967661315135 64.48499692037555,11.670111314823721 64.48268164622182)))"
23450007155000,58,30,28,45.2,"MULTIPOLYGON(((11.773967661315135 64.48499692037555,11.768674616060157 64.52979265835305,11.872719964888121 64.53203918705321,11.877843266699415 64.48723895048524,11.773967661315135 64.48499692037555)))"
23500007155000,1076,546,530,41.7,"MULTIPOLYGON(((11.877843266699415 64.48723895048524,11.872719964888121 64.53203918705321,11.976784056360309 64.53421230062257,11.981737516719072 64.48940771177197,11.877843266699415 64.48723895048524)))"
23550007155000,478,267,211,38.9,"MULTIPOLYGON(((11.981737516719072 64.48940771177197,11.976784056360309 64.53421230062257,12.08086627232533 64.5363119749658,12.08564979643201 64.49150318025872,11.981737516719072 64.48940771177197)))"
23600007155000,52,26,26,38.4,"MULTIPOLYGON(((12.08564979643201 64.49150318025872,12.08086627232533 64.5363119749658,12.184965993963582 64.53833818679436,12.189579490233738 64.49352533277118,12.08564979643201 64.49150318025872)))"
23700007155000,51,23,28,37.6,"MULTIPOLYGON(((12.29352598187966 64.49547414693892,12.289082601809717 64.5402909136275,12.39321547577518 64.54217013379318,12.397488654507391 64.49734960119625,12.29352598187966 64.49547414693892)))"
23750007155000,99,50,49,46.5,"MULTIPOLYGON(((12.397488654507391 64.49734960119625,12.39321547577518 64.54217013379318,12.497363995170785 64.54397582642906,12.501466890659175 64.49915167478336,12.397488654507391 64.49734960119625)))"
24250007155000,3,2,1,0,"MULTIPOLYGON(((13.437869228340181 64.51206518151628,13.435302032295008 64.55691528098157,13.539572752205547 64.55798472965114,13.54196902468616 64.51313248449347,13.437869228340181 64.51206518151628)))"
24300007155000,26,13,13,43.2,"MULTIPOLYGON(((13.54196902468616 64.51313248449347,13.539572752205547 64.55798472965114,13.643852256835796 64.55898047498762,13.646077559680782 64.51412623186154,13.54196902468616 64.51313248449347)))"
24350007155000,35,18,17,44.6,"MULTIPOLYGON(((13.646077559680782 64.51412623186154,13.643852256835796 64.55898047498762,13.748139920069109 64.55990250590764,13.750194210486258 64.51504641259164,13.646077559680782 64.51412623186154)))"
22950007160000,17,8,9,37,"MULTIPOLYGON(((10.729387444075863 64.50329541467649,10.722377564364287 64.54803746653572,10.826370848972571 64.55102261840607,10.833211531080947 64.50627459277567,10.729387444075863 64.50329541467649)))"
23000007160000,4,2,2,0,"MULTIPOLYGON(((10.833211531080947 64.50627459277567,10.826370848972571 64.55102261840607,10.930389146740083 64.55393449483687,10.93706050059502 64.50918064081387,10.833211531080947 64.50627459277567)))"
23050007160000,14,7,7,51.7,"MULTIPOLYGON(((10.93706050059502 64.50918064081387,10.930389146740083 64.55393449483687,11.034431844256774 64.55677306357235,11.040933742370282 64.5120135266932,10.93706050059502 64.50918064081387)))"
23100007160000,8,3,5,67,"MULTIPOLYGON(((11.040933742370282 64.5120135266932,11.034431844256774 64.55677306357235,11.138498327215578 64.55953829315496,11.144830645269705 64.5147732191102,11.040933742370282 64.5120135266932)))"
23200007160000,304,153,151,41.9,"MULTIPOLYGON(((11.248750597288812 64.51745968755726,11.242587980434354 64.56223015292687,11.346700187877943 64.5648486130313,11.35269298557752 64.52007290232399,11.248750597288812 64.51745968755726)))"
23250007160000,23,8,15,49.3,"MULTIPOLYGON(((11.35269298557752 64.52007290232399,11.346700187877943 64.5648486130313,11.450834332680254 64.56739364441388,11.456657196462054 64.52261283449845,11.35269298557752 64.52007290232399)))"
23300007160000,122,65,57,42.3,"MULTIPOLYGON(((11.456657196462054 64.52261283449845,11.450834332680254 64.56739364441388,11.554989797166467 64.56986521882385,11.56064261546696 64.52507945596848,11.456657196462054 64.52261283449845)))"
23350007160000,46,18,28,45.5,"MULTIPOLYGON(((11.56064261546696 64.52507945596848,11.554989797166467 64.56986521882385,11.659165962875308 64.5722633088154,11.664648627337172 64.52747273942299,11.56064261546696 64.52507945596848)))"
23600007160000,46,25,21,47.2,"MULTIPOLYGON(((12.08086627232533 64.5363119749658,12.07606524243779 64.58112030392094,12.180335611381668 64.583150588389,12.184965993963582 64.53833818679436,12.08086627232533 64.5363119749658)))"
23650007160000,44,24,20,43.3,"MULTIPOLYGON(((12.184965993963582 64.53833818679436,12.180335611381668 64.583150588389,12.284622955520346 64.58510724073307,12.289082601809717 64.5402909136275,12.184965993963582 64.53833818679436)))"
23750007160000,154,78,76,47.1,"MULTIPOLYGON(((12.39321547577518 64.54217013379318,12.388926651516492 64.58699023917397,12.493246075426864 64.58879956274625,12.497363995170785 64.54397582642906,12.39321547577518 64.54217013379318)))"
23800007160000,146,79,67,40.5,"MULTIPOLYGON(((12.497363995170785 64.54397582642906,12.493246075426864 64.58879956274625,12.597580602725133 64.59053519129913,12.601527538729373 64.54570797148357,12.497363995170785 64.54397582642906)))"
23000007165000,6,4,2,27.2,"MULTIPOLYGON(((10.826370848972571 64.55102261840607,10.819505153551814 64.59576997972964,10.92369339298646 64.5986877036446,10.930389146740083 64.55393449483687,10.826370848972571 64.55102261840607)))"
23050007165000,80,40,40,47.3,"MULTIPOLYGON(((10.930389146740083 64.55393449483687,10.92369339298646 64.5986877036446,11.027906160555313 64.6015319738583,11.034431844256774 64.55677306357235,10.930389146740083 64.55393449483687)))"
23100007165000,5,3,2,50.2,"MULTIPOLYGON(((11.034431844256774 64.55677306357235,11.027906160555313 64.6015319738583,11.132142838759302 64.60430275875808,11.138498327215578 64.55953829315496,11.034431844256774 64.55677306357235)))"
23150007165000,95,50,45,43.7,"MULTIPOLYGON(((11.138498327215578 64.55953829315496,11.132142838759302 64.60430275875808,11.236402809216607 64.60700002753482,11.242587980434354 64.56223015292687,11.138498327215578 64.55953829315496)))"
23200007165000,75,40,35,43.6,"MULTIPOLYGON(((11.242587980434354 64.56223015292687,11.236402809216607 64.60700002753482,11.340685452684857 64.60962375018443,11.346700187877943 64.5648486130313,11.242587980434354 64.56223015292687)))"
23250007165000,49,26,23,47.3,"MULTIPOLYGON(((11.346700187877943 64.5648486130313,11.340685452684857 64.60962375018443,11.444990149083468 64.61217389750904,11.450834332680254 64.56739364441388,11.346700187877943 64.5648486130313)))"
23300007165000,1,1,0,0,"MULTIPOLYGON(((11.450834332680254 64.56739364441388,11.444990149083468 64.61217389750904,11.549316277515993 64.61465044111839,11.554989797166467 64.56986521882385,11.450834332680254 64.56739364441388)))"
23350007165000,41,21,20,50,"MULTIPOLYGON(((11.554989797166467 64.56986521882385,11.549316277515993 64.61465044111839,11.653663216292607 64.61705335343102,11.659165962875308 64.5722633088154,11.554989797166467 64.56986521882385)))"
23400007165000,18,11,7,35.1,"MULTIPOLYGON(((11.659165962875308 64.5722633088154,11.653663216292607 64.61705335343102,11.758030342952614 64.61938260767565,11.763362210581365 64.57458788774888,11.659165962875308 64.5722633088154)))"
23450007165000,4,1,3,0,"MULTIPOLYGON(((11.763362210581365 64.57458788774888,11.758030342952614 64.61938260767565,11.86241703428706 64.62163817789214,11.8675779203175 64.57683892979193,11.763362210581365 64.57458788774888)))"
23650007165000,188,101,87,47,"MULTIPOLYGON(((12.180335611381668 64.583150588389,12.175688253500171 64.62796253696546,12.280146957272512 64.62992312773416,12.284622955520346 64.58510724073307,12.180335611381668 64.583150588389)))"
23700007165000,453,224,229,43,"MULTIPOLYGON(((12.284622955520346 64.58510724073307,12.280146957272512 64.62992312773416,12.384622099246403 64.63180991688286,12.388926651516492 64.58699023917397,12.284622955520346 64.58510724073307)))"
23800007165000,21,11,10,49.5,"MULTIPOLYGON(((12.493246075426864 64.58879956274625,12.48911305220168 64.63362288334226,12.593619188329965 64.63536200686168,12.597580602725133 64.59053519129913,12.493246075426864 64.58879956274625)))"
23850007165000,7,2,5,53.3,"MULTIPOLYGON(((12.597580602725133 64.59053519129913,12.593619188329965 64.63536200686168,12.698139879257733 64.63702726801004,12.701929608324793 64.59219710549726,12.597580602725133 64.59053519129913)))"
24050007165000,6,4,2,61.2,"MULTIPOLYGON(((13.015057236146594 64.59674038086166,13.01178298911227 64.64157969522891,13.11635560501143 64.64294932900268,13.119457893687345 64.59810726062848,13.015057236146594 64.59674038086166)))"
24100007165000,2,0,2,0,"MULTIPOLYGON(((13.119457893687345 64.59810726062848,13.11635560501143 64.64294932900268,13.220939626177456 64.64424501557235,13.223869896499124 64.59940034162625,13.119457893687345 64.59810726062848)))"
24300007165000,12,6,6,37.3,"MULTIPOLYGON(((13.537167694950922 64.60283665185857,13.534753806524906 64.64768825121443,13.639377132089937 64.6486880122522,13.641618795337296 64.60383440173995,13.537167694950922 64.60283665185857)))"
24350007165000,26,12,14,57.6,"MULTIPOLYGON(((13.641618795337296 64.60383440173995,13.639377132089937 64.6486880122522,13.744008702753193 64.649613761857,13.74607809742163 64.60475828894072,13.641618795337296 64.60383440173995)))"
23000007170000,2,1,1,0,"MULTIPOLYGON(((10.819505153551814 64.59576997972964,10.812614313248188 64.64051667503064,10.916973110947808 64.64344026562227,10.92369339298646 64.5986877036446,10.819505153551814 64.59576997972964)))"
23100007170000,43,22,21,47.2,"MULTIPOLYGON(((11.027906160555313 64.6015319738583,11.02135656607158 64.64629025603482,11.125764057906293 64.64906661449936,11.132142838759302 64.60430275875808,11.027906160555313 64.6015319738583)))"
23150007170000,61,33,28,43.2,"MULTIPOLYGON(((11.132142838759302 64.60430275875808,11.125764057906293 64.64906661449936,11.230194964848197 64.65176931005463,11.236402809216607 64.60700002753482,11.132142838759302 64.60430275875808)))"
23200007170000,188,91,97,41.6,"MULTIPOLYGON(((11.236402809216607 64.60700002753482,11.230194964848197 64.65176931005463,11.334648664425439 64.65439831254803,11.340685452684857 64.60962375018443,11.236402809216607 64.60700002753482)))"
23250007170000,58,31,27,55.7,"MULTIPOLYGON(((11.340685452684857 64.60962375018443,11.334648664425439 64.65439831254803,11.439124533320529 64.65695359263731,11.444990149083468 64.61217389750904,11.340685452684857 64.60962375018443)))"
23700007170000,223,109,114,44.3,"MULTIPOLYGON(((12.280146957272512 64.62992312773416,12.275654520721252 64.67473857410387,12.380301735896882 64.67662916645904,12.384622099246403 64.63180991688286,12.280146957272512 64.62992312773416)))"
23850007170000,8,5,3,71,"MULTIPOLYGON(((12.593619188329965 64.63536200686168,12.589643219044978 64.68018841783511,12.694336224220223 64.68185703697718,12.698139879257733 64.63702726801004,12.593619188329965 64.63536200686168)))"
23950007170000,5,1,4,62.6,"MULTIPOLYGON(((12.802674496069486 64.63861864817663,12.799043229004573 64.68345162654296,12.903763600644188 64.68497216865461,12.907222409330936 64.64013612957206,12.802674496069486 64.63861864817663)))"
24000007170000,7,5,2,39.4,"MULTIPOLYGON(((12.907222409330936 64.64013612957206,12.903763600644188 64.68497216865461,13.008496705885303 64.68641864626046,13.01178298911227 64.64157969522891,12.907222409330936 64.64013612957206)))"
24050007170000,12,7,5,53.6,"MULTIPOLYGON(((13.01178298911227 64.64157969522891,13.008496705885303 64.68641864626046,13.113241910997724 64.68779104313572,13.11635560501143 64.64294932900268,13.01178298911227 64.64157969522891)))"
24100007170000,27,11,16,51.9,"MULTIPOLYGON(((13.11635560501143 64.64294932900268,13.113241910997724 64.68779104313572,13.21799858179838 64.68908934388321,13.220939626177456 64.64424501557235,13.11635560501143 64.64294932900268)))"
24250007170000,10,6,4,50.1,"MULTIPOLYGON(((13.430139358802094 64.64661448993735,13.42754378160925 64.69146359954851,13.532331040201399 64.69253952781624,13.534753806524906 64.64768825121443,13.430139358802094 64.64661448993735)))"
24300007170000,1,1,0,0,"MULTIPOLYGON(((13.534753806524906 64.64768825121443,13.532331040201399 64.69253952781624,13.637127223693007 64.69354130665715,13.639377132089937 64.6486880122522,13.534753806524906 64.64768825121443)))"
24350007170000,20,10,10,41.6,"MULTIPOLYGON(((13.639377132089937 64.6486880122522,13.637127223693007 64.69354130665715,13.741931695991173 64.6944689248219,13.744008702753193 64.649613761857,13.639377132089937 64.6486880122522)))"
23150007175000,45,26,19,35.3,"MULTIPOLYGON(((11.125764057906293 64.64906661449936,11.119361861801401 64.69382985894687,11.22396432770352 64.69653799914852,11.230194964848197 64.65176931005463,11.125764057906293 64.64906661449936)))"
23200007175000,122,60,62,56.6,"MULTIPOLYGON(((11.230194964848197 64.65176931005463,11.22396432770352 64.69653799914852,11.328589706710988 64.69917229887614,11.334648664425439 64.65439831254803,11.230194964848197 64.65176931005463)))"
23250007175000,9,3,6,52.3,"MULTIPOLYGON(((11.334648664425439 64.65439831254803,11.328589706710988 64.69917229887614,11.43323737224686 64.70173272864203,11.439124533320529 64.65695359263731,11.334648664425439 64.65439831254803)))"
23300007175000,50,30,20,49.4,"MULTIPOLYGON(((11.439124533320529 64.65695359263731,11.43323737224686 64.70173272864203,11.53790669690388 64.70421925977392,11.543621947392953 64.65943512179167,11.439124533320529 64.65695359263731)))"
23700007175000,47,26,21,46.7,"MULTIPOLYGON(((12.275654520721252 64.67473857410387,12.27114555891031 64.71955357930965,12.375965477811661 64.7214479874366,12.380301735896882 64.67662916645904,12.275654520721252 64.67473857410387)))"
23900007175000,44,20,24,47.7,"MULTIPOLYGON(((12.694336224220223 64.68185703697718,12.690518569486375 64.72668641211713,12.795398595001073 64.72828422169555,12.799043229004573 64.68345162654296,12.694336224220223 64.68185703697718)))"
23950007175000,8,4,4,60.5,"MULTIPOLYGON(((12.799043229004573 64.68345162654296,12.795398595001073 64.72828422169555,12.900292058276538 64.72980783464735,12.903763600644188 64.68497216865461,12.799043229004573 64.68345162654296)))"
24150007175000,1,1,0,0,"MULTIPOLYGON(((13.21799858179838 64.68908934388321,13.215046706275826 64.73393332653293,13.31998754989443 64.73515998992602,13.322766083674898 64.69031353393409,13.21799858179838 64.68908934388321)))"
24200007175000,1,1,0,0,"MULTIPOLYGON(((13.322766083674898 64.69031353393409,13.31998754989443 64.73515998992602,13.424938643698894 64.73631237932668,13.42754378160925 64.69146359954851,13.322766083674898 64.69031353393409)))"
24250007175000,4,2,2,0,"MULTIPOLYGON(((13.42754378160925 64.69146359954851,13.424938643698894 64.73631237932668,13.52989934892267 64.73739048176031,13.532331040201399 64.69253952781624,13.42754378160925 64.69146359954851)))"
24300007175000,2,1,1,0,"MULTIPOLYGON(((13.532331040201399 64.69253952781624,13.52989934892267 64.73739048176031,13.63486902643772 64.73839428508664,13.637127223693007 64.69354130665715,13.532331040201399 64.69253952781624)))"
24350007175000,3,1,2,0,"MULTIPOLYGON(((13.637127223693007 64.69354130665715,13.63486902643772 64.73839428508664,13.739847036778462 64.73932377800024,13.741931695991173 64.6944689248219,13.637127223693007 64.69354130665715)))"
24400007175000,5,3,2,41.6,"MULTIPOLYGON(((13.741931695991173 64.6944689248219,13.739847036778462 64.73932377800024,13.84483274016576 64.74017895003104,13.846743820692197 64.69532237189246,13.741931695991173 64.6944689248219)))"
23150007180000,139,74,65,45.2,"MULTIPOLYGON(((11.119361861801401 64.69382985894687,11.112936126721335 64.73859249065659,11.21771077731131 64.74130609346753,11.22396432770352 64.69653799914852,11.119361861801401 64.69382985894687)))"
23250007180000,3,1,2,0,"MULTIPOLYGON(((11.328589706710988 64.69917229887614,11.322508462329745 64.74394570791229,11.427328551917459 64.74651130435667,11.43323737224686 64.70173272864203,11.328589706710988 64.69917229887614)))"
23300007180000,35,18,17,53.8,"MULTIPOLYGON(((11.43323737224686 64.70173272864203,11.427328551917459 64.74651130435667,11.532170415377614 64.74900285398603,11.53790669690388 64.70421925977392,11.43323737224686 64.70173272864203)))"
23350007180000,4,2,2,0,"MULTIPOLYGON(((11.53790669690388 64.70421925977392,11.532170415377614 64.74900285398603,11.637033421198765 64.75142032880649,11.642597052467332 64.70663186441641,11.53790669690388 64.70421925977392)))"
23500007180000,1,1,0,0,"MULTIPOLYGON(((11.852038339554953 64.7112351869026,11.84682032994401 64.75603294615652,11.951742965980626 64.75822803681342,11.956788010819045 64.71342585313037,11.852038339554953 64.7112351869026)))"
23700007180000,97,45,52,38.9,"MULTIPOLYGON(((12.27114555891031 64.71955357930965,12.266619984266724 64.76436814281348,12.371613240741008 64.76626637934453,12.375965477811661 64.7214479874366,12.27114555891031 64.71955357930965)))"
23900007180000,4,2,2,0,"MULTIPOLYGON(((12.690518569486375 64.72668641211713,12.6866868408069 64.77151539314458,12.791740523152747 64.77311643340579,12.795398595001073 64.72828422169555,12.690518569486375 64.72668641211713)))"
23950007180000,114,57,57,48,"MULTIPOLYGON(((12.795398595001073 64.72828422169555,12.791740523152747 64.77311643340579,12.896807714669226 64.77464312737574,12.900292058276538 64.72980783464735,12.795398595001073 64.72828422169555)))"
24200007180000,10,5,5,35.6,"MULTIPOLYGON(((13.31998754989443 64.73515998992602,13.317198765863862 64.78000610843274,13.42232389430898 64.78116082932863,13.424938643698894 64.73631237932668,13.31998754989443 64.73515998992602)))"
24250007180000,11,5,6,40.7,"MULTIPOLYGON(((13.424938643698894 64.73631237932668,13.42232389430898 64.78116082932863,13.527458685296411 64.78224111314191,13.52989934892267 64.73739048176031,13.424938643698894 64.73631237932668)))"
24350007180000,5,3,2,55.8,"MULTIPOLYGON(((13.63486902643772 64.73839428508664,13.632602496304473 64.7832469476717,13.737754684470936 64.78417832155607,13.739847036778462 64.73932377800024,13.63486902643772 64.73839428508664)))"
22950007185000,1,0,1,0,"MULTIPOLYGON(((10.694080435227422 64.72699881704041,10.686941069482804 64.77173743122741,10.791789593381257 64.77475274743125,10.79875666706723 64.73000806063224,10.694080435227422 64.72699881704041)))"
23200007185000,81,47,34,46.2,"MULTIPOLYGON(((11.21771077731131 64.74130609346753,11.211434192347205 64.78607359165119,11.316404813239611 64.78871853838905,11.322508462329745 64.74394570791229,11.21771077731131 64.74130609346753)))"
23250007185000,133,72,61,31.3,"MULTIPOLYGON(((11.322508462329745 64.74394570791229,11.316404813239611 64.78871853838905,11.421397957579844 64.79128931860446,11.427328551917459 64.74651130435667,11.322508462329745 64.74394570791229)))"
23300007185000,5,2,3,30,"MULTIPOLYGON(((11.427328551917459 64.74651130435667,11.421397957579844 64.79128931860446,11.526412991358441 64.79378590333927,11.532170415377614 64.74900285398603,11.427328551917459 64.74651130435667)))"
23350007185000,35,20,15,57,"MULTIPOLYGON(((11.532170415377614 64.74900285398603,11.526412991358441 64.79378590333927,11.631449279744096 64.79620826446022,11.637033421198765 64.75142032880649,11.532170415377614 64.74900285398603)))"
23400007185000,4,2,2,0,"MULTIPOLYGON(((11.637033421198765 64.75142032880649,11.631449279744096 64.79620826446022,11.736506187106993 64.79855637466011,11.741916937077974 64.75376370164618,11.637033421198765 64.75142032880649)))"
23450007185000,20,10,10,62.7,"MULTIPOLYGON(((11.741916937077974 64.75376370164618,11.736506187106993 64.79855637466011,11.841583077042209 64.80083020745913,11.84682032994401 64.75603294615652,11.741916937077974 64.75376370164618)))"
23500007185000,55,38,17,53,"MULTIPOLYGON(((11.84682032994401 64.75603294615652,11.841583077042209 64.80083020745913,11.946679312393181 64.80302973720586,11.951742965980626 64.75822803681342,11.84682032994401 64.75603294615652)))"
23700007185000,20,11,9,45.4,"MULTIPOLYGON(((12.266619984266724 64.76436814281348,12.262077708595374 64.8091822640715,12.367244939836485 64.81108434170649,12.371613240741008 64.76626637934453,12.266619984266724 64.76436814281348)))"
23900007185000,2,1,1,0,"MULTIPOLYGON(((12.6866868408069 64.77151539314458,12.682840963404484 64.81634397977018,12.788068942048978 64.81794826144147,12.791740523152747 64.77311643340579,12.6866868408069 64.77151539314458)))"
23950007185000,1,1,0,0,"MULTIPOLYGON(((12.791740523152747 64.77311643340579,12.788068942048978 64.81794826144147,12.893310501782834 64.8194780466621,12.896807714669226 64.77464312737574,12.791740523152747 64.77311643340579)))"
24000007185000,3,2,1,0,"MULTIPOLYGON(((12.896807714669226 64.77464312737574,12.893310501782834 64.8194780466621,12.998564999238601 64.82093331812389,13.001887775383967 64.77609545783238,12.896807714669226 64.77464312737574)))"
24200007185000,12,6,6,52.6,"MULTIPOLYGON(((13.317198765863862 64.78000610843274,13.314399677069199 64.82485188946823,13.419699482315965 64.82600894960963,13.42232389430898 64.78116082932863,13.317198765863862 64.78000610843274)))"
24300007185000,8,5,3,54.5,"MULTIPOLYGON(((13.527458685296411 64.78224111314191,13.525009001592762 64.82709142205496,13.630327588960101 64.82809929454227,13.632602496304473 64.7832469476717,13.527458685296411 64.78224111314191)))"
24350007185000,33,16,17,43.1,"MULTIPOLYGON(((13.632602496304473 64.7832469476717,13.630327588960101 64.82809929454227,13.73565459813491 64.82903255565277,13.737754684470936 64.78417832155607,13.632602496304473 64.7832469476717)))"
23200007190000,95,50,45,38.5,"MULTIPOLYGON(((11.211434192347205 64.78607359165119,11.205134450626176 64.83084049232764,11.310278640560798 64.83349078902837,11.316404813239611 64.78871853838905,11.211434192347205 64.78607359165119)))"
23250007190000,314,168,146,37.7,"MULTIPOLYGON(((11.316404813239611 64.78871853838905,11.310278640560798 64.83349078902837,11.415445473666894 64.83606677019849,11.421397957579844 64.79128931860446,11.316404813239611 64.78871853838905)))"
23300007190000,244,119,125,40.6,"MULTIPOLYGON(((11.421397957579844 64.79128931860446,11.415445473666894 64.83606677019849,11.52063431259912 64.8385684067354,11.526412991358441 64.79378590333927,11.421397957579844 64.79128931860446)))"
23350007190000,123,65,58,41.5,"MULTIPOLYGON(((11.526412991358441 64.79378590333927,11.52063431259912 64.8385684067354,11.625844519182992 64.84099567036552,11.631449279744096 64.79620826446022,11.526412991358441 64.79378590333927)))"
23400007190000,19,11,8,34.6,"MULTIPOLYGON(((11.631449279744096 64.79620826446022,11.625844519182992 64.84099567036552,11.731075454438416 64.84334853364535,11.736506187106993 64.79855637466011,11.631449279744096 64.79620826446022)))"
23450007190000,43,26,17,60.9,"MULTIPOLYGON(((11.736506187106993 64.79855637466011,11.731075454438416 64.84334853364535,11.836326478603297 64.84562696996282,11.841583077042209 64.80083020745913,11.736506187106993 64.79855637466011)))"
23500007190000,21,12,9,70.4,"MULTIPOLYGON(((11.841583077042209 64.80083020745913,11.836326478603297 64.84562696996282,11.941596951157218 64.84783095353853,11.946679312393181 64.80302973720586,11.841583077042209 64.80083020745913)))"
23750007190000,26,11,15,38.8,"MULTIPOLYGON(((12.367244939836485 64.81108434170649,12.362860489645609 64.85590187404105,12.468218571463542 64.85773323643802,12.472428320262377 64.81291200049999,12.367244939836485 64.81108434170649)))"
24050007190000,149,71,78,40,"MULTIPOLYGON(((12.998564999238601 64.82093331812389,12.99522992915051 64.86577081458194,13.100671866662587 64.86715435578455,13.10383179055958 64.82231405935796,12.998564999238601 64.82093331812389)))"
24100007190000,2,1,1,0,"MULTIPOLYGON(((13.10383179055958 64.82231405935796,13.100671866662587 64.86715435578455,13.206125515879714 64.86846320022623,13.209110231423992 64.82362025473545,13.10383179055958 64.82231405935796)))"
24200007190000,10,6,4,54.9,"MULTIPOLYGON(((13.314399677069199 64.82485188946823,13.311590228607589 64.86969733304478,13.417065356231591 64.8708567402236,13.419699482315965 64.82600894960963,13.314399677069199 64.82485188946823)))"
24250007190000,2,1,1,0,"MULTIPOLYGON(((13.419699482315965 64.82600894960963,13.417065356231591 64.8708567402236,13.522550249741306 64.8719414085923,13.525009001592762 64.82709142205496,13.419699482315965 64.82600894960963)))"
24300007190000,8,4,4,54.1,"MULTIPOLYGON(((13.525009001592762 64.82709142205496,13.522550249741306 64.8719414085923,13.628044259755065 64.87295132582747,13.630327588960101 64.82809929454227,13.525009001592762 64.82709142205496)))"
23000007195000,13,10,3,45.6,"MULTIPOLYGON(((10.784796839178544 64.8194967612042,10.777778268171215 64.86424010016455,10.882999219163628 64.86719331561082,10.88984410037566 64.82244401247183,10.784796839178544 64.8194967612042)))"
23100007195000,10,6,4,43.4,"MULTIPOLYGON(((10.994916545366436 64.82531707288068,10.988245487885392 64.87007219132387,11.093516437213658 64.8728766947376,11.10001354035579 64.82811591002631,10.994916545366436 64.82531707288068)))"
23150007195000,161,96,65,38.6,"MULTIPOLYGON(((11.10001354035579 64.82811591002631,11.093516437213658 64.8728766947376,11.198811429094913 64.87560679411328,11.205134450626176 64.83084049232764,11.10001354035579 64.82811591002631)))"
23200007195000,4065,2105,1960,39.8,"MULTIPOLYGON(((11.205134450626176 64.83084049232764,11.198811429094913 64.87560679411328,11.304129824568404 64.87826245854112,11.310278640560798 64.83349078902837,11.205134450626176 64.83084049232764)))"
23250007195000,170,93,77,37.5,"MULTIPOLYGON(((11.310278640560798 64.83349078902837,11.304129824568404 64.87826245854112,11.40947098378962 64.88084365794148,11.415445473666894 64.83606677019849,11.310278640560798 64.83349078902837)))"
23300007195000,84,47,37,39.4,"MULTIPOLYGON(((11.415445473666894 64.83606677019849,11.40947098378962 64.88084365794148,11.514834266053887 64.88335036306648,11.52063431259912 64.8385684067354,11.415445473666894 64.83606677019849)))"
23350007195000,1935,973,962,40,"MULTIPOLYGON(((11.52063431259912 64.8385684067354,11.514834266053887 64.88335036306648,11.620219029820003 64.88578254550117,11.625844519182992 64.84099567036552,11.52063431259912 64.8385684067354)))"
23400007195000,52,28,24,50.3,"MULTIPOLYGON(((11.625844519182992 64.84099567036552,11.620219029820003 64.88578254550117,11.725624632733997 64.88814017766478,11.731075454438416 64.84334853364535,11.625844519182992 64.84099567036552)))"
23750007195000,72,40,32,51.4,"MULTIPOLYGON(((12.362860489645609 64.85590187404105,12.358459804106493 64.90071897586137,12.463993231889727 64.90255405420082,12.468218571463542 64.85773323643802,12.362860489645609 64.85590187404105)))"
23800007195000,2,1,1,0,"MULTIPOLYGON(((12.468218571463542 64.85773323643802,12.463993231889727 64.90255405420082,12.56954233360157 64.9043143918002,12.573592243958 64.8594900089647,12.468218571463542 64.85773323643802)))"
23950007195000,9,6,3,49.7,"MULTIPOLYGON(((12.784383779770282 64.86277970556694,12.78068496388378 64.907610765543,12.886277193586038 64.90914676418237,12.889800351092985 64.86431259232562,12.784383779770282 64.86277970556694)))"
24050007195000,27,13,14,46.8,"MULTIPOLYGON(((12.99522992915051 64.86577081458194,12.991882499529662 64.91060794707519,13.097500230986414 64.91199429758706,13.100671866662587 64.86715435578455,12.99522992915051 64.86577081458194)))"
24100007195000,52,31,21,44.8,"MULTIPOLYGON(((13.100671866662587 64.86715435578455,13.097500230986414 64.91199429758706,13.203129736754633 64.91330579993185,13.206125515879714 64.86846320022623,13.100671866662587 64.86715435578455)))"
24250007195000,4,3,1,0,"MULTIPOLYGON(((13.417065356231591 64.8708567402236,13.41442146419963 64.91570420122285,13.520082381328027 64.91679107284551,13.522550249741306 64.8719414085923,13.417065356231591 64.8708567402236)))"
24300007195000,218,107,111,45,"MULTIPOLYGON(((13.522550249741306 64.8719414085923,13.520082381328027 64.91679107284551,13.625752463720632 64.91780304165539,13.628044259755065 64.87295132582747,13.522550249741306 64.8719414085923)))"
24350007195000,17,8,9,66.1,"MULTIPOLYGON(((13.628044259755065 64.87295132582747,13.625752463720632 64.91780304165539,13.731431058179252 64.91874009611882,13.733546736544545 64.87388648045305,13.628044259755065 64.87295132582747)))"
24400007195000,22,10,12,49.7,"MULTIPOLYGON(((13.733546736544545 64.87388648045305,13.731431058179252 64.91874009611882,13.837117511180768 64.91960222555426,13.839057030059388 64.87474686184093,13.733546736544545 64.87388648045305)))"
24450007195000,8,4,4,69.5,"MULTIPOLYGON(((13.839057030059388 64.87474686184093,13.837117511180768 64.91960222555426,13.942811168902029 64.92038942013295,13.94457448995186 64.87553246021149,13.839057030059388 64.87474686184093)))"
24500007195000,3,1,2,0,"MULTIPOLYGON(((13.94457448995186 64.87553246021149,13.942811168902029 64.92038942013295,14.048511377244727 64.92110167087925,14.050098465601518 64.87624326663402,13.94457448995186 64.87553246021149)))"
22950007200000,9,4,5,48.7,"MULTIPOLYGON(((10.672583271077055 64.86121257837709,10.665364558272861 64.90594910753703,10.770733743102781 64.908982762511,10.777778268171215 64.86424010016455,10.672583271077055 64.86121257837709)))"
23000007200000,72,34,38,38.1,"MULTIPOLYGON(((10.777778268171215 64.86424010016455,10.770733743102781 64.908982762511,10.87612902006324 64.91194196194932,10.882999219163628 64.86719331561082,10.777778268171215 64.86424010016455)))"
23050007200000,65,37,28,49.9,"MULTIPOLYGON(((10.882999219163628 64.86719331561082,10.87612902006324 64.91194196194932,10.981549749642738 64.91482667229309,10.988245487885392 64.87007219132387,10.882999219163628 64.86719331561082)))"
23100007200000,26,14,12,36.5,"MULTIPOLYGON(((10.988245487885392 64.87007219132387,10.981549749642738 64.91482667229309,11.08699529136733 64.9176368608134,11.093516437213658 64.8728766947376,10.988245487885392 64.87007219132387)))"
23150007200000,81,42,39,34.2,"MULTIPOLYGON(((11.093516437213658 64.8728766947376,11.08699529136733 64.9176368608134,11.192465003824125 64.9203724956129,11.198811429094913 64.87560679411328,11.093516437213658 64.8728766947376)))"
23200007200000,373,181,192,38.9,"MULTIPOLYGON(((11.198811429094913 64.87560679411328,11.192465003824125 64.9203724956129,11.297958244684919 64.92303354562706,11.304129824568404 64.87826245854112,11.198811429094913 64.87560679411328)))"
23250007200000,127,72,55,39.5,"MULTIPOLYGON(((11.304129824568404 64.87826245854112,11.297958244684919 64.92303354562706,11.40347437072988 64.92561998062584,11.40947098378962 64.88084365794148,11.304129824568404 64.87826245854112)))"
23300007200000,20,10,10,37.7,"MULTIPOLYGON(((11.40947098378962 64.88084365794148,11.40347437072988 64.92561998062584,11.509012737871336 64.92813177121482,11.514834266053887 64.88335036306648,11.40947098378962 64.88084365794148)))"
23350007200000,58,34,24,46.9,"MULTIPOLYGON(((11.514834266053887 64.88335036306648,11.509012737871336 64.92813177121482,11.614572701177645 64.93056888883679,11.620219029820003 64.88578254550117,11.514834266053887 64.88335036306648)))"
23400007200000,25,12,13,36.4,"MULTIPOLYGON(((11.620219029820003 64.88578254550117,11.614572701177645 64.93056888883679,11.72015361489713 64.93293130577277,11.725624632733997 64.88814017766478,11.620219029820003 64.88578254550117)))"
23450007200000,41,19,22,32.7,"MULTIPOLYGON(((11.725624632733997 64.88814017766478,11.72015361489713 64.93293130577277,11.82575483248211 64.93521899514359,11.831050431652915 64.89042323281215,11.725624632733997 64.88814017766478)))"
23500007200000,43,25,18,51.1,"MULTIPOLYGON(((11.831050431652915 64.89042323281215,11.82575483248211 64.93521899514359,11.931375706612995 64.93743193091089,11.936495782668741 64.89263168503486,11.831050431652915 64.89042323281215)))"
23650007200000,16,8,8,37.3,"MULTIPOLYGON(((12.147442561677439 64.89682468126327,12.142673831519643 64.94163344169318,12.248349784014572 64.94362196884651,12.252942698244846 64.89880917764626,12.147442561677439 64.89682468126327)))"
23700007200000,29,13,16,38.6,"MULTIPOLYGON(((12.252942698244846 64.89880917764626,12.248349784014572 64.94362196884651,12.35404279654241 64.9455356466752,12.358459804106493 64.90071897586137,12.252942698244846 64.89880917764626)))"
23750007200000,3,2,1,0,"MULTIPOLYGON(((12.358459804106493 64.90071897586137,12.35404279654241 64.9455356466752,12.459752218287973 64.94737445336249,12.463993231889727 64.90255405420082,12.358459804106493 64.90071897586137)))"
24050007200000,11,5,6,37.9,"MULTIPOLYGON(((12.991882499529662 64.91060794707519,12.988522644316777 64.95544471546945,13.094316820923979 64.95683388468157,13.097500230986414 64.91199429758706,12.991882499529662 64.91060794707519)))"
24100007200000,303,142,161,47.7,"MULTIPOLYGON(((13.097500230986414 64.91199429758706,13.094316820923979 64.95683388468157,13.200122834897845 64.95814805381605,13.203129736754633 64.91330579993185,13.097500230986414 64.91199429758706)))"
24300007200000,2,1,1,0,"MULTIPOLYGON(((13.520082381328027 64.91679107284551,13.517605347592246 64.96164041490489,13.623452155566035 64.96265444215318,13.625752463720632 64.91780304165539,13.520082381328027 64.91679107284551)))"
23000007205000,31,17,14,37.7,"MULTIPOLYGON(((10.770733743102781 64.908982762511,10.76366312573949 64.9537247464277,10.869233368183394 64.95668994977747,10.87612902006324 64.91194196194932,10.770733743102781 64.908982762511)))"
23050007205000,88,42,46,41.4,"MULTIPOLYGON(((10.87612902006324 64.91194196194932,10.869233368183394 64.95668994977747,10.974829199098501 64.95958051418192,10.981549749642738 64.91482667229309,10.87612902006324 64.91194196194932)))"
23100007205000,60,34,26,49.5,"MULTIPOLYGON(((10.981549749642738 64.91482667229309,10.974829199098501 64.95958051418192,11.08044997463624 64.96239640674828,11.08699529136733 64.9176368608134,10.981549749642738 64.91482667229309)))"
23150007205000,67,35,32,43.3,"MULTIPOLYGON(((11.08699529136733 64.9176368608134,11.08044997463624 64.96239640674828,11.186095050000732 64.96513759541935,11.192465003824125 64.9203724956129,11.08699529136733 64.9176368608134)))"
23200007205000,16,11,5,41.2,"MULTIPOLYGON(((11.192465003824125 64.9203724956129,11.186095050000732 64.96513759541935,11.291763779472625 64.96780404897494,11.297958244684919 64.92303354562706,11.192465003824125 64.9203724956129)))"
23250007205000,38,22,16,35,"MULTIPOLYGON(((11.297958244684919 64.92303354562706,11.291763779472625 64.96780404897494,11.397455516432974 64.97039573703339,11.40347437072988 64.92561998062584,11.297958244684919 64.92303354562706)))"
23300007205000,153,77,76,43,"MULTIPOLYGON(((11.40347437072988 64.92561998062584,11.397455516432974 64.97039573703339,11.503169613387257 64.97291263005285,11.509012737871336 64.92813177121482,11.40347437072988 64.92561998062584)))"
23400007205000,50,28,22,46,"MULTIPOLYGON(((11.614572701177645 64.93056888883679,11.608905421989437 64.97535469933277,11.714662293066116 64.9777219170151,11.72015361489713 64.93293130577277,11.614572701177645 64.93056888883679)))"
23450007205000,33,17,16,52.3,"MULTIPOLYGON(((11.72015361489713 64.93293130577277,11.714662293066116 64.9777219170151,11.820439576640776 64.98001425608561,11.82575483248211 64.93521899514359,11.72015361489713 64.93293130577277)))"
23500007205000,16,12,4,55.4,"MULTIPOLYGON(((11.82575483248211 64.93521899514359,11.820439576640776 64.98001425608561,11.926236621958086 64.9822316903752,11.931375706612995 64.93743193091089,11.82575483248211 64.93521899514359)))"
23550007205000,75,38,37,47.5,"MULTIPOLYGON(((11.931375706612995 64.93743193091089,11.926236621958086 64.9822316903752,12.032052777508286 64.98437419456097,12.037015589222444 64.93957008787844,11.931375706612995 64.93743193091089)))"
23600007205000,39,21,18,47.9,"MULTIPOLYGON(((12.037015589222444 64.93957008787844,12.032052777508286 64.98437419456097,12.137887391051645 64.9864417441675,12.142673831519643 64.94163344169318,12.037015589222444 64.93957008787844)))"
23650007205000,182,100,82,46.2,"MULTIPOLYGON(((12.142673831519643 64.94163344169318,12.137887391051645 64.9864417441675,12.243739809642989 64.98843431556791,12.248349784014572 64.94362196884651,12.142673831519643 64.94163344169318)))"
23700007205000,5,3,2,53.2,"MULTIPOLYGON(((12.248349784014572 64.94362196884651,12.243739809642989 64.98843431556791,12.34960937965629 64.990351885985,12.35404279654241 64.9455356466752,12.248349784014572 64.94362196884651)))"
24150007205000,8,6,2,50.4,"MULTIPOLYGON(((13.200122834897845 64.95814805381605,13.19710475073435 65.00298996184034,13.30309917028694 65.00423163911587,13.305940031107104 64.9593872078609,13.200122834897845 64.95814805381605)))"
24300007205000,33,18,15,43.2,"MULTIPOLYGON(((13.517605347592246 64.96164041490489,13.515119099423506 65.00648943485955,13.621143289675567 65.00750552744697,13.623452155566035 64.96265444215318,13.517605347592246 64.96164041490489)))"
23050007210000,20,10,10,50.4,"MULTIPOLYGON(((10.869233368183394 64.95668994977747,10.862312127670513 65.00143727737124,10.968083703773749 65.00433371537062,10.974829199098501 64.95958051418192,10.869233368183394 64.95668994977747)))"
23150007210000,18,10,8,55.4,"MULTIPOLYGON(((11.08044997463624 64.96239640674828,11.073880357924475 65.00715533102412,11.17970144192001 65.0099020921136,11.186095050000732 64.96513759541935,11.08044997463624 64.96239640674828)))"
23400007210000,62,33,29,38.2,"MULTIPOLYGON(((11.608905421989437 64.97535469933277,11.603217080192875 65.02013997594017,11.709150558607318 65.02251201042874,11.714662293066116 64.9777219170151,11.608905421989437 64.97535469933277)))"
23450007210000,100,56,44,48.2,"MULTIPOLYGON(((11.714662293066116 64.9777219170151,11.709150558607318 65.02251201042874,11.815104558931052 65.02480901475853,11.820439576640776 64.98001425608561,11.714662293066116 64.9777219170151)))"
23500007210000,13,8,5,41.3,"MULTIPOLYGON(((11.820439576640776 64.98001425608561,11.815104558931052 65.02480901475853,11.921078426948625 65.02703096262873,11.926236621958086 64.9822316903752,11.820439576640776 64.98001425608561)))"
23650007210000,6,3,3,62,"MULTIPOLYGON(((12.137887391051645 64.9864417441675,12.133083145422187 65.03124958804044,12.239112683740085 65.03324621723736,12.243739809642989 64.98843431556791,12.137887391051645 64.9864417441675)))"
23800007210000,22,10,12,42.7,"MULTIPOLYGON(((12.455495446809326 64.99219443349229,12.451222833003522 65.03701399415439,12.557302127763966 65.03878509865642,12.561397356188404 64.99396193701499,12.455495446809326 64.99219443349229)))"
24150007210000,24,13,11,54.4,"MULTIPOLYGON(((13.19710475073435 65.00298996184034,13.194075424261253 65.04783152396412,13.30024772623012 65.04907573294264,13.30309917028694 65.00423163911587,13.19710475073435 65.00298996184034)))"
23350007215000,40,24,16,53.7,"MULTIPOLYGON(((11.49730477711739 65.01769293844299,11.491418112750083 65.06247269523769,11.5975075629223 65.06492471760065,11.603217080192875 65.02013997594017,11.49730477711739 65.01769293844299)))"
23400007215000,96,53,43,45.4,"MULTIPOLYGON(((11.603217080192875 65.02013997594017,11.5975075629223 65.06492471760065,11.703618302108259 65.06730158504192,11.709150558607318 65.02251201042874,11.603217080192875 65.02013997594017)))"
23450007215000,1,1,0,0,"MULTIPOLYGON(((11.709150558607318 65.02251201042874,11.703618302108259 65.06730158504192,11.809749673400624 65.06960327027448,11.815104558931052 65.02480901475853,11.709150558607318 65.02251201042874)))"
23500007215000,26,13,13,51.2,"MULTIPOLYGON(((11.815104558931052 65.02480901475853,11.809749673400624 65.06960327027448,11.915901019099215 65.07182974686485,11.921078426948625 65.02703096262873,11.815104558931052 65.02480901475853)))"
23550007215000,16,9,7,59.4,"MULTIPOLYGON(((11.921078426948625 65.02703096262873,11.915901019099215 65.07182974686485,12.022071680735829 65.07398098923424,12.02707150768339 65.02917782858894,11.921078426948625 65.02703096262873)))"
23600007215000,5,2,3,50.8,"MULTIPOLYGON(((12.02707150768339 65.02917782858894,12.022071680735829 65.07398098923424,12.128260999099133 65.07605697265984,12.133083145422187 65.03124958804044,12.02707150768339 65.02917782858894)))"
23650007215000,29,17,12,52.2,"MULTIPOLYGON(((12.133083145422187 65.03124958804044,12.128260999099133 65.07605697265984,12.234468314259622 65.07805767327585,12.239112683740085 65.03324621723736,12.133083145422187 65.03124958804044)))"
23700007215000,3,2,1,0,"MULTIPOLYGON(((12.239112683740085 65.03324621723736,12.234468314259622 65.07805767327585,12.340692965594661 65.0799830680747,12.345159465525189 65.0351676932877,12.239112683740085 65.03324621723736)))"
23750007215000,12,7,5,43.3,"MULTIPOLYGON(((12.345159465525189 65.0351676932877,12.340692965594661 65.0799830680747,12.446934291813577 65.08183313490801,12.451222833003522 65.03701399415439,12.345159465525189 65.0351676932877)))"
23800007215000,55,27,28,58.2,"MULTIPOLYGON(((12.451222833003522 65.03701399415439,12.446934291813577 65.08183313490801,12.553191630982823 65.08360785248775,12.557302127763966 65.03878509865642,12.451222833003522 65.03701399415439)))"
24150007215000,2,1,1,0,"MULTIPOLYGON(((13.194075424261253 65.04783152396412,13.191034795043919 65.09267274014454,13.297385642036826 65.09391948934422,13.30024772623012 65.04907573294264,13.194075424261253 65.04783152396412)))"
24200007215000,22,10,12,59,"MULTIPOLYGON(((13.30024772623012 65.04907573294264,13.297385642036826 65.09391948934422,13.40374718640726 65.09509075006615,13.406430668267095 65.05024460703292,13.30024772623012 65.04907573294264)))"
23350007220000,37,22,15,37.5,"MULTIPOLYGON(((11.491418112750083 65.06247269523769,11.485509503138903 65.10725189927912,11.591776756501714 65.10970892324625,11.5975075629223 65.06492471760065,11.491418112750083 65.06247269523769)))"
23400007220000,101,47,54,44.6,"MULTIPOLYGON(((11.5975075629223 65.06492471760065,11.591776756501714 65.10970892324625,11.698065413370653 65.1120906398739,11.703618302108259 65.06730158504192,11.5975075629223 65.06492471760065)))"
23450007220000,247,107,140,46,"MULTIPOLYGON(((11.703618302108259 65.06730158504192,11.698065413370653 65.1120906398739,11.804374813335965 65.1143970217372,11.809749673400624 65.06960327027448,11.703618302108259 65.06730158504192)))"
23500007220000,50,24,26,61.8,"MULTIPOLYGON(((11.809749673400624 65.06960327027448,11.804374813335965 65.1143970217372,11.91070429518793 65.11662804226913,11.915901019099215 65.07182974686485,11.809749673400624 65.06960327027448)))"
23550007220000,126,63,63,47.7,"MULTIPOLYGON(((11.915901019099215 65.07182974686485,11.91070429518793 65.11662804226913,12.01705319694189 65.11878367576158,12.022071680735829 65.07398098923424,11.915901019099215 65.07182974686485)))"
23600007220000,36,21,15,43.9,"MULTIPOLYGON(((12.022071680735829 65.07398098923424,12.01705319694189 65.11878367576158,12.12342085586337 65.12086389736676,12.128260999099133 65.07605697265984,12.022071680735829 65.07398098923424)))"
23650007220000,7,5,2,26.7,"MULTIPOLYGON(((12.128260999099133 65.07605697265984,12.12342085586337 65.12086389736676,12.229806608493272 65.12286868309816,12.234468314259622 65.07805767327585,12.128260999099133 65.07605697265984)))"
23700007220000,45,28,17,33.6,"MULTIPOLYGON(((12.234468314259622 65.07805767327585,12.229806608493272 65.12286868309816,12.336209790673111 65.12479800983176,12.340692965594661 65.0799830680747,12.234468314259622 65.07805767327585)))"
23750007220000,529,251,278,46.8,"MULTIPOLYGON(((12.340692965594661 65.0799830680747,12.336209790673111 65.12479800983176,12.442629737570357 65.12665185530713,12.446934291813577 65.08183313490801,12.340692965594661 65.0799830680747)))"
23800007220000,91,51,40,38.1,"MULTIPOLYGON(((12.446934291813577 65.08183313490801,12.442629737570357 65.12665185530713,12.549065783703812 65.12843019812844,12.553191630982823 65.08360785248775,12.446934291813577 65.08183313490801)))"
24200007220000,5,4,1,58.8,"MULTIPOLYGON(((13.297385642036826 65.09391948934422,13.294512860397015 65.13876290832168,13.401053673682801 65.13993656372315,13.40374718640726 65.09509075006615,13.297385642036826 65.09391948934422)))"
23500007225000,8,4,4,58,"MULTIPOLYGON(((11.804374813335965 65.1143970217372,11.798979871255499 65.15919026824213,11.905488151249672 65.1614258480194,11.91070429518793 65.11662804226913,11.804374813335965 65.1143970217372)))"
23550007225000,5,2,3,35.2,"MULTIPOLYGON(((11.91070429518793 65.11662804226913,11.905488151249672 65.1614258480194,12.012015955859646 65.16358588742851,12.01705319694189 65.11878367576158,11.91070429518793 65.11662804226913)))"
23600007225000,33,20,13,39,"MULTIPOLYGON(((12.01705319694189 65.11878367576158,12.012015955859646 65.16358588742851,12.118562618802622 65.16567036149573,12.12342085586337 65.12086389736676,12.01705319694189 65.11878367576158)))"
23650007225000,122,68,54,54.5,"MULTIPOLYGON(((12.12342085586337 65.12086389736676,12.118562618802622 65.16567036149573,12.225127473064637 65.16767924611298,12.229806608493272 65.12286868309816,12.12342085586337 65.12086389736676)))"
23700007225000,150,78,72,48.7,"MULTIPOLYGON(((12.229806608493272 65.12286868309816,12.225127473064637 65.16767924611298,12.331709850926046 65.16961251803909,12.336209790673111 65.12479800983176,12.229806608493272 65.12286868309816)))"
24200007225000,42,18,24,57.2,"MULTIPOLYGON(((13.294512860397015 65.13876290832168,13.291629323586736 65.18360598987427,13.398350075959355 65.18478204804696,13.401053673682801 65.13993656372315,13.294512860397015 65.13876290832168)))"
24250007225000,4,2,2,0,"MULTIPOLYGON(((13.401053673682801 65.13993656372315,13.398350075959355 65.18478204804696,13.505080967791185 65.18588229536725,13.507604571902284 65.14103456296657,13.401053673682801 65.13993656372315)))"
23600007230000,2,1,1,0,"MULTIPOLYGON(((12.012015955859646 65.16358588742851,12.006959856322542 65.20838762348517,12.11368619030522 65.21047636437439,12.118562618802622 65.16567036149573,12.012015955859646 65.16358588742851)))"
23650007230000,63,39,24,44.4,"MULTIPOLYGON(((12.118562618802622 65.16567036149573,12.11368619030522 65.21047636437439,12.220430813923254 65.2124893617228,12.225127473064637 65.16767924611298,12.118562618802622 65.16567036149573)))"
23700007230000,43,26,17,56.9,"MULTIPOLYGON(((12.225127473064637 65.16767924611298,12.220430813923254 65.2124893617228,12.327193055870278 65.21442659217115,12.331709850926046 65.16961251803909,12.225127473064637 65.16767924611298)))"
23750007230000,1,1,0,0,"MULTIPOLYGON(((12.331709850926046 65.16961251803909,12.327193055870278 65.21442659217115,12.433972244153647 65.21628803323242,12.438309083987061 65.1714701549007,12.331709850926046 65.16961251803909)))"
23550007235000,2,1,1,0,"MULTIPOLYGON(((11.90025248256952 65.20622316328561,11.894997183675944 65.25101998722972,12.001884796432815 65.25318888317439,12.006959856322542 65.20838762348517,11.90025248256952 65.20622316328561)))"
23600007235000,82,42,40,53.6,"MULTIPOLYGON(((12.006959856322542 65.20838762348517,12.001884796432815 65.25318888317439,12.108791472053783 65.25528190532367,12.11368619030522 65.21047636437439,12.006959856322542 65.20838762348517)))"
23650007235000,30,16,14,51.1,"MULTIPOLYGON(((12.11368619030522 65.21047636437439,12.108791472053783 65.25528190532367,12.215716536338496 65.2572990293238,12.220430813923254 65.2124893617228,12.11368619030522 65.21047636437439)))"
23700007235000,7,4,3,61.7,"MULTIPOLYGON(((12.220430813923254 65.2124893617228,12.215716536338496 65.2572990293238,12.322659314368094 65.25924023169664,12.327193055870278 65.21442659217115,12.220430813923254 65.2124893617228)))"
23750007235000,3,2,1,0,"MULTIPOLYGON(((12.327193055870278 65.21442659217115,12.322659314368094 65.25924023169664,12.429619130531222 65.2611054898407,12.433972244153647 65.21628803323242,12.327193055870278 65.21442659217115)))"
23850007235000,2,2,0,0,"MULTIPOLYGON(((12.540767706120276 65.21807366329293,12.536595308550098 65.26289478203222,12.643587171506663 65.26460808742628,12.647578768482546 65.21978346161337,12.540767706120276 65.21807366329293)))"
23900007235000,3,2,1,0,"MULTIPOLYGON(((12.647578768482546 65.21978346161337,12.643587171506663 65.26460808742628,12.750594041868785 65.26624538605769,12.75440475734429 65.22141740832977,12.647578768482546 65.21978346161337)))"
23950007235000,7,4,3,67.9,"MULTIPOLYGON(((12.75440475734429 65.22141740832977,12.750594041868785 65.26624538605769,12.857615241516518 65.2678066588419,12.861244998226795 65.2229754844544,12.75440475734429 65.22141740832977)))"
24250007235000,7,4,3,44,"MULTIPOLYGON(((13.39563633871081 65.22962720307876,13.392912407015764 65.27447202885816,13.500005312264323 65.27557679521313,13.50254789833726 65.23072970608906,13.39563633871081 65.22962720307876)))"
23650007240000,214,108,106,42.6,"MULTIPOLYGON(((12.108791472053783 65.25528190532367,12.103878365018845 65.30008698365758,12.210984544893432 65.30210824830584,12.215716536338496 65.2572990293238,12.108791472053783 65.25528190532367)))"
23700007240000,30,17,13,46.7,"MULTIPOLYGON(((12.215716536338496 65.2572990293238,12.210984544893432 65.30210824830584,12.318108534621308 65.30405343607848,12.322659314368094 65.25924023169664,12.215716536338496 65.2572990293238)))"
23750007240000,5,3,2,71.2,"MULTIPOLYGON(((12.322659314368094 65.25924023169664,12.318108534621308 65.30405343607848,12.425249654946331 65.3059225242587,12.429619130531222 65.2611054898407,12.322659314368094 65.25924023169664)))"
23800007240000,2,1,1,0,"MULTIPOLYGON(((12.429619130531222 65.2611054898407,12.425249654946331 65.3059225242587,12.532407225939881 65.30771549101193,12.536595308550098 65.26289478203222,12.429619130531222 65.2611054898407)))"
23900007240000,30,13,17,56.3,"MULTIPOLYGON(((12.643587171506663 65.26460808742628,12.639580567027254 65.30943231538684,12.746768997014087 65.3110729773163,12.750594041868785 65.26624538605769,12.643587171506663 65.26460808742628)))"
24300007240000,9,4,5,30,"MULTIPOLYGON(((13.500005312264323 65.27557679521313,13.49745315792373 65.32042356281927,13.604737710522459 65.32145430917049,13.607107785717897 65.27660542685983,13.500005312264323 65.27557679521313)))"
24700007240000,1,1,0,0,"MULTIPOLYGON(((14.357035691887539 65.28167317959385,14.355941316067641 65.32653248282264,14.463278123705665 65.32695254122667,14.464190137685582 65.28209237581656,14.357035691887539 65.28167317959385)))"
23650007245000,576,271,305,45.2,"MULTIPOLYGON(((12.103878365018845 65.30008698365758,12.098946769452413 65.34489159868318,12.206234743478612 65.34691701805235,12.210984544893432 65.30210824830584,12.103878365018845 65.30008698365758)))"
23700007245000,113,59,54,45.6,"MULTIPOLYGON(((12.210984544893432 65.30210824830584,12.206234743478612 65.34691701805235,12.313540624165299 65.34886620477366,12.318108534621308 65.30405343607848,12.210984544893432 65.30210824830584)))"
23750007245000,19,14,5,40.4,"MULTIPOLYGON(((12.318108534621308 65.30405343607848,12.313540624165299 65.34886620477366,12.420863728585227 65.35073913601418,12.425249654946331 65.3059225242587,12.318108534621308 65.30405343607848)))"
23800007245000,20,11,9,39.9,"MULTIPOLYGON(((12.425249654946331 65.3059225242587,12.420863728585227 65.35073913601418,12.528203373132568 65.35253578982773,12.532407225939881 65.30771549101193,12.425249654946331 65.3059225242587)))"
23850007245000,2,2,0,0,"MULTIPOLYGON(((12.532407225939881 65.30771549101193,12.528203373132568 65.35253578982773,12.635558873549522 65.3542561451558,12.639580567027254 65.30943231538684,12.532407225939881 65.30771549101193)))"
23900007245000,98,44,54,39.4,"MULTIPOLYGON(((12.639580567027254 65.30943231538684,12.635558873549522 65.3542561451558,12.742929544953004 65.35590018182863,12.746768997014087 65.3110729773163,12.639580567027254 65.30943231538684)))"
24000007245000,11,8,3,56.6,"MULTIPOLYGON(((12.853971834112873 65.31263745761837,12.850314701861375 65.3574678805661,12.957713658221259 65.35895922297874,12.961188395969511 65.31412573799716,12.853971834112873 65.31263745761837)))"
24050007245000,5,3,2,60,"MULTIPOLYGON(((12.961188395969511 65.31412573799716,12.957713658221259 65.35895922297874,13.065125727434378 65.36037419156854,13.06841799968993 65.31553780104382,12.961188395969511 65.31412573799716)))"
24200007245000,2,1,1,0,"MULTIPOLYGON(((13.282913598606013 65.31813320994472,13.279986455464295 65.36297494174978,13.387433738602542 65.36416069280985,13.390178225553935 65.31931652542313,13.282913598606013 65.31813320994472)))"
24300007245000,3,1,2,0,"MULTIPOLYGON(((13.49745315792373 65.32042356281927,13.494891383290991 65.36527000898576,13.602358700611555 65.3663028772485,13.604737710522459 65.32145430917049,13.49745315792373 65.32042356281927)))"
24350007245000,1,1,0,0,"MULTIPOLYGON(((13.604737710522459 65.32145430917049,13.602358700611555 65.3663028772485,13.70983500126344 65.36725928546497,13.712031197777932 65.32240875240555,13.604737710522459 65.32145430917049)))"
24550007245000,32,16,16,46,"MULTIPOLYGON(((14.033958406639911 65.324814156082,14.032310905029327 65.36966964195462,14.139816239296211 65.37032010659068,14.141280770158714 65.32546328398453,14.033958406639911 65.324814156082)))"
24600007245000,28,14,14,48.9,"MULTIPOLYGON(((14.141280770158714 65.32546328398453,14.139816239296211 65.37032010659068,14.247327105602135 65.37089406397114,14.24860863572829 65.32603606180241,14.141280770158714 65.32546328398453)))"
24650007245000,10,7,3,37.8,"MULTIPOLYGON(((14.24860863572829 65.32603606180241,14.247327105602135 65.37089406397114,14.354842812921905 65.37139150734862,14.355941316067641 65.32653248282264,14.24860863572829 65.32603606180241)))"
24700007245000,1,1,0,0,"MULTIPOLYGON(((14.355941316067641 65.32653248282264,14.354842812921905 65.37139150734862,14.462362670038495 65.37181243087467,14.463278123705665 65.32695254122667,14.355941316067641 65.32653248282264)))"
23650007250000,688,347,341,42.5,"MULTIPOLYGON(((12.098946769452413 65.34489159868318,12.093996584881443 65.38969574970048,12.20146703528578 65.39172533794031,12.206234743478612 65.34691701805235,12.098946769452413 65.34489159868318)))"
23700007250000,328,178,150,43.6,"MULTIPOLYGON(((12.206234743478612 65.34691701805235,12.20146703528578 65.39172533794031,12.308955489862946 65.39367853723326,12.313540624165299 65.34886620477366,12.206234743478612 65.34691701805235)))"
23750007250000,25,14,11,37.8,"MULTIPOLYGON(((12.313540624165299 65.34886620477366,12.308955489862946 65.39367853723326,12.416461261988047 65.39555532462947,12.420863728585227 65.35073913601418,12.313540624165299 65.34886620477366)))"
23800007250000,21,11,10,35,"MULTIPOLYGON(((12.420863728585227 65.35073913601418,12.416461261988047 65.39555532462947,12.523983664351425 65.39735567807031,12.528203373132568 65.35253578982773,12.420863728585227 65.35073913601418)))"
23850007250000,45,27,18,37.6,"MULTIPOLYGON(((12.528203373132568 65.35253578982773,12.523983664351425 65.39735567807031,12.631522008985504 65.3990795763894,12.635558873549522 65.3542561451558,12.528203373132568 65.35253578982773)))"
23900007250000,15,8,7,42.1,"MULTIPOLYGON(((12.635558873549522 65.3542561451558,12.631522008985504 65.3990795763894,12.739075607291737 65.40072699931356,12.742929544953004 65.35590018182863,12.635558873549522 65.3542561451558)))"
24200007250000,3,2,1,0,"MULTIPOLYGON(((13.279986455464295 65.36297494174978,13.277048262191315 65.4078163360959,13.384678890032635 65.40900453105277,13.387433738602542 65.36416069280985,13.279986455464295 65.36297494174978)))"
24300007250000,2,1,1,0,"MULTIPOLYGON(((13.494891383290991 65.36527000898576,13.492319935962348 65.41011613378956,13.599970707310074 65.41115113121035,13.602358700611555 65.3663028772485,13.494891383290991 65.36527000898576)))"
24350007250000,6,3,3,59,"MULTIPOLYGON(((13.602358700611555 65.3663028772485,13.599970707310074 65.41115113121035,13.707630511019238 65.4121095111197,13.70983500126344 65.36725928546497,13.602358700611555 65.3663028772485)))"
24500007250000,66,37,29,50.4,"MULTIPOLYGON(((13.92481179360752 65.36894267770906,13.922974441529094 65.41379637412794,14.030657180532586 65.41452483734312,14.032310905029327 65.36966964195462,13.92481179360752 65.36894267770906)))"
24550007250000,2,2,0,0,"MULTIPOLYGON(((14.032310905029327 65.36966964195462,14.030657180532586 65.41452483734312,14.138346176358136 65.41517664328043,14.139816239296211 65.37032010659068,14.032310905029327 65.36966964195462)))"
24600007250000,1,1,0,0,"MULTIPOLYGON(((14.139816239296211 65.37032010659068,14.138346176358136 65.41517664328043,14.246040734430165 65.4157517842545,14.247327105602135 65.37089406397114,14.139816239296211 65.37032010659068)))"
23600007255000,59,32,27,52.6,"MULTIPOLYGON(((11.986544824563277 65.38758979635367,11.98139288942901 65.43238914285136,12.089027710101256 65.43449943600245,12.093996584881443 65.38969574970048,11.986544824563277 65.38758979635367)))"
23650007255000,155,77,78,38.5,"MULTIPOLYGON(((12.093996584881443 65.38969574970048,12.089027710101256 65.43449943600245,12.196681322801528 65.43653320734016,12.20146703528578 65.39172533794031,12.093996584881443 65.38969574970048)))"
23700007255000,89,50,39,44.5,"MULTIPOLYGON(((12.20146703528578 65.39172533794031,12.196681322801528 65.43653320734016,12.304353037898533 65.43849043290234,12.308955489862946 65.39367853723326,12.20146703528578 65.39172533794031)))"
23750007255000,5,4,1,57.4,"MULTIPOLYGON(((12.308955489862946 65.39367853723326,12.304353037898533 65.43849043290234,12.412042165042942 65.4403710896214,12.416461261988047 65.39555532462947,12.308955489862946 65.39367853723326)))"
23800007255000,67,34,33,55.5,"MULTIPOLYGON(((12.416461261988047 65.39555532462947,12.412042165042942 65.4403710896214,12.519748013194407 65.44217515532544,12.523983664351425 65.39735567807031,12.416461261988047 65.39555532462947)))"
23850007255000,395,180,215,45.3,"MULTIPOLYGON(((12.523983664351425 65.39735567807031,12.519748013194407 65.44217515532544,12.627469890648669 65.4439026087394,12.631522008985504 65.3990795763894,12.523983664351425 65.39735567807031)))"
24200007255000,4,2,2,0,"MULTIPOLYGON(((13.277048262191315 65.4078163360959,13.27409895849968 65.45265739297008,13.38191362330541 65.45384804018461,13.384678890032635 65.40900453105277,13.277048262191315 65.4078163360959)))"
24250007255000,87,46,41,47,"MULTIPOLYGON(((13.384678890032635 65.40900453105277,13.38191362330541 65.45384804018461,13.489738763151319 65.45496193730611,13.492319935962348 65.41011613378956,13.384678890032635 65.40900453105277)))"
24350007255000,36,20,16,39.7,"MULTIPOLYGON(((13.599970707310074 65.41115113121035,13.597573681587361 65.45599907117128,13.705417681773742 65.45695942952194,13.707630511019238 65.4121095111197,13.599970707310074 65.41115113121035)))"
24500007255000,28,16,12,41.6,"MULTIPOLYGON(((13.922974441529094 65.41379637412794,13.921130138255748 65.45864977517569,14.028997199172334 65.45937974249273,14.030657180532586 65.41452483734312,13.922974441529094 65.41379637412794)))"
24550007255000,17,9,8,51.6,"MULTIPOLYGON(((14.030657180532586 65.41452483734312,14.028997199172334 65.45937974249273,14.136870551136711 65.46003289432416,14.138346176358136 65.41517664328043,14.030657180532586 65.41452483734312)))"
24600007255000,12,6,6,50.3,"MULTIPOLYGON(((14.138346176358136 65.41517664328043,14.136870551136711 65.46003289432416,14.244749495776194 65.46060922294498,14.246040734430165 65.4157517842545,14.138346176358136 65.41517664328043)))"
24750007255000,4,2,2,0,"MULTIPOLYGON(((14.461443757933134 65.41667204508815,14.460521368501578 65.46153138419513,14.568412898837526 65.46187720591553,14.569150833217469 65.4170171540947,14.461443757933134 65.41667204508815)))"
23600007260000,2,1,1,0,"MULTIPOLYGON(((11.98139288942901 65.43238914285136,11.976221473251782 65.4771880090826,12.084040043168875 65.47930265687484,12.089027710101256 65.43449943600245,11.98139288942901 65.43238914285136)))"
23650007260000,1137,575,562,38.2,"MULTIPOLYGON(((12.089027710101256 65.43449943600245,12.084040043168875 65.47930265687484,12.191877507800859 65.48134062561576,12.196681322801528 65.43653320734016,12.089027710101256 65.43449943600245)))"
23700007260000,2639,1271,1368,45.6,"MULTIPOLYGON(((12.196681322801528 65.43653320734016,12.191877507800859 65.48134062561576,12.299733173771543 65.48330189121998,12.304353037898533 65.43849043290234,12.196681322801528 65.43653320734016)))"
23750007260000,278,158,120,41.2,"MULTIPOLYGON(((12.304353037898533 65.43849043290234,12.299733173771543 65.48330189121998,12.40760634698012 65.48518643050133,12.412042165042942 65.4403710896214,12.304353037898533 65.43849043290234)))"
23800007260000,6,4,2,61.8,"MULTIPOLYGON(((12.412042165042942 65.4403710896214,12.40760634698012 65.48518643050133,12.515496332628466 65.48699422117384,12.519748013194407 65.44217515532544,12.412042165042942 65.4403710896214)))"
23850007260000,4,2,2,0,"MULTIPOLYGON(((12.519748013194407 65.44217515532544,12.515496332628466 65.48699422117384,12.623402435248458 65.48872524185307,12.627469890648669 65.4439026087394,12.519748013194407 65.44217515532544)))"
24250007260000,43,23,20,45.1,"MULTIPOLYGON(((13.38191362330541 65.45384804018461,13.379137881468436 65.49869122023634,13.4871478116852 65.49980741960945,13.489738763151319 65.45496193730611,13.38191362330541 65.45384804018461)))"
24350007260000,29,17,12,57.7,"MULTIPOLYGON(((13.597573681587361 65.45599907117128,13.595167574053958 65.50084669724546,13.70319646792404 65.50180904082299,13.705417681773742 65.45695942952194,13.597573681587361 65.45599907117128)))"
24400007260000,3,1,2,0,"MULTIPOLYGON(((13.705417681773742 65.45695942952194,13.70319646792404 65.50180904082299,13.811233792279372 65.50269443893092,13.81327006650861 65.45784300100554,13.705417681773742 65.45695942952194)))"
24500007260000,23,12,11,55.3,"MULTIPOLYGON(((13.921130138255748 65.45864977517569,13.91927884576648 65.50350288106907,14.027330926722449 65.50423435764847,14.028997199172334 65.45937974249273,13.921130138255748 65.45864977517569)))"
24550007260000,6,4,2,36,"MULTIPOLYGON(((14.028997199172334 65.45937974249273,14.027330926722449 65.50423435764847,14.135389333202982 65.50488885999214,14.136870551136711 65.46003289432416,14.028997199172334 65.45937974249273)))"
24600007260000,3,1,2,0,"MULTIPOLYGON(((14.136870551136711 65.46003289432416,14.135389333202982 65.50488885999214,14.243453363010444 65.50546638033524,14.244749495776194 65.46060922294498,14.136870551136711 65.46003289432416)))"
24650007260000,8,5,3,48.5,"MULTIPOLYGON(((14.244749495776194 65.46060922294498,14.243453363010444 65.50546638033524,14.351522313721954 65.50596691182561,14.352633334494895 65.46110872153822,14.244749495776194 65.46060922294498)))"
24700007260000,5,1,4,19.6,"MULTIPOLYGON(((14.352633334494895 65.46110872153822,14.351522313721954 65.50596691182561,14.459595482717491 65.506390448524,14.460521368501578 65.46153138419513,14.352633334494895 65.46110872153822)))"
23650007265000,5,3,2,67.6,"MULTIPOLYGON(((12.084040043168875 65.47930265687484,12.079033481396298 65.52410541159617,12.187055491340727 65.52614759212422,12.191877507800859 65.48134062561576,12.084040043168875 65.47930265687484)))"
23700007265000,2204,1079,1125,39.4,"MULTIPOLYGON(((12.191877507800859 65.48134062561576,12.187055491340727 65.52614759212422,12.295095802290435 65.52811291161902,12.299733173771543 65.48330189121998,12.191877507800859 65.48134062561576)))"
23750007265000,219,115,104,40.8,"MULTIPOLYGON(((12.299733173771543 65.48330189121998,12.295095802290435 65.52811291161902,12.403153716365873 65.53000134677491,12.40760634698012 65.48518643050133,12.299733173771543 65.48330189121998)))"
23800007265000,17,8,9,47.9,"MULTIPOLYGON(((12.40760634698012 65.48518643050133,12.403153716365873 65.53000134677491,12.51122853498378 65.53181287519115,12.515496332628466 65.48699422117384,12.40760634698012 65.48518643050133)))"
24250007265000,893,462,431,44.2,"MULTIPOLYGON(((13.379137881468436 65.49869122023634,13.376351607151905 65.54353407123706,13.48454702800153 65.54465258077207,13.4871478116852 65.49980741960945,13.379137881468436 65.49869122023634)))"
24300007265000,45,24,21,41.9,"MULTIPOLYGON(((13.4871478116852 65.49980741960945,13.48454702800153 65.54465258077207,13.592752334958337 65.5456940095458,13.595167574053958 65.50084669724546,13.4871478116852 65.49980741960945)))"
24350007265000,16,11,5,36.8,"MULTIPOLYGON(((13.595167574053958 65.50084669724546,13.592752334958337 65.5456940095458,13.70096682353284 65.5466583451732,13.70319646792404 65.50180904082299,13.595167574053958 65.50084669724546)))"
24400007265000,4,1,3,0,"MULTIPOLYGON(((13.70319646792404 65.50180904082299,13.70096682353284 65.5466583451732,13.809189788866798 65.5475455761842,13.811233792279372 65.50269443893092,13.70319646792404 65.50180904082299)))"
24450007265000,1,1,0,0,"MULTIPOLYGON(((13.811233792279372 65.50269443893092,13.809189788866798 65.5475455761842,13.91742052576145 65.54835569202433,13.91927884576648 65.50350288106907,13.811233792279372 65.50269443893092)))"
24500007265000,12,7,5,53.8,"MULTIPOLYGON(((13.91927884576648 65.50350288106907,13.91742052576145 65.54835569202433,14.025658328705779 65.5490886830551,14.027330926722449 65.50423435764847,13.91927884576648 65.50350288106907)))"
24550007265000,21,10,11,50.8,"MULTIPOLYGON(((14.027330926722449 65.50423435764847,14.025658328705779 65.5490886830551,14.133902491904779 65.54974454055466,14.135389333202982 65.50488885999214,14.027330926722449 65.50423435764847)))"
24600007265000,14,9,5,48.8,"MULTIPOLYGON(((14.135389333202982 65.50488885999214,14.133902491904779 65.54974454055466,14.242152309307787 65.55032325671804,14.243453363010444 65.50546638033524,14.135389333202982 65.50488885999214)))"
23700007270000,42,23,19,47.6,"MULTIPOLYGON(((12.187055491340727 65.52614759212422,12.18221517375344 65.57095410621605,12.290440827566304 65.5729234935262,12.295095802290435 65.52811291161902,12.187055491340727 65.52614759212422)))"
23750007270000,38,19,19,38,"MULTIPOLYGON(((12.295095802290435 65.52811291161902,12.290440827566304 65.5729234935262,12.398684181096463 65.57481583794231,12.403153716365873 65.53000134677491,12.295095802290435 65.52811291161902)))"
24250007270000,109,59,50,47.7,"MULTIPOLYGON(((13.376351607151905 65.54353407123706,13.373554742564776 65.5883765932141,13.48193635814452 65.58949742086499,13.48454702800153 65.54465258077207,13.376351607151905 65.54353407123706)))"
24350007270000,2,1,1,0,"MULTIPOLYGON(((13.592752334958337 65.5456940095458,13.590327914183566 65.590541008184,13.698728702325429 65.59150734272198,13.70096682353284 65.5466583451732,13.592752334958337 65.5456940095458)))"
24400007270000,2,0,2,0,"MULTIPOLYGON(((13.70096682353284 65.5466583451732,13.698728702325429 65.59150734272198,13.807138013841476 65.59239641294947,13.809189788866798 65.5475455761842,13.70096682353284 65.5466583451732)))"
24450007270000,22,12,10,55.2,"MULTIPOLYGON(((13.809189788866798 65.5475455761842,13.807138013841476 65.59239641294947,13.915555139659416 65.59320820825731,13.91742052576145 65.54835569202433,13.809189788866798 65.5475455761842)))"
24500007270000,237,129,108,46.5,"MULTIPOLYGON(((13.91742052576145 65.54835569202433,13.915555139659416 65.59320820825731,14.023979370391826 65.59394271895714,14.025658328705779 65.5490886830551,13.91742052576145 65.54835569202433)))"
24550007270000,27,15,12,58.9,"MULTIPOLYGON(((14.025658328705779 65.5490886830551,14.023979370391826 65.59394271895714,14.13240999636468 65.59459993628192,14.133902491904779 65.54974454055466,14.025658328705779 65.5490886830551)))"
24600007270000,26,15,11,42,"MULTIPOLYGON(((14.133902491904779 65.54974454055466,14.13240999636468 65.59459993628192,14.240846307645946 65.59517985238625,14.242152309307787 65.55032325671804,14.133902491904779 65.54974454055466)))"
24650007270000,3,1,2,0,"MULTIPOLYGON(((14.242152309307787 65.55032325671804,14.240846307645946 65.59517985238625,14.349287594074168 65.59568246034688,14.350407074636822 65.55082482465764,14.242152309307787 65.55032325671804)))"
23500007275000,1,1,0,0,"MULTIPOLYGON(((11.749503578155888 65.56230661017253,11.743901730423199 65.6070947554432,11.85223519310189 65.6093767879401,11.857651423759323 65.56458392572137,11.749503578155888 65.56230661017253)))"
23550007275000,2,1,1,0,"MULTIPOLYGON(((11.857651423759323 65.56458392572137,11.85223519310189 65.6093767879401,11.96058927029895 65.61158171810771,11.965819771284906 65.56678429752564,11.857651423759323 65.56458392572137)))"
23650007275000,3,2,1,0,"MULTIPOLYGON(((12.074007921343684 65.56890769943773,12.068963258812488 65.61370951966332,12.177356454640051 65.61576016723481,12.18221517375344 65.57095410621605,12.074007921343684 65.56890769943773)))"
23700007275000,1,0,1,0,"MULTIPOLYGON(((12.18221517375344 65.57095410621605,12.177356454640051 65.61576016723481,12.285768153006517 65.617733636362,12.290440827566304 65.5729234935262,12.18221517375344 65.57095410621605)))"
23750007275000,34,19,15,46.8,"MULTIPOLYGON(((12.290440827566304 65.5729234935262,12.285768153006517 65.617733636362,12.394197648392025 65.6196299034978,12.398684181096463 65.57481583794231,12.290440827566304 65.5729234935262)))"
24100007275000,7,4,3,33.7,"MULTIPOLYGON(((13.048476615967244 65.58455080654458,13.04510876223487 65.62938506117845,13.153643025543701 65.63074033198116,13.156824164177884 65.58590327130824,13.048476615967244 65.58455080654458)))"
24150007275000,8,5,3,54.4,"MULTIPOLYGON(((13.156824164177884 65.58590327130824,13.153643025543701 65.63074033198116,13.262189418280112 65.63201824541375,13.265183775400258 65.58717853859959,13.156824164177884 65.58590327130824)))"
24200007275000,40,23,17,40.9,"MULTIPOLYGON(((13.265183775400258 65.58717853859959,13.262189418280112 65.63201824541375,13.37074722949093 65.6332187861929,13.373554742564776 65.5883765932141,13.265183775400258 65.58717853859959)))"
24250007275000,37,19,18,52.2,"MULTIPOLYGON(((13.373554742564776 65.5883765932141,13.37074722949093 65.6332187861929,13.479315747761435 65.6343419399577,13.48193635814452 65.58949742086499,13.373554742564776 65.5883765932141)))"
24450007275000,21,14,7,38.8,"MULTIPOLYGON(((13.807138013841476 65.59239641294947,13.805078424461735 65.63724694941016,13.913682648595149 65.63806042998337,13.915555139659416 65.59320820825731,13.807138013841476 65.59239641294947)))"
24500007275000,367,160,207,48.8,"MULTIPOLYGON(((13.915555139659416 65.59320820825731,13.913682648595149 65.63806042998337,14.022294016794422 65.63879646559886,14.023979370391826 65.59394271895714,13.915555139659416 65.59320820825731)))"
24550007275000,92,55,37,45.2,"MULTIPOLYGON(((14.023979370391826 65.59394271895714,14.022294016794422 65.63879646559886,14.130911815477939 65.63945504744403,14.13240999636468 65.59459993628192,14.023979370391826 65.59394271895714)))"
23500007280000,32,19,13,40.5,"MULTIPOLYGON(((11.743901730423199 65.6070947554432,11.738278565655909 65.65188238522825,11.846798347788026 65.65416915092364,11.85223519310189 65.6093767879401,11.743901730423199 65.6070947554432)))"
23550007280000,116,62,54,42.5,"MULTIPOLYGON(((11.85223519310189 65.6093767879401,11.846798347788026 65.65416915092364,11.955338857863094 65.6563786551636,11.96058927029895 65.61158171810771,11.85223519310189 65.6093767879401)))"
23600007280000,46,26,20,56.7,"MULTIPOLYGON(((11.96058927029895 65.61158171810771,11.955338857863094 65.6563786551636,12.06389938883848 65.6585108715293,12.068963258812488 65.61370951966332,11.96058927029895 65.61158171810771)))"
23650007280000,24,12,12,52.3,"MULTIPOLYGON(((12.068963258812488 65.61370951966332,12.06389938883848 65.6585108715293,12.172479232863639 65.66056577451728,12.177356454640051 65.61576016723481,12.068963258812488 65.61370951966332)))"
23700007280000,7,3,4,27.7,"MULTIPOLYGON(((12.177356454640051 65.61576016723481,12.172479232863639 65.66056577451728,12.281077681308227 65.66254333954059,12.285768153006517 65.617733636362,12.177356454640051 65.61576016723481)))"
23750007280000,34,22,12,48.8,"MULTIPOLYGON(((12.285768153006517 65.617733636362,12.281077681308227 65.66254333954059,12.389694024790323 65.66444354293002,12.394197648392025 65.6196299034978,12.285768153006517 65.617733636362)))"
23800007280000,4,3,1,0,"MULTIPOLYGON(((12.394197648392025 65.6196299034978,12.389694024790323 65.66444354293002,12.498327553204707 65.66626636193533,12.502644234560021 65.62144894600925,12.394197648392025 65.6196299034978)))"
23950007280000,13,8,5,34.2,"MULTIPOLYGON(((12.719585850882412 65.624855271205,12.71564332096312 65.66967976039375,12.824324136735736 65.67127029895065,12.828079465233413 65.6264425132042,12.719585850882412 65.624855271205)))"
24150007280000,3,1,2,0,"MULTIPOLYGON(((13.153643025543701 65.63074033198116,13.150449757400253 65.67557704593932,13.259183642608628 65.67685761465893,13.262189418280112 65.63201824541375,13.153643025543701 65.63074033198116)))"
24200007280000,12,7,5,55.1,"MULTIPOLYGON(((13.262189418280112 65.63201824541375,13.259183642608628 65.67685761465893,13.367929009285243 65.67806065019701,13.37074722949093 65.6332187861929,13.262189418280112 65.63201824541375)))"
24400007280000,5,3,2,53.6,"MULTIPOLYGON(((13.69648205768656 65.63635603361783,13.694226842657311 65.68120441800824,13.803010977670745 65.682097185749,13.805078424461735 65.63724694941016,13.69648205768656 65.63635603361783)))"
24450007280000,10,8,2,36.6,"MULTIPOLYGON(((13.805078424461735 65.63724694941016,13.803010977670745 65.682097185749,13.911803013416815 65.68291235741741,13.913682648595149 65.63806042998337,13.805078424461735 65.63724694941016)))"
24550007280000,17,11,6,50.7,"MULTIPOLYGON(((14.022294016794422 65.63879646559886,14.020602232669377 65.68364992322424,14.129407917910378 65.68430987431105,14.130911815477939 65.63945504744403,14.022294016794422 65.63879646559886)))"
24600007280000,24,14,10,44.9,"MULTIPOLYGON(((14.130911815477939 65.63945504744403,14.129407917910378 65.68430987431105,14.238219351358957 65.68489220275079,14.239535330803681 65.6400361676328,14.130911815477939 65.63945504744403)))"
24650007280000,5,4,1,49.6,"MULTIPOLYGON(((14.239535330803681 65.6400361676328,14.238219351358957 65.68489220275079,14.34703581500059 65.68539690154799,14.348163848698107 65.64053981920597,14.239535330803681 65.6400361676328)))"
23500007285000,10,5,5,44.7,"MULTIPOLYGON(((11.738278565655909 65.65188238522825,11.732633966595005 65.69666949851579,11.841340774391877 65.69896101374995,11.846798347788026 65.65416915092364,11.738278565655909 65.65188238522825)))"
23550007285000,289,147,142,47.4,"MULTIPOLYGON(((11.846798347788026 65.65416915092364,11.841340774391877 65.69896101374995,11.950068424392262 65.70117510785818,11.955338857863094 65.6563786551636,11.846798347788026 65.65416915092364)))"
23600007285000,377,180,197,45.7,"MULTIPOLYGON(((11.955338857863094 65.6563786551636,11.950068424392262 65.70117510785818,12.058816205684739 65.70331175428457,12.06389938883848 65.6585108715293,11.955338857863094 65.6563786551636)))"
23650007285000,62,32,30,48.9,"MULTIPOLYGON(((12.06389938883848 65.6585108715293,12.058816205684739 65.70331175428457,12.16758340654253 65.70537092739326,12.172479232863639 65.66056577451728,12.06389938883848 65.6585108715293)))"
23750007285000,7,4,3,63.6,"MULTIPOLYGON(((12.281077681308227 65.66254333954059,12.27636931445188 65.70735260246967,12.385173216140515 65.70925675572168,12.389694024790323 65.66444354293002,12.281077681308227 65.66254333954059)))"
23800007285000,257,120,137,46.2,"MULTIPOLYGON(((12.389694024790323 65.66444354293002,12.385173216140515 65.70925675572168,12.493994397606187 65.71108336428088,12.498327553204707 65.66626636193533,12.389694024790323 65.66444354293002)))"
23850007285000,5,3,2,72.4,"MULTIPOLYGON(((12.498327553204707 65.66626636193533,12.493994397606187 65.71108336428088,12.60283214414529 65.71283240620356,12.606977555751202 65.6680117747263,12.498327553204707 65.66626636193533)))"
24150007285000,15,11,4,60.3,"MULTIPOLYGON(((13.150449757400253 65.67557704593932,13.147244292840796 65.72041341310593,13.25616638539127 65.7216966463091,13.259183642608628 65.67685761465893,13.150449757400253 65.67557704593932)))"
24200007285000,19,10,9,45.9,"MULTIPOLYGON(((13.259183642608628 65.67685761465893,13.25616638539127 65.7216966463091,13.365100022869639 65.72290218524817,13.367929009285243 65.67806065019701,13.259183642608628 65.67685761465893)))"
24450007285000,14,8,6,35.5,"MULTIPOLYGON(((13.803010977670745 65.682097185749,13.80093563009362 65.72694712214796,13.909916194683337 65.72776399077382,13.911803013416815 65.68291235741741,13.803010977670745 65.682097185749)))"
24500007285000,20,11,9,36.7,"MULTIPOLYGON(((13.911803013416815 65.68291235741741,13.909916194683337 65.72776399077382,14.018903982512093 65.728503092077,14.020602232669377 65.68364992322424,13.911803013416815 65.68291235741741)))"
24550007285000,5,1,4,18,"MULTIPOLYGON(((14.020602232669377 65.68364992322424,14.018903982512093 65.728503092077,14.12789827209629 65.72916441715297,14.129407917910378 65.68430987431105,14.020602232669377 65.68364992322424)))"
24600007285000,10,5,5,33.6,"MULTIPOLYGON(((14.129407917910378 65.68430987431105,14.12789827209629 65.72916441715297,14.236898341687095 65.72974795803331,14.238219351358957 65.68489220275079,14.129407917910378 65.68430987431105)))"
23550007290000,233,129,104,44.5,"MULTIPOLYGON(((11.841340774391877 65.69896101374995,11.835862358651607 65.7437523754882,11.94477785949344 65.74597107534815,11.950068424392262 65.70117510785818,11.841340774391877 65.69896101374995)))"
23600007290000,12,6,6,52.5,"MULTIPOLYGON(((11.950068424392262 65.70117510785818,11.94477785949344 65.74597107534815,12.053713602834517 65.74811216717032,12.058816205684739 65.70331175428457,11.950068424392262 65.70117510785818)))"
23800007290000,58,33,25,43.2,"MULTIPOLYGON(((12.385173216140515 65.70925675572168,12.380635127596772 65.75406954134966,12.489644676822122 65.75589995259521,12.493994397606187 65.71108336428088,12.385173216140515 65.70925675572168)))"
23850007290000,47,23,24,53.5,"MULTIPOLYGON(((12.493994397606187 65.71108336428088,12.489644676822122 65.75589995259521,12.59867088273491 65.7576526362293,12.60283214414529 65.71283240620356,12.493994397606187 65.71108336428088)))"
23900007290000,5,2,3,63,"MULTIPOLYGON(((12.60283214414529 65.71283240620356,12.59867088273491 65.7576526362293,12.707713026020507 65.75932757112464,12.711685740381546 65.71450386047186,12.60283214414529 65.71283240620356)))"
24150007290000,124,66,58,44.1,"MULTIPOLYGON(((13.147244292840796 65.72041341310593,13.144026564463918 65.76524943340146,13.253137583167659 65.7665353403359,13.25616638539127 65.7216966463091,13.147244292840796 65.72041341310593)))"
24200007290000,44,22,22,34.6,"MULTIPOLYGON(((13.25616638539127 65.7216966463091,13.253137583167659 65.7665353403359,13.36226021072909 65.76774339136614,13.365100022869639 65.72290218524817,13.25616638539127 65.7216966463091)))"
24500007290000,1,1,0,0,"MULTIPOLYGON(((13.909916194683337 65.72776399077382,13.908022152661719 65.77261533026648,14.01719923055516 65.77335597240061,14.018903982512093 65.728503092077,13.909916194683337 65.72776399077382)))"
24550007290000,5,2,3,37.8,"MULTIPOLYGON(((14.018903982512093 65.728503092077,14.01719923055516 65.77335597240061,14.12638284623629 65.77401867623965,14.12789827209629 65.72916441715297,14.018903982512093 65.728503092077)))"
24800007290000,2,1,1,0,"MULTIPOLYGON(((14.563926009649876 65.73103180986644,14.563168168521278 65.77588996256796,14.672373582632794 65.7761628736147,14.672941977503601 65.73130415301573,14.563926009649876 65.73103180986644)))"
23800007295000,68,32,36,49.5,"MULTIPOLYGON(((12.380635127596772 65.75406954134966,12.376079663611886 65.7988818992849,12.485278299237471 65.80071612642236,12.489644676822122 65.75589995259521,12.380635127596772 65.75406954134966)))"
23850007295000,37,15,22,56.2,"MULTIPOLYGON(((12.489644676822122 65.75589995259521,12.485278299237471 65.80071612642236,12.594493683843403 65.80247246441755,12.59867088273491 65.7576526362293,12.489644676822122 65.75589995259521)))"
24150007295000,175,97,78,43.1,"MULTIPOLYGON(((13.144026564463918 65.76524943340146,13.14079650436895 65.81008510674383,13.250097172007276 65.81137369670877,13.253137583167659 65.7665353403359,13.144026564463918 65.76524943340146)))"
24200007295000,59,30,29,37.4,"MULTIPOLYGON(((13.253137583167659 65.7665353403359,13.250097172007276 65.81137369670877,13.359409512907579 65.81258426856873,13.36226021072909 65.76774339136614,13.253137583167659 65.7665353403359)))"
24300007295000,5,3,2,52.6,"MULTIPOLYGON(((13.471393723897307 65.76887357190589,13.468732799815077 65.81371680766117,13.578066305025796 65.81477130026612,13.58053739897634 65.76992586830649,13.471393723897307 65.76887357190589)))"
24500007295000,10,5,5,48.7,"MULTIPOLYGON(((13.908022152661719 65.77261533026648,13.906120847324337 65.8174663761088,14.015487940765922 65.81820856443821,14.01719923055516 65.77335597240061,13.908022152661719 65.77261533026648)))"
24600007295000,15,6,9,32.4,"MULTIPOLYGON(((14.12638284623629 65.77401867623965,14.124861608295143 65.8188726518409,14.23424112013873 65.81945863026498,14.23557227395889 65.7746034337736,14.12638284623629 65.77401867623965)))"
24700007295000,11,7,4,35.4,"MULTIPOLYGON(((14.34476678773873 65.77511023793383,14.343625746283179 65.81996649260482,14.453014756504722 65.82039623270154,14.453965661383247 65.77553908259354,14.34476678773873 65.77511023793383)))"
24750007295000,2,1,1,0,"MULTIPOLYGON(((14.453965661383247 65.77553908259354,14.453014756504722 65.82039623270154,14.562407420399337 65.82074784534325,14.563168168521278 65.77588996256796,14.453965661383247 65.77553908259354)))"
23600007300000,3,3,0,0,"MULTIPOLYGON(((11.939467051958223 65.7907665567819,11.934135889755291 65.83556155129939,12.043449708035368 65.83771158025975,12.048591472984066 65.79291210942012,11.939467051958223 65.7907665567819)))"
23650007300000,2,2,0,0,"MULTIPOLYGON(((12.048591472984066 65.79291210942012,12.043449708035368 65.83771158025975,12.1527832701785 65.8397836527746,12.157735528974555 65.7949798672098,12.048591472984066 65.79291210942012)))"
23700007300000,6,2,4,73.7,"MULTIPOLYGON(((12.157735528974555 65.7949798672098,12.1527832701785 65.8397836527746,12.262135851848843 65.84177774374085,12.26689849956345 65.79696980517828,12.157735528974555 65.7949798672098)))"
23800007300000,203,98,105,48.4,"MULTIPOLYGON(((12.376079663611886 65.7988818992849,12.371506727930788 65.84369382899226,12.480895172558274 65.84553188530067,12.485278299237471 65.80071612642236,12.376079663611886 65.7988818992849)))"
23850007300000,6,4,2,30.2,"MULTIPOLYGON(((12.485278299237471 65.80071612642236,12.480895172558274 65.84553188530067,12.590300459144219 65.84729189037718,12.594493683843403 65.80247246441755,12.485278299237471 65.80071612642236)))"
23900007300000,3,3,0,0,"MULTIPOLYGON(((12.594493683843403 65.80247246441755,12.590300459144219 65.84729189037718,12.699721860409989 65.84897382287312,12.703725094147696 65.80415089203292,12.594493683843403 65.80247246441755)))"
24150007300000,7468,3738,3730,44.7,"MULTIPOLYGON(((13.14079650436895 65.81008510674383,13.137554044151367 65.85492043304814,13.247045087505104 65.8562117153947,13.250097172007276 65.81137369670877,13.14079650436895 65.81008510674383)))"
24200007300000,446,246,200,41.9,"MULTIPOLYGON(((13.250097172007276 65.81137369670877,13.247045087505104 65.8562117153947,13.356547869004002 65.85742481687176,13.359409512907579 65.81258426856873,13.250097172007276 65.81137369670877)))"
24250007300000,67,33,34,35.7,"MULTIPOLYGON(((13.359409512907579 65.81258426856873,13.356547869004002 65.85742481687176,13.466061657359715 65.85855972273994,13.468732799815077 65.81371680766117,13.359409512907579 65.81258426856873)))"
24300007300000,9,5,4,37.3,"MULTIPOLYGON(((13.468732799815077 65.81371680766117,13.466061657359715 65.85855972273994,13.57558572083052 65.85961641920743,13.578066305025796 65.81477130026612,13.468732799815077 65.81371680766117)))"
24450007300000,4,3,1,0,"MULTIPOLYGON(((13.796761057473471 65.81664609585056,13.794661744063767 65.86149513351442,13.904212238346219 65.86231712851361,13.906120847324337 65.8174663761088,13.796761057473471 65.81664609585056)))"
24600007300000,43,21,22,44.5,"MULTIPOLYGON(((14.124861608295143 65.8188726518409,14.123334525999592 65.8637263442264,14.232904851982664 65.86431354780078,14.23424112013873 65.81945863026498,14.124861608295143 65.8188726518409)))"
23700007305000,34,18,16,48.2,"MULTIPOLYGON(((12.1527832701785 65.8397836527746,12.14781199172526 65.88458698118126,12.257354909597561 65.88658523961998,12.262135851848843 65.84177774374085,12.1527832701785 65.8397836527746)))"
23750007305000,14,8,6,56.6,"MULTIPOLYGON(((12.262135851848843 65.84177774374085,12.257354909597561 65.88658523961998,12.366916223583969 65.88850532993057,12.371506727930788 65.84369382899226,12.262135851848843 65.84177774374085)))"
23800007305000,43,19,24,52,"MULTIPOLYGON(((12.371506727930788 65.84369382899226,12.366916223583969 65.88850532993057,12.47649520380536 65.89034722876322,12.480895172558274 65.84553188530067,12.371506727930788 65.84369382899226)))"
23850007305000,30,18,12,47.9,"MULTIPOLYGON(((12.480895172558274 65.84553188530067,12.47649520380536 65.89034722876322,12.586091119654878 65.89211091371224,12.590300459144219 65.84729189037718,12.480895172558274 65.84553188530067)))"
23900007305000,4,2,2,0,"MULTIPOLYGON(((12.590300459144219 65.84729189037718,12.586091119654878 65.89211091371224,12.695703239827688 65.89379636331714,12.699721860409989 65.84897382287312,12.590300459144219 65.84729189037718)))"
24100007305000,3,3,0,0,"MULTIPOLYGON(((13.028075469747789 65.85355098551814,13.024629503394666 65.89838309966254,13.134299114898075 65.8997554122268,13.137554044151367 65.85492043304814,13.028075469747789 65.85355098551814)))"
24150007305000,2770,1454,1316,39.2,"MULTIPOLYGON(((13.137554044151367 65.85492043304814,13.134299114898075 65.8997554122268,13.243981264777213 65.90104939635845,13.247045087505104 65.8562117153947,13.137554044151367 65.85492043304814)))"
24200007305000,151,87,64,45.3,"MULTIPOLYGON(((13.247045087505104 65.8562117153947,13.243981264777213 65.90104939635845,13.353675218168046 65.9022650362891,13.356547869004002 65.85742481687176,13.247045087505104 65.8562117153947)))"
24250007305000,154,71,83,42.1,"MULTIPOLYGON(((13.356547869004002 65.85742481687176,13.353675218168046 65.9022650362891,13.463380239718697 65.9034023172021,13.466061657359715 65.85855972273994,13.356547869004002 65.85742481687176)))"
24300007305000,33,17,16,36.3,"MULTIPOLYGON(((13.466061657359715 65.85855972273994,13.463380239718697 65.9034023172021,13.573095593619684 65.90446122523315,13.57558572083052 65.85961641920743,13.466061657359715 65.85855972273994)))"
24400007305000,15,7,8,55.3,"MULTIPOLYGON(((13.685119327251334 65.86059489343054,13.682820543634215 65.90544174747117,13.792554353128528 65.90634387195887,13.794661744063767 65.86149513351442,13.685119327251334 65.86059489343054)))"
24450007305000,78,45,33,47.3,"MULTIPOLYGON(((13.794661744063767 65.86149513351442,13.792554353128528 65.90634387195887,13.902296285102265 65.9071675876933,13.904212238346219 65.86231712851361,13.794661744063767 65.86149513351442)))"
24500007305000,42,29,13,47.9,"MULTIPOLYGON(((13.904212238346219 65.86231712851361,13.902296285102265 65.9071675876933,14.012045602218889 65.90791288462643,14.013770076844018 65.86306086843263,13.904212238346219 65.86231712851361)))"
24550007305000,17,8,9,43.7,"MULTIPOLYGON(((14.013770076844018 65.86306086843263,14.012045602218889 65.90791288462643,14.121801566836128 65.90857975366573,14.123334525999592 65.8637263442264,14.013770076844018 65.86306086843263)))"
24600007305000,10,7,3,76.9,"MULTIPOLYGON(((14.123334525999592 65.8637263442264,14.121801566836128 65.90857975366573,14.231563441036476 65.9091681866745,14.232904851982664 65.86431354780078,14.123334525999592 65.8637263442264)))"
24700007305000,1,0,1,0,"MULTIPOLYGON(((14.342480320720485 65.86482247201295,14.341330486657686 65.90967817647238,14.451101965323307 65.91010971683565,14.452060197928091 65.8652531106717,14.342480320720485 65.86482247201295)))"
23600007310000,14,6,8,66.4,"MULTIPOLYGON(((11.928784260022788 65.88035605803216,11.92341204906064 65.9251500761031,12.033106836435588 65.92730910457234,12.038288199088774 65.88251057890716,11.928784260022788 65.88035605803216)))"
23650007310000,38,21,17,64.3,"MULTIPOLYGON(((12.038288199088774 65.88251057890716,12.033106836435588 65.92730910457234,12.14282158790504 65.92938985172377,12.14781199172526 65.88458698118126,12.038288199088774 65.88251057890716)))"
23700007310000,46,22,24,64.8,"MULTIPOLYGON(((12.14781199172526 65.88458698118126,12.14282158790504 65.92938985172377,12.252555571105935 65.93139229219054,12.257354909597561 65.88658523961998,12.14781199172526 65.88458698118126)))"
23750007310000,41,24,17,57,"MULTIPOLYGON(((12.257354909597561 65.88658523961998,12.252555571105935 65.93139229219054,12.362308052880872 65.9333164015525,12.366916223583969 65.88850532993057,12.257354909597561 65.88658523961998)))"
23800007310000,294,147,147,42,"MULTIPOLYGON(((12.366916223583969 65.88850532993057,12.362308052880872 65.9333164015525,12.472078299307984 65.93516215633727,12.47649520380536 65.89034722876322,12.366916223583969 65.88850532993057)))"
23850007310000,73,41,32,39.7,"MULTIPOLYGON(((12.47649520380536 65.89034722876322,12.472078299307984 65.93516215633727,12.581865575730886 65.93692953402162,12.586091119654878 65.89211091371224,12.47649520380536 65.89034722876322)))"
23950007310000,10,7,3,69.7,"MULTIPOLYGON(((12.695703239827688 65.89379636331714,12.691669146788708 65.93861851303228,12.801488276446209 65.94022907274737,12.8053308323508 65.8954035570637,12.695703239827688 65.89379636331714)))"
24000007310000,8,4,4,40.4,"MULTIPOLYGON(((12.8053308323508 65.8954035570637,12.801488276446209 65.94022907274737,12.91132222802393 65.94176119349721,12.914973164612972 65.89693247538504,12.8053308323508 65.8954035570637)))"
24050007310000,8,4,4,61.9,"MULTIPOLYGON(((12.914973164612972 65.89693247538504,12.91132222802393 65.94176119349721,13.021170264228461 65.94321485656529,13.024629503394666 65.89838309966254,12.914973164612972 65.89693247538504)))"
24100007310000,16,6,10,44.8,"MULTIPOLYGON(((13.024629503394666 65.89838309966254,13.021170264228461 65.94321485656529,13.131031647182716 65.9445900441894,13.134299114898075 65.8997554122268,13.024629503394666 65.89838309966254)))"
24150007310000,304,160,144,41,"MULTIPOLYGON(((13.134299114898075 65.8997554122268,13.131031647182716 65.9445900441894,13.240905638456315 65.94588673956225,13.243981264777213 65.90104939635845,13.134299114898075 65.8997554122268)))"
24200007310000,234,122,112,44,"MULTIPOLYGON(((13.243981264777213 65.90104939635845,13.240905638456315 65.94588673956225,13.350791499096005 65.94710492683257,13.353675218168046 65.9022650362891,13.243981264777213 65.90104939635845)))"
24250007310000,103,56,47,46.5,"MULTIPOLYGON(((13.353675218168046 65.9022650362891,13.350791499096005 65.94710492683257,13.460688489656125 65.94824459110575,13.463380239718697 65.9034023172021,13.353675218168046 65.9022650362891)))"
24450007310000,197,109,88,50,"MULTIPOLYGON(((13.792554353128528 65.90634387195887,13.790438839657838 65.95119231136206,13.900372946664474 65.95201775385958,13.902296285102265 65.9071675876933,13.792554353128528 65.90634387195887)))"
24700007310000,6,3,3,60.8,"MULTIPOLYGON(((14.341330486657686 65.90967817647238,14.340176219519863 65.9545336062974,14.450140038208685 65.95496605152536,14.451101965323307 65.91010971683565,14.341330486657686 65.90967817647238)))"
23700007315000,38,21,17,48.5,"MULTIPOLYGON(((12.14282158790504 65.92938985172377,12.137811952220977 65.97419226368875,12.24773773391285 65.97619890082066,12.252555571105935 65.93139229219054,12.14282158790504 65.92938985172377)))"
23750007315000,309,165,144,40.2,"MULTIPOLYGON(((12.252555571105935 65.93139229219054,12.24773773391285 65.97619890082066,12.357682117403185 65.97812704330453,12.362308052880872 65.9333164015525,12.252555571105935 65.93139229219054)))"
23800007315000,78,38,40,48.7,"MULTIPOLYGON(((12.362308052880872 65.9333164015525,12.357682117403185 65.97812704330453,12.467644364697403 65.97997666754459,12.472078299307984 65.93516215633727,12.362308052880872 65.9333164015525)))"
23850007315000,171,89,82,39.8,"MULTIPOLYGON(((12.472078299307984 65.93516215633727,12.467644364697403 65.97997666754459,12.57762373705957 65.98174775089909,12.581865575730886 65.93692953402162,12.472078299307984 65.93516215633727)))"
23900007315000,11,4,7,41,"MULTIPOLYGON(((12.581865575730886 65.93692953402162,12.57762373705957 65.98174775089909,12.687619495042682 65.98344027168129,12.691669146788708 65.93861851303228,12.581865575730886 65.93692953402162)))"
23950007315000,24,13,11,50,"MULTIPOLYGON(((12.691669146788708 65.93861851303228,12.687619495042682 65.98344027168129,12.79763089851906 65.98505420916081,12.801488276446209 65.94022907274737,12.691669146788708 65.93861851303228)))"
24000007315000,14,7,7,57.4,"MULTIPOLYGON(((12.801488276446209 65.94022907274737,12.79763089851906 65.98505420916081,12.907657206710804 65.98658954356436,12.91132222802393 65.94176119349721,12.801488276446209 65.94022907274737)))"
24050007315000,1,1,0,0,"MULTIPOLYGON(((12.91132222802393 65.94176119349721,12.907657206710804 65.98658954356436,13.01769767822031 65.98804625607697,13.021170264228461 65.94321485656529,12.91132222802393 65.94176119349721)))"
24100007315000,21,10,11,44.2,"MULTIPOLYGON(((13.021170264228461 65.94321485656529,13.01769767822031 65.98804625607697,13.127751571060863 65.98942432884277,13.131031647182716 65.9445900441894,13.021170264228461 65.94321485656529)))"
24150007315000,486,263,223,41,"MULTIPOLYGON(((13.131031647182716 65.9445900441894,13.127751571060863 65.98942432884277,13.237818142687262 65.99072374496608,13.240905638456315 65.94588673956225,13.131031647182716 65.9445900441894)))"
24200007315000,48,29,19,35,"MULTIPOLYGON(((13.240905638456315 65.94588673956225,13.237818142687262 65.99072374496608,13.347896650026552 65.991944488512,13.350791499096005 65.94710492683257,13.240905638456315 65.94588673956225)))"
24250007315000,56,29,27,49.2,"MULTIPOLYGON(((13.350791499096005 65.94710492683257,13.347896650026552 65.991944488512,13.457986349508769 65.99308654450746,13.460688489656125 65.94824459110575,13.350791499096005 65.94710492683257)))"
24400007315000,2,1,1,0,"MULTIPOLYGON(((13.680512900476215 65.95028829587014,13.678196348321995 65.99513453876769,13.78831515830558 65.99604045190137,13.790438839657838 65.95119231136206,13.680512900476215 65.95028829587014)))"
24450007315000,4,3,1,0,"MULTIPOLYGON(((13.790438839657838 65.95119231136206,13.78831515830558 65.99604045190137,13.89844218179909 65.99686762722376,13.900372946664474 65.95201775385958,13.790438839657838 65.95119231136206)))"
23700007320000,135,77,58,43.2,"MULTIPOLYGON(((12.137811952220977 65.97419226368875,12.132782977381853 66.01899421635534,12.242901294792702 66.02100506487157,12.24773773391285 65.97619890082066,12.137811952220977 65.97419226368875)))"
23750007320000,1102,574,528,41.4,"MULTIPOLYGON(((12.24773773391285 65.97619890082066,12.242901294792702 66.02100506487157,12.353038317998042 66.02293725462687,12.357682117403185 65.97812704330453,12.24773773391285 65.97619890082066)))"
23800007320000,21,14,7,60.8,"MULTIPOLYGON(((12.357682117403185 65.97812704330453,12.353038317998042 66.02293725462687,12.463193304900365 66.02479076190113,12.467644364697403 65.97997666754459,12.357682117403185 65.97812704330453)))"
23850007320000,1351,679,672,39.1,"MULTIPOLYGON(((12.467644364697403 65.97997666754459,12.463193304900365 66.02479076190113,12.573365512653863 66.02656556393325,12.57762373705957 65.98174775089909,12.467644364697403 65.97997666754459)))"
23900007320000,4826,2390,2436,43.6,"MULTIPOLYGON(((12.57762373705957 65.98174775089909,12.573365512653863 66.02656556393325,12.683554197695015 66.02826163892223,12.687619495042682 65.98344027168129,12.57762373705957 65.98174775089909)))"
24000007320000,40,25,15,48,"MULTIPOLYGON(((12.79763089851906 65.98505420916081,12.79375861577326 66.0298789660283,12.903978021981727 66.03141752537391,12.907657206710804 65.98658954356436,12.79763089851906 65.98505420916081)))"
24050007320000,107,47,60,42.9,"MULTIPOLYGON(((12.907657206710804 65.98658954356436,12.903978021981727 66.03141752537391,13.014211670788042 66.0328772980448,13.01769767822031 65.98804625607697,12.907657206710804 65.98658954356436)))"
24150007320000,2,1,1,0,"MULTIPOLYGON(((13.127751571060863 65.98942432884277,13.124458816065196 66.03425826609092,13.23471871112248 66.03556041252729,13.237818142687262 65.99072374496608,13.127751571060863 65.98942432884277)))"
24200007320000,92,49,43,48.1,"MULTIPOLYGON(((13.237818142687262 65.99072374496608,13.23471871112248 66.03556041252729,13.344990608736474 66.03678372133504,13.347896650026552 65.991944488512,13.237818142687262 65.99072374496608)))"
24250007320000,46,24,22,41.4,"MULTIPOLYGON(((13.347896650026552 65.991944488512,13.344990608736474 66.03678372133504,13.455273761182093 66.03792817746191,13.457986349508769 65.99308654450746,13.347896650026552 65.991944488512)))"
24300007320000,30,15,15,43.3,"MULTIPOLYGON(((13.457986349508769 65.99308654450746,13.455273761182093 66.03792817746191,13.565567420263687 66.03899376682337,13.568086497097749 65.99414989894184,13.457986349508769 65.99308654450746)))"
24350007320000,8,6,2,58,"MULTIPOLYGON(((13.568086497097749 65.99414989894184,13.565567420263687 66.03899376682337,13.67587083734619 66.03998047630297,13.678196348321995 65.99513453876769,13.568086497097749 65.99414989894184)))"
24450007320000,115,64,51,42.2,"MULTIPOLYGON(((13.78831515830558 65.99604045190137,13.786183263386311 66.0408882937533,13.896503948963778 66.04171720799643,13.89844218179909 65.99686762722376,13.78831515830558 65.99604045190137)))"
24500007320000,10,8,2,61.3,"MULTIPOLYGON(((13.89844218179909 65.99686762722376,13.896503948963778 66.04171720799643,14.006832144312604 66.04246720882458,14.00857667321062 65.99761605458069,13.89844218179909 65.99686762722376)))"
23600007325000,1,0,1,0,"MULTIPOLYGON(((11.912605424409183 66.01473664270803,11.907170779058118 66.05952918944426,12.01744251685527 66.06170183565419,12.022684107084194 66.01690473375604,11.912605424409183 66.01473664270803)))"
23700007325000,86,37,49,48.1,"MULTIPOLYGON(((12.132782977381853 66.01899421635534,12.127734555294664 66.0637957089952,12.23804614974826 66.0658107836976,12.242901294792702 66.02100506487157,12.132782977381853 66.01899421635534)))"
23750007325000,67,37,30,50.3,"MULTIPOLYGON(((12.242901294792702 66.02100506487157,12.23804614974826 66.0658107836976,12.348376554771203 66.06774703495336,12.353038317998042 66.02293725462687,12.242901294792702 66.02100506487157)))"
23800007325000,20,14,6,56.4,"MULTIPOLYGON(((12.353038317998042 66.02293725462687,12.348376554771203 66.06774703495336,12.458725024132535 66.0696044389171,12.463193304900365 66.02479076190113,12.353038317998042 66.02293725462687)))"
23850007325000,32,16,16,41.9,"MULTIPOLYGON(((12.463193304900365 66.02479076190113,12.458725024132535 66.0696044389171,12.569090810845992 66.0713829727075,12.573365512653863 66.02656556393325,12.463193304900365 66.02479076190113)))"
23900007325000,18,9,9,46.8,"MULTIPOLYGON(((12.573365512653863 66.02656556393325,12.569090810845992 66.0713829727075,12.679473167200868 66.07308261440843,12.683554197695015 66.02826163892223,12.573365512653863 66.02656556393325)))"
23950007325000,494,261,233,41.4,"MULTIPOLYGON(((12.683554197695015 66.02826163892223,12.679473167200868 66.07308261440843,12.789871344792985 66.07470334306997,12.79375861577326 66.0298789660283,12.683554197695015 66.02826163892223)))"
24000007325000,178,91,87,47.2,"MULTIPOLYGON(((12.79375861577326 66.0298789660283,12.789871344792985 66.07470334306997,12.900284594555695 66.0762451387095,12.903978021981727 66.03141752537391,12.79375861577326 66.0298789660283)))"
24050007325000,931,459,472,40,"MULTIPOLYGON(((12.903978021981727 66.03141752537391,12.900284594555695 66.0762451387095,13.01071216679098 66.07770798231277,13.014211670788042 66.0328772980448,12.903978021981727 66.03141752537391)))"
24100007325000,57,29,28,39.8,"MULTIPOLYGON(((13.014211670788042 66.0328772980448,13.01071216679098 66.07770798231277,13.121153311200613 66.07909185583486,13.124458816065196 66.03425826609092,13.014211670788042 66.0328772980448)))"
24200007325000,16,10,6,38.1,"MULTIPOLYGON(((13.23471871112248 66.03556041252729,13.231607276917376 66.0803967422009,13.342073312536343 66.08162262530729,13.344990608736474 66.03678372133504,13.23471871112248 66.03556041252729)))"
24250007325000,114,58,56,45.3,"MULTIPOLYGON(((13.344990608736474 66.03678372133504,13.342073312536343 66.08162262530729,13.452550666146205 66.08276949002214,13.455273761182093 66.03792817746191,13.344990608736474 66.03678372133504)))"
24300007325000,78,40,38,44.3,"MULTIPOLYGON(((13.455273761182093 66.03792817746191,13.452550666146205 66.08276949002214,13.56303858536068 66.08383732218633,13.565567420263687 66.03899376682337,13.455273761182093 66.03792817746191)))"
24350007325000,20,8,12,47.6,"MULTIPOLYGON(((13.565567420263687 66.03899376682337,13.56303858536068 66.08383732218633,13.673536317349935 66.08482610861404,13.67587083734619 66.03998047630297,13.565567420263687 66.03899376682337)))"
24400007325000,6,3,3,48.8,"MULTIPOLYGON(((13.67587083734619 66.03998047630297,13.673536317349935 66.08482610861404,13.784043108872083 66.08573583709352,13.786183263386311 66.0408882937533,13.67587083734619 66.03998047630297)))"
24450007325000,1106,561,545,44.6,"MULTIPOLYGON(((13.786183263386311 66.0408882937533,13.784043108872083 66.08573583709352,13.894558206304707 66.08656649638768,13.896503948963778 66.04171720799643,13.786183263386311 66.0408882937533)))"
24500007325000,43,21,22,44.5,"MULTIPOLYGON(((13.896503948963778 66.04171720799643,13.894558206304707 66.08656649638768,14.005080855676436 66.08731807623462,14.006832144312604 66.04246720882458,13.896503948963778 66.04171720799643)))"
24550007325000,44,23,21,43,"MULTIPOLYGON(((14.006832144312604 66.04246720882458,14.005080855676436 66.08731807623462,14.11561030269854 66.08799056734826,14.117167099352407 66.04313828700049,14.006832144312604 66.04246720882458)))"
23800007330000,89,44,45,42.6,"MULTIPOLYGON(((12.348376554771203 66.06774703495336,12.343696727080088 66.11255638371146,12.45423942589184 66.11441769809689,12.458725024132535 66.0696044389171,12.348376554771203 66.06774703495336)))"
23850007330000,364,191,173,40,"MULTIPOLYGON(((12.458725024132535 66.0696044389171,12.45423942589184 66.11441769809689,12.564799539281115 66.11619997679995,12.569090810845992 66.0713829727075,12.458725024132535 66.0696044389171)))"
23900007330000,175,91,84,43.3,"MULTIPOLYGON(((12.569090810845992 66.0713829727075,12.564799539281115 66.11619997679995,12.675376315359074 66.1179031977885,12.679473167200868 66.07308261440843,12.569090810845992 66.0713829727075)))"
23950007330000,22,10,12,53.4,"MULTIPOLYGON(((12.679473167200868 66.07308261440843,12.675376315359074 66.1179031977885,12.78596900153689 66.11952734000165,12.789871344792985 66.07470334306997,12.679473167200868 66.07308261440843)))"
24000007330000,9,6,3,53.8,"MULTIPOLYGON(((12.789871344792985 66.07470334306997,12.78596900153689 66.11952734000165,12.896576844557048 66.12107238335103,12.900284594555695 66.0762451387095,12.789871344792985 66.07470334306997)))"
24050007330000,45,19,26,30,"MULTIPOLYGON(((12.900284594555695 66.0762451387095,12.896576844557048 66.12107238335103,13.007199090524736 66.1225383087216,13.01071216679098 66.07770798231277,12.900284594555695 66.0762451387095)))"
24100007330000,114,57,57,44.1,"MULTIPOLYGON(((13.01071216679098 66.07770798231277,13.007199090524736 66.1225383087216,13.11783498493928 66.12392509797282,13.121153311200613 66.07909185583486,13.01071216679098 66.07770798231277)))"
24300007330000,68,35,33,47.9,"MULTIPOLYGON(((13.452550666146205 66.08276949002214,13.44981700543178 66.12761048223936,13.560499937614214 66.12868056512647,13.56303858536068 66.08383732218633,13.452550666146205 66.08276949002214)))"
24350007330000,6,2,4,42.7,"MULTIPOLYGON(((13.56303858536068 66.08383732218633,13.560499937614214 66.12868056512647,13.671192737757364 66.12967143583782,13.673536317349935 66.08482610861404,13.56303858536068 66.08383732218633)))"
24450007330000,168,86,82,44.3,"MULTIPOLYGON(((13.784043108872083 66.08573583709352,13.781894648389216 66.13058308209689,13.892604911653638 66.131415492607,13.894558206304707 66.08656649638768,13.784043108872083 66.08573583709352)))"
23750007335000,10,6,4,70.1,"MULTIPOLYGON(((12.233172194003451 66.11061605664612,12.228279321996071 66.15542088305737,12.338998733526784 66.15736530032221,12.343696727080088 66.11255638371146,12.233172194003451 66.11061605664612)))"
23800007335000,5,3,2,49.6,"MULTIPOLYGON(((12.343696727080088 66.11255638371146,12.338998733526784 66.15736530032221,12.449736412951752 66.159230538939,12.45423942589184 66.11441769809689,12.343696727080088 66.11255638371146)))"
23850007335000,66,34,32,51.4,"MULTIPOLYGON(((12.45423942589184 66.11441769809689,12.449736412951752 66.159230538939,12.560491604910883 66.16101657578332,12.564799539281115 66.11619997679995,12.45423942589184 66.11441769809689)))"
23900007335000,104,52,52,54.2,"MULTIPOLYGON(((12.564799539281115 66.11619997679995,12.560491604910883 66.16101657578332,12.671263553305973 66.16272338870615,12.675376315359074 66.1179031977885,12.564799539281115 66.11619997679995)))"
23950007335000,73,36,37,44.6,"MULTIPOLYGON(((12.675376315359074 66.1179031977885,12.671263553305973 66.16272338870615,12.782051501332232 66.16435095653486,12.78596900153689 66.11952734000165,12.675376315359074 66.1179031977885)))"
24000007335000,32,19,13,58,"MULTIPOLYGON(((12.78596900153689 66.11952734000165,12.782051501332232 66.16435095653486,12.892854691509898 66.1658992590745,12.896576844557048 66.12107238335103,12.78596900153689 66.11952734000165)))"
24050007335000,5,3,2,64.6,"MULTIPOLYGON(((12.896576844557048 66.12107238335103,12.892854691509898 66.1658992590745,13.003672365715907 66.16736827710852,13.007199090524736 66.1225383087216,12.896576844557048 66.12107238335103)))"
24100007335000,76,40,36,38.4,"MULTIPOLYGON(((13.007199090524736 66.1225383087216,13.003672365715907 66.16736827710852,13.114503765215636 66.16875799240005,13.11783498493928 66.12392509797282,13.007199090524736 66.1225383087216)))"
24150007335000,5,2,3,54.2,"MULTIPOLYGON(((13.11783498493928 66.12392509797282,13.114503765215636 66.16875799240005,13.22534813069471 66.17006838769264,13.228483772725678 66.1252327339394,13.11783498493928 66.12392509797282)))"
24350007335000,4,4,0,0,"MULTIPOLYGON(((13.560499937614214 66.12868056512647,13.557951421837707 66.17352349573801,13.668840047612074 66.17451645811008,13.671192737757364 66.12967143583782,13.560499937614214 66.12868056512647)))"
24400007335000,9,3,6,24.9,"MULTIPOLYGON(((13.671192737757364 66.12967143583782,13.668840047612074 66.17451645811008,13.779737835215064 66.1754300289374,13.781894648389216 66.13058308209689,13.671192737757364 66.12967143583782)))"
24450007335000,672,346,326,41.7,"MULTIPOLYGON(((13.781894648389216 66.13058308209689,13.779737835215064 66.1754300289374,13.890644022524976 66.17626419686322,13.892604911653638 66.131415492607,13.781894648389216 66.13058308209689)))"
24500007335000,44,22,22,46.1,"MULTIPOLYGON(((13.892604911653638 66.131415492607,13.890644022524976 66.17626419686322,14.001557847064536 66.17701895151633,14.003322769342267 66.13216865705175,13.892604911653638 66.131415492607)))"
24550007335000,11,5,6,42.2,"MULTIPOLYGON(((14.003322769342267 66.13216865705175,14.001557847064536 66.17701895151633,14.112478546033117 66.17769428351174,14.11404746292639 66.13284256609579,14.003322769342267 66.13216865705175)))"
24800007335000,3,2,1,0,"MULTIPOLYGON(((14.556999416221096 66.13474549591399,14.556214820673539 66.17960123175486,14.667158440718413 66.17987934423111,14.667746902377408 66.135023022286,14.556999416221096 66.13474549591399)))"
23750007340000,3,1,2,0,"MULTIPOLYGON(((12.228279321996071 66.15542088305737,12.223367427370416 66.2002252622645,12.334282471950962 66.20217378420007,12.338998733526784 66.15736530032221,12.228279321996071 66.15542088305737)))"
23800007340000,15,8,7,50.6,"MULTIPOLYGON(((12.338998733526784 66.15736530032221,12.334282471950962 66.20217378420007,12.445215887354479 66.20404296093601,12.449736412951752 66.159230538939,12.338998733526784 66.15736530032221)))"
23850007340000,110,54,56,50.9,"MULTIPOLYGON(((12.449736412951752 66.159230538939,12.445215887354479 66.20404296093601,12.556166913986928 66.20583276922503,12.560491604910883 66.16101657578332,12.449736412951752 66.159230538939)))"
23900007340000,184,93,91,41.9,"MULTIPOLYGON(((12.560491604910883 66.16101657578332,12.556166913986928 66.20583276922503,12.6671347915092 66.20754318680036,12.671263553305973 66.16272338870615,12.560491604910883 66.16101657578332)))"
23950007340000,27,15,12,52,"MULTIPOLYGON(((12.671263553305973 66.16272338870615,12.6671347915092 66.20754318680036,12.778118758868947 66.20917419237685,12.782051501332232 66.16435095653486,12.671263553305973 66.16272338870615)))"
24000007340000,6,4,2,56.2,"MULTIPOLYGON(((12.782051501332232 66.16435095653486,12.778118758868947 66.20917419237685,12.889118054332478 66.21072576565211,12.892854691509898 66.1658992590745,12.782051501332232 66.16435095653486)))"
24050007340000,57,29,28,57.3,"MULTIPOLYGON(((12.892854691509898 66.1658992590745,12.889118054332478 66.21072576565211,13.000131915516732 66.2121978873074,13.003672365715907 66.16736827710852,12.892854691509898 66.1658992590745)))"
24100007340000,1421,736,685,41.9,"MULTIPOLYGON(((13.003672365715907 66.16736827710852,13.000131915516732 66.2121978873074,13.11115957942133 66.21359053900879,13.114503765215636 66.16875799240005,13.003672365715907 66.16736827710852)))"
24150007340000,10,5,5,48.9,"MULTIPOLYGON(((13.114503765215636 66.16875799240005,13.11115957942133 66.21359053900879,13.222200282460657 66.21490370340803,13.22534813069471 66.17006838769264,13.114503765215636 66.16875799240005)))"
24200007340000,11,7,4,55.9,"MULTIPOLYGON(((13.22534813069471 66.17006838769264,13.222200282460657 66.21490370340803,13.33325326049606 66.21613736414345,13.33620470229088 66.17129944671125,13.22534813069471 66.17006838769264)))"
24250007340000,89,49,40,48.5,"MULTIPOLYGON(((13.33620470229088 66.17129944671125,13.33325326049606 66.21613736414345,13.444317748868057 66.2172915058407,13.447072719625938 66.172451154163,13.33620470229088 66.17129944671125)))"
24300007340000,2,1,1,0,"MULTIPOLYGON(((13.447072719625938 66.172451154163,13.444317748868057 66.2172915058407,13.555392982428627 66.21836611411372,13.557951421837707 66.17352349573801,13.447072719625938 66.172451154163)))"
24350007340000,47,29,18,51.5,"MULTIPOLYGON(((13.557951421837707 66.17352349573801,13.555392982428627 66.21836611411372,13.666478195573536 66.2193611755654,13.668840047612074 66.17451645811008,13.557951421837707 66.17352349573801)))"
24400007340000,40,20,20,44.3,"MULTIPOLYGON(((13.668840047612074 66.17451645811008,13.666478195573536 66.2193611755654,13.777572622274732 66.22027667778812,13.779737835215064 66.1754300289374,13.668840047612074 66.17451645811008)))"
24450007340000,386,200,186,40.3,"MULTIPOLYGON(((13.779737835215064 66.1754300289374,13.777572622274732 66.22027667778812,13.888675496112766 66.22111260936465,13.890644022524976 66.17626419686322,13.779737835215064 66.1754300289374)))"
23900007345000,87,43,44,57.1,"MULTIPOLYGON(((12.556166913986928 66.20583276922503,12.551825372054275 66.25064855668691,12.662989939761397 66.25236259170508,12.6671347915092 66.20754318680036,12.556166913986928 66.20583276922503)))"
23950007345000,75,40,35,39.2,"MULTIPOLYGON(((12.6671347915092 66.20754318680036,12.662989939761397 66.25236259170508,12.77417068819365 66.25399704723034,12.778118758868947 66.20917419237685,12.6671347915092 66.20754318680036)))"
24000007345000,29,11,18,48.4,"MULTIPOLYGON(((12.778118758868947 66.20917419237685,12.77417068819365 66.25399704723034,12.885366851331442 66.25555190285209,12.889118054332478 66.21072576565211,12.778118758868947 66.20917419237685)))"
24050007345000,23,13,10,47.4,"MULTIPOLYGON(((12.889118054332478 66.21072576565211,12.885366851331442 66.25555190285209,12.99657766249968 66.25702713914865,13.000131915516732 66.2121978873074,12.889118054332478 66.21072576565211)))"
24100007345000,54,33,21,54.3,"MULTIPOLYGON(((13.000131915516732 66.2121978873074,12.99657766249968 66.25702713914865,13.10780235440011 66.2584227376883,13.11115957942133 66.21359053900879,13.000131915516732 66.2121978873074)))"
24150007345000,48,27,21,52.7,"MULTIPOLYGON(((13.11115957942133 66.21359053900879,13.10780235440011 66.2584227376883,13.21904015914372 66.25973868103034,13.222200282460657 66.21490370340803,13.11115957942133 66.21359053900879)))"
24250007345000,16,9,7,51.7,"MULTIPOLYGON(((13.33325326049606 66.21613736414345,13.330290308283221 66.26097495272573,13.441552032845573 66.26213153731823,13.444317748868057 66.2172915058407,13.33325326049606 66.21613736414345)))"
24300007345000,2,1,1,0,"MULTIPOLYGON(((13.444317748868057 66.2172915058407,13.441552032845573 66.26213153731823,13.552824563364567 66.26320842034494,13.555392982428627 66.21836611411372,13.444317748868057 66.2172915058407)))"
24350007345000,1342,669,673,43.9,"MULTIPOLYGON(((13.555392982428627 66.21836611411372,13.552824563364567 66.26320842034494,13.664107129913475 66.26420558833719,13.666478195573536 66.2193611755654,13.555392982428627 66.21836611411372)))"
24400007345000,32,18,14,42.7,"MULTIPOLYGON(((13.666478195573536 66.2193611755654,13.664107129913475 66.26420558833719,13.775398962137738 66.26512302882125,13.777572622274732 66.22027667778812,13.666478195573536 66.2193611755654)))"
24450007345000,11,5,6,55.4,"MULTIPOLYGON(((13.777572622274732 66.22027667778812,13.775398962137738 66.26512302882125,13.88669928928769 66.26596073031888,13.888675496112766 66.22111260936465,13.777572622274732 66.22027667778812)))"
24500007345000,440,230,210,43.3,"MULTIPOLYGON(((13.888675496112766 66.22111260936465,13.88669928928769 66.26596073031888,13.998007340251341 66.26671868234797,13.999786050309265 66.22186895986854,13.888675496112766 66.22111260936465)))"
24550007345000,229,117,112,38.9,"MULTIPOLYGON(((13.999786050309265 66.22186895986854,13.998007340251341 66.26671868234797,14.109322343587198 66.26739687542306,14.110903517759436 66.2225457198647,13.999786050309265 66.22186895986854)))"
24800007345000,8,5,3,54.3,"MULTIPOLYGON(((14.555427168399602 66.22445670079502,14.554636442130413 66.2693119033839,14.665974626473242 66.26959119432203,14.666567686401267 66.22473540145602,14.555427168399602 66.22445670079502)))"
23950007350000,6,3,3,38.8,"MULTIPOLYGON(((12.662989939761397 66.25236259170508,12.65882890717383 66.29718160304935,12.770207202703554 66.29881952079367,12.77417068819365 66.25399704723034,12.662989939761397 66.25236259170508)))"
24000007350000,8,4,4,66.5,"MULTIPOLYGON(((12.77417068819365 66.25399704723034,12.770207202703554 66.29881952079367,12.881601000196095 66.30037767043873,12.885366851331442 66.25555190285209,12.77417068819365 66.25399704723034)))"
24050007350000,4,2,2,0,"MULTIPOLYGON(((12.885366851331442 66.25555190285209,12.881601000196095 66.30037767043873,12.993009528651976 66.30185603245917,12.99657766249968 66.25702713914865,12.885366851331442 66.25555190285209)))"
24100007350000,11,6,5,64.5,"MULTIPOLYGON(((12.99657766249968 66.25702713914865,12.993009528651976 66.30185603245917,13.104432016442663 66.30325458832479,13.10780235440011 66.2584227376883,12.99657766249968 66.25702713914865)))"
24150007350000,40,25,15,42.1,"MULTIPOLYGON(((13.10780235440011 66.2584227376883,13.104432016442663 66.30325458832479,13.215867691343268 66.30457332050166,13.21904015914372 66.25973868103034,13.10780235440011 66.2584227376883)))"
24250007350000,5,3,2,72.8,"MULTIPOLYGON(((13.330290308283221 66.26097495272573,13.327315780565339 66.30581221245286,13.438775510789686 66.30697124863946,13.441552032845573 66.26213153731823,13.330290308283221 66.26097495272573)))"
24300007350000,147,76,71,42.8,"MULTIPOLYGON(((13.441552032845573 66.26213153731823,13.438775510789686 66.30697124863946,13.550246108199282 66.30805041452129,13.552824563364567 66.26320842034494,13.441552032845573 66.26213153731823)))"
24350007350000,329,165,164,43.7,"MULTIPOLYGON(((13.552824563364567 66.26320842034494,13.550246108199282 66.30805041452129,13.661726798512213 66.30904969655766,13.664107129913475 66.26420558833719,13.552824563364567 66.26320842034494)))"
24400007350000,129,70,59,43.9,"MULTIPOLYGON(((13.664107129913475 66.26420558833719,13.661726798512213 66.30904969655766,13.773216807014668 66.30996908220807,13.775398962137738 66.26512302882125,13.664107129913475 66.26420558833719)))"
24450007350000,52,26,26,45,"MULTIPOLYGON(((13.775398962137738 66.26512302882125,13.773216807014668 66.30996908220807,13.884715358593994 66.31080855993288,13.88669928928769 66.26596073031888,13.775398962137738 66.26512302882125)))"
24500007350000,172,90,82,41.3,"MULTIPOLYGON(((13.88669928928769 66.26596073031888,13.884715358593994 66.31080855993288,13.99622167777177 66.31156811919392,13.998007340251341 66.26671868234797,13.88669928928769 66.26596073031888)))"
24550007350000,2340,1203,1137,39.7,"MULTIPOLYGON(((13.998007340251341 66.26671868234797,13.99622167777177 66.31156811919392,14.107734988736947 66.31224775045501,14.109322343587198 66.26739687542306,13.998007340251341 66.26671868234797)))"
24600007350000,3406,1690,1716,49.6,"MULTIPOLYGON(((14.109322343587198 66.26739687542306,14.107734988736947 66.31224775045501,14.219254515379 66.31284744518237,14.220643527557103 66.26799530105588,14.109322343587198 66.26739687542306)))"
24650007350000,744,381,363,38,"MULTIPOLYGON(((14.220643527557103 66.26799530105588,14.219254515379 66.31284744518237,14.330779481321123 66.31336719584529,14.331970120159125 66.26851395175572,14.220643527557103 66.26799530105588)))"
24700007350000,70,34,36,35.5,"MULTIPOLYGON(((14.331970120159125 66.26851395175572,14.330779481321123 66.31336719584529,14.442309109953458 66.31380699591624,14.443301349160473 66.26895282102987,14.331970120159125 66.26851395175572)))"
24800007350000,1,1,0,0,"MULTIPOLYGON(((14.554636442130413 66.2693119033839,14.55384262446633 66.31416683987142,14.66537924788353 66.31444672319094,14.665974626473242 66.26959119432203,14.554636442130413 66.2693119033839)))"
24850007350000,6,3,3,52.3,"MULTIPOLYGON(((14.665974626473242 66.26959119432203,14.66537924788353 66.31444672319094,14.776918203095592 66.31464664235912,14.777315129461263 66.26979069034726,14.665974626473242 66.26959119432203)))"
24900007350000,26,15,11,47.9,"MULTIPOLYGON(((14.777315129461263 66.26979069034726,14.776918203095592 66.31464664235912,14.888458712893097 66.3147665948646,14.888657178267753 66.26991038896162,14.777315129461263 66.26979069034726)))"
24100007355000,57,26,31,52.8,"MULTIPOLYGON(((12.993009528651976 66.30185603245917,12.989427435370073 66.3466845670624,13.101048491281365 66.3480860908014,13.104432016442663 66.30325458832479,12.993009528651976 66.30185603245917)))"
24150007355000,18,11,7,45.1,"MULTIPOLYGON(((13.104432016442663 66.30325458832479,13.101048491281365 66.3480860908014,13.212682809132895 66.34940762176149,13.215867691343268 66.30457332050166,13.104432016442663 66.30325458832479)))"
24250007355000,24,14,10,57.9,"MULTIPOLYGON(((13.327315780565339 66.30581221245286,13.324329611762206 66.35064914331724,13.435988121471068 66.35181063984645,13.438775510789686 66.30697124863946,13.327315780565339 66.30581221245286)))"
24300007355000,58,29,29,53.2,"MULTIPOLYGON(((13.438775510789686 66.30697124863946,13.435988121471068 66.35181063984645,13.547657560058683 66.35289209673104,13.550246108199282 66.30805041452129,13.438775510789686 66.30697124863946)))"
24350007355000,12,7,5,37.1,"MULTIPOLYGON(((13.550246108199282 66.30805041452129,13.547657560058683 66.35289209673104,13.659337148854949 66.35389350035776,13.661726798512213 66.30904969655766,13.550246108199282 66.30805041452129)))"
24500007355000,85,43,42,45.7,"MULTIPOLYGON(((13.884715358593994 66.31080855993288,13.882723660246404 66.35565609841296,13.994429023454884 66.35641727064531,13.99622167777177 66.31156811919392,13.884715358593994 66.31080855993288)))"
24550007355000,1556,779,777,38.8,"MULTIPOLYGON(((13.99622167777177 66.31156811919392,13.994429023454884 66.35641727064531,14.106141418165441 66.35709834522852,14.107734988736947 66.31224775045501,13.99622167777177 66.31156811919392)))"
24600007355000,12018,6119,5899,42.1,"MULTIPOLYGON(((14.107734988736947 66.31224775045501,14.106141418165441 66.35709834522852,14.217860063861982 66.3576993135832,14.219254515379 66.31284744518237,14.107734988736947 66.31224775045501)))"
24650007355000,1835,927,908,43.2,"MULTIPOLYGON(((14.219254515379 66.31284744518237,14.217860063861982 66.3576993135832,14.329584179759609 66.35822016813812,14.330779481321123 66.31336719584529,14.219254515379 66.31284744518237)))"
24700007355000,497,255,242,39.3,"MULTIPOLYGON(((14.330779481321123 66.31336719584529,14.329584179759609 66.35822016813812,14.441312984838145 66.35866090233081,14.442309109953458 66.31380699591624,14.330779481321123 66.31336719584529)))"
24750007355000,64,35,29,39.4,"MULTIPOLYGON(((14.442309109953458 66.31380699591624,14.441312984838145 66.35866090233081,14.553045697875712 66.35902151060783,14.55384262446633 66.31416683987142,14.442309109953458 66.31380699591624)))"
24800007355000,60,29,31,40.3,"MULTIPOLYGON(((14.55384262446633 66.31416683987142,14.553045697875712 66.35902151060783,14.664781537482298 66.35930198842506,14.66537924788353 66.31444672319094,14.55384262446633 66.31416683987142)))"
24850007355000,47,27,20,35.3,"MULTIPOLYGON(((14.66537924788353 66.31444672319094,14.664781537482298 66.35930198842506,14.77651972213337 66.35950233224791,14.776918203095592 66.31464664235912,14.66537924788353 66.31444672319094)))"
24900007355000,27,14,13,35.7,"MULTIPOLYGON(((14.776918203095592 66.31464664235912,14.77651972213337 66.35950233224791,14.888259470203504 66.35962253955161,14.888458712893097 66.3147665948646,14.776918203095592 66.31464664235912)))"
23750007360000,1,1,0,0,"MULTIPOLYGON(((12.20851653216692 66.33463570988378,12.203527467378162 66.37943829346028,12.315232675127334 66.38140338043905,12.32002304589761 66.33659663348132,12.20851653216692 66.33463570988378)))"
23800007360000,516,273,243,34.2,"MULTIPOLYGON(((12.32002304589761 66.33659663348132,12.315232675127334 66.38140338043905,12.426956673256333 66.38328845011151,12.43154824392779 66.33847770869097,12.32002304589761 66.33659663348132)))"
23900007360000,289,144,145,51.9,"MULTIPOLYGON(((12.5430913537699 66.34027891189129,12.538698684914872 66.38509347872977,12.650457932478977 66.38681844354737,12.654651602169968 66.34200022045715,12.5430913537699 66.34027891189129)))"
24000007360000,5,3,2,17.4,"MULTIPOLYGON(((12.766228215140362 66.34364161276065,12.762233637584028 66.38846332282051,12.874025021157884 66.39002809580913,12.877820417992565 66.34520306817235,12.766228215140362 66.34364161276065)))"
24100007360000,23,11,12,50.2,"MULTIPOLYGON(((12.989427435370073 66.3466845670624,12.98583130345406 66.39151274277809,13.097651704085004 66.39291724499805,13.101048491281365 66.3480860908014,12.989427435370073 66.3466845670624)))"
24150007360000,74,35,39,57.6,"MULTIPOLYGON(((13.101048491281365 66.3480860908014,13.097651704085004 66.39291724499805,13.209485442055444 66.39424158474658,13.212682809132895 66.34940762176149,13.101048491281365 66.3480860908014)))"
24550007360000,26,16,10,41.5,"MULTIPOLYGON(((13.994429023454884 66.35641727064531,13.992629337585536 66.40126613694049,14.104541596563145 66.40194866001143,14.106141418165441 66.35709834522852,13.994429023454884 66.35641727064531)))"
24600007360000,11,8,3,41.2,"MULTIPOLYGON(((14.106141418165441 66.35709834522852,14.104541596563145 66.40194866001143,14.216460142104665 66.40255090655201,14.217860063861982 66.3576993135832,14.106141418165441 66.35709834522852)))"
24650007360000,109,56,53,44.3,"MULTIPOLYGON(((14.217860063861982 66.3576993135832,14.216460142104665 66.40255090655201,14.328384188983561 66.40307286895037,14.329584179759609 66.35822016813812,14.217860063861982 66.3576993135832)))"
24700007360000,286,149,137,36.6,"MULTIPOLYGON(((14.329584179759609 66.35822016813812,14.328384188983561 66.40307286895037,14.440312951735784 66.40351454060878,14.441312984838145 66.35866090233081,14.329584179759609 66.35822016813812)))"
24750007360000,255,121,134,42.4,"MULTIPOLYGON(((14.441312984838145 66.35866090233081,14.440312951735784 66.40351454060878,14.552245644693652 66.4038759159439,14.553045697875712 66.35902151060783,14.441312984838145 66.35866090233081)))"
24800007360000,133,66,67,36.7,"MULTIPOLYGON(((14.553045697875712 66.35902151060783,14.552245644693652 66.4038759159439,14.664181482019753 66.40415699038721,14.664781537482298 66.35930198842506,14.553045697875712 66.35902151060783)))"
24850007360000,27,14,13,38.1,"MULTIPOLYGON(((14.664781537482298 66.35930198842506,14.664181482019753 66.40415699038721,14.776119677740883 66.40435776038514,14.77651972213337 66.35950233224791,14.664781537482298 66.35930198842506)))"
24000007365000,341,172,169,47.6,"MULTIPOLYGON(((12.762233637584028 66.38846332282051,12.758223381446504 66.43328465065797,12.870214725494035 66.43485275310127,12.874025021157884 66.39002809580913,12.762233637584028 66.38846332282051)))"
24050007365000,36,20,16,46.8,"MULTIPOLYGON(((12.874025021157884 66.39002809580913,12.870214725494035 66.43485275310127,12.982221053101979 66.4363405594225,12.98583130345406 66.39151274277809,12.874025021157884 66.39002809580913)))"
24100007365000,4,3,1,0,"MULTIPOLYGON(((12.98583130345406 66.39151274277809,12.982221053101979 66.4363405594225,13.09424157945343 66.43774805079165,13.097651704085004 66.39291724499805,12.98583130345406 66.39151274277809)))"
24150007365000,76,43,33,51.6,"MULTIPOLYGON(((13.097651704085004 66.39291724499805,13.09424157945343 66.43774805079165,13.206275519117964 66.43907520939102,13.209485442055444 66.39424158474658,13.097651704085004 66.39291724499805)))"
24450007365000,3,3,0,0,"MULTIPOLYGON(((13.768826818837509 66.39966029672316,13.766618888379114 66.44450545818931,13.878716783782062 66.4453503027933,13.880724150127003 66.40050334596478,13.768826818837509 66.39966029672316)))"
24500007365000,13,8,5,55.2,"MULTIPOLYGON(((13.880724150127003 66.40050334596478,13.878716783782062 66.4453503027933,13.990822580146245 66.44611471831755,13.992629337585536 66.40126613694049,13.880724150127003 66.40050334596478)))"
24550007365000,6,3,3,59.2,"MULTIPOLYGON(((13.992629337585536 66.40126613694049,13.990822580146245 66.44611471831755,14.10293548835171 66.4467986950713,14.104541596563145 66.40194866001143,13.992629337585536 66.40126613694049)))"
24600007365000,4,2,2,0,"MULTIPOLYGON(((14.104541596563145 66.40194866001143,14.10293548835171 66.4467986950713,14.215054718970388 66.44740222438254,14.216460142104665 66.40255090655201,14.104541596563145 66.40194866001143)))"
24650007365000,43,26,17,39.7,"MULTIPOLYGON(((14.216460142104665 66.40255090655201,14.215054718970388 66.44740222438254,14.327179482300252 66.4479252985984,14.328384188983561 66.40307286895037,14.216460142104665 66.40255090655201)))"
24750007365000,455,239,216,38,"MULTIPOLYGON(((14.440312951735784 66.40351454060878,14.439308988399494 66.44836791108563,14.551442447120724 66.4487300562308,14.552245644693652 66.4038759159439,14.440312951735784 66.40351454060878)))"
24800007365000,19,9,10,45,"MULTIPOLYGON(((14.552245644693652 66.4038759159439,14.551442447120724 66.4487300562308,14.663579068145213 66.44901172944077,14.664181482019753 66.40415699038721,14.552245644693652 66.4038759159439)))"
24850007365000,2,1,1,0,"MULTIPOLYGON(((14.664181482019753 66.40415699038721,14.663579068145213 66.44901172944077,14.775718061017127 66.44921292714285,14.776119677740883 66.40435776038514,14.664181482019753 66.40415699038721)))"
24900007365000,27,17,10,49.7,"MULTIPOLYGON(((14.776119677740883 66.40435776038514,14.775718061017127 66.44921292714285,14.887858635177796 66.44933364678496,14.888059445781957 66.40447822339928,14.776119677740883 66.40435776038514)))"
25050007365000,7,3,4,67.4,"MULTIPOLYGON(((15.111940554218009 66.40447822339928,15.11214136482217 66.44933364678496,15.224281938982838 66.44921292714285,15.223880322259083 66.40435776038514,15.111940554218009 66.40447822339928)))"
24000007370000,3,2,1,0,"MULTIPOLYGON(((12.758223381446504 66.43328465065797,12.754197357465378 66.478105595953,12.866389446161914 66.47967703979671,12.870214725494035 66.43485275310127,12.758223381446504 66.43328465065797)))"
24050007370000,2,1,1,0,"MULTIPOLYGON(((12.870214725494035 66.43485275310127,12.866389446161914 66.47967703979671,12.978596603904137 66.48116801680814,12.982221053101979 66.4363405594225,12.870214725494035 66.43485275310127)))"
24150007370000,40,22,18,53.1,"MULTIPOLYGON(((13.09424157945343 66.43774805079165,13.090818041412135 66.48257850805584,13.203052968786626 66.48390849562605,13.206275519117964 66.43907520939102,13.09424157945343 66.43774805079165)))"
24200007370000,47,23,24,48.7,"MULTIPOLYGON(((13.206275519117964 66.43907520939102,13.203052968786626 66.48390849562605,13.31530059554298 66.48515796262367,13.318322086085356 66.440322018416,13.206275519117964 66.43907520939102)))"
24450007370000,5,3,2,76.8,"MULTIPOLYGON(((13.766618888379114 66.44450545818931,13.76440226811904 66.48935032268479,13.876701516418848 66.49019696910273,13.878716783782062 66.4453503027933,13.766618888379114 66.44450545818931)))"
24500007370000,6,4,2,39,"MULTIPOLYGON(((13.878716783782062 66.4453503027933,13.876701516418848 66.49019696910273,13.989008710814321 66.49096301501397,13.990822580146245 66.44611471831755,13.878716783782062 66.4453503027933)))"
24650007370000,39,21,18,39,"MULTIPOLYGON(((14.215054718970388 66.44740222438254,14.21364376308496 66.49225326736843,14.325970032813304 66.49277745739866,14.327179482300252 66.4479252985984,14.215054718970388 66.44740222438254)))"
24900007370000,26,13,13,39.2,"MULTIPOLYGON(((14.775718061017127 66.44921292714285,14.775314862993188 66.49406783289368,14.887657033906398 66.4941888100865,14.887858635177796 66.44933364678496,14.775718061017127 66.44921292714285)))"
25000007370000,2,1,1,0,"MULTIPOLYGON(((14.999999999999982 66.44937388683582,14.999999999999982 66.4942291359885,15.112342966093568 66.4941888100865,15.11214136482217 66.44933364678496,14.999999999999982 66.44937388683582)))"
25050007370000,1,1,0,0,"MULTIPOLYGON(((15.11214136482217 66.44933364678496,15.112342966093568 66.4941888100865,15.224685137006778 66.49406783289368,15.224281938982838 66.44921292714285,15.11214136482217 66.44933364678496)))"
23650007375000,1,1,0,0,"MULTIPOLYGON(((11.969340823651294 66.46485422121077,11.963890997150102 66.5096465224622,12.076156366792892 66.51178516813559,12.081405388333547 66.46698831753781,11.969340823651294 66.46485422121077)))"
23700007375000,386,207,179,40.8,"MULTIPOLYGON(((12.081405388333547 66.46698831753781,12.076156366792892 66.51178516813559,12.188442427678611 66.51384333744774,12.193490526834113 66.46904210795738,12.081405388333547 66.46698831753781)))"
24000007375000,3,2,1,0,"MULTIPOLYGON(((12.754197357465378 66.478105595953,12.750155475697461 66.52292615838094,12.862549097675213 66.52450095563933,12.866389446161914 66.47967703979671,12.754197357465378 66.478105595953)))"
24050007375000,75,37,38,33.7,"MULTIPOLYGON(((12.866389446161914 66.47967703979671,12.862549097675213 66.52450095563933,12.974957874837285 66.52599511474389,12.978596603904137 66.48116801680814,12.866389446161914 66.47967703979671)))"
24100007375000,132,66,66,49.2,"MULTIPOLYGON(((12.978596603904137 66.48116801680814,12.974957874837285 66.52599511474389,13.087381013406793 66.527408616661,13.090818041412135 66.48257850805584,12.978596603904137 66.48116801680814)))"
24150007375000,120,59,61,52.2,"MULTIPOLYGON(((13.090818041412135 66.48257850805584,13.087381013406793 66.527408616661,13.199817718981544 66.52874144338023,13.203052968786626 66.48390849562605,13.090818041412135 66.48257850805584)))"
24200007375000,86,43,43,48.1,"MULTIPOLYGON(((13.203052968786626 66.48390849562605,13.199817718981544 66.52874144338023,13.31226719656842 66.52999357791515,13.31530059554298 66.48515796262367,13.203052968786626 66.48390849562605)))"
24250007375000,1,0,1,0,"MULTIPOLYGON(((13.31530059554298 66.48515796262367,13.31226719656842 66.52999357791515,13.424728650617785 66.5311650043044,13.427560130645341 66.48632689317303,13.31530059554298 66.48515796262367)))"
24400007375000,5,4,1,65,"MULTIPOLYGON(((13.652111759193463 66.48842308652688,13.649684303329867 66.53326567393015,13.762176908421418 66.53419489037613,13.76440226811904 66.48935032268479,13.652111759193463 66.48842308652688)))"
24950007375000,43,22,21,44.5,"MULTIPOLYGON(((14.887657033906398 66.4941888100865,14.887454637448863 66.53904371368242,14.999999999999982 66.53908412574495,14.999999999999982 66.4942291359885,14.887657033906398 66.4941888100865)))"
23700007380000,1,0,1,0,"MULTIPOLYGON(((12.076156366792892 66.51178516813559,12.070886653859725 66.55658155017451,12.18337442558005 66.55864411413289,12.188442427678611 66.51384333744774,12.076156366792892 66.51178516813559)))"
23950007380000,2,1,1,0,"MULTIPOLYGON(((12.63777780202132 66.52127074302449,12.633517736755136 66.56608738493007,12.746097645512295 66.56774633761233,12.750155475697461 66.52292615838094,12.63777780202132 66.52127074302449)))"
24000007380000,21,12,9,47.5,"MULTIPOLYGON(((12.750155475697461 66.52292615838094,12.746097645512295 66.56774633761233,12.858693593894259 66.56932450036867,12.862549097675213 66.52450095563933,12.750155475697461 66.52292615838094)))"
24050007380000,2,1,1,0,"MULTIPOLYGON(((12.862549097675213 66.52450095563933,12.858693593894259 66.56932450036867,12.971304784258782 66.57082185303484,12.974957874837285 66.52599511474389,12.862549097675213 66.52450095563933)))"
24100007380000,17,9,8,56.2,"MULTIPOLYGON(((12.974957874837285 66.52599511474389,12.971304784258782 66.57082185303484,13.083930418297708 66.57223837647435,13.087381013406793 66.527408616661,12.974957874837285 66.52599511474389)))"
24150007380000,9,3,6,33,"MULTIPOLYGON(((13.087381013406793 66.527408616661,13.083930418297708 66.57223837647435,13.196569697071585 66.57357405257918,13.199817718981544 66.52874144338023,13.087381013406793 66.527408616661)))"
25100007380000,1,0,1,0,"MULTIPOLYGON(((15.225089925368383 66.53892247801079,15.225496313174359 66.58377686286798,15.33824245899122 66.58357437279079,15.337632888752943 66.53872042027794,15.225089925368383 66.53892247801079)))"
23750007385000,56,27,29,51.2,"MULTIPOLYGON(((12.18337442558005 66.55864411413289,12.178286406695225 66.60344443727826,12.290996813534656 66.60543056618165,12.295882213941308 66.56062600436204,12.18337442558005 66.55864411413289)))"
23900007385000,14,11,3,45.7,"MULTIPOLYGON(((12.520954664564567 66.56434766351272,12.516474827157204 66.60916018669047,12.62924083479987 66.61090363053451,12.633517736755136 66.56608738493007,12.520954664564567 66.56434766351272)))"
23950007385000,89,50,39,43.6,"MULTIPOLYGON(((12.633517736755136 66.56608738493007,12.62924083479987 66.61090363053451,12.74202377558558 66.6125661333129,12.746097645512295 66.56774633761233,12.633517736755136 66.56608738493007)))"
24050007385000,6,4,2,68,"MULTIPOLYGON(((12.858693593894259 66.56932450036867,12.85482284801976 66.61414767372001,12.967637249900662 66.61564823148237,12.971304784258782 66.57082185303484,12.858693593894259 66.56932450036867)))"
24100007385000,45,26,19,54,"MULTIPOLYGON(((12.971304784258782 66.57082185303484,12.967637249900662 66.61564823148237,13.080466178354236 66.61706778735966,13.083930418297708 66.57223837647435,12.971304784258782 66.57082185303484)))"
24200007385000,54,32,22,39,"MULTIPOLYGON(((13.196569697071585 66.57357405257918,13.19330882986908 66.61840632314575,13.306164400331461 66.61966382166977,13.309221821044366 66.57482886427111,13.196569697071585 66.57357405257918)))"
24100007390000,73,33,40,40.8,"MULTIPOLYGON(((12.967637249900662 66.61564823148237,12.963955188863645 66.66047424988392,13.07698821524911 66.66189684917744,13.080466178354236 66.61706778735966,12.967637249900662 66.61564823148237)))"
24150007390000,19,8,11,30.6,"MULTIPOLYGON(((13.080466178354236 66.61706778735966,13.07698821524911 66.66189684917744,13.190035043624498 66.66323825499983,13.19330882986908 66.61840632314575,13.080466178354236 66.61706778735966)))"
24200007390000,130,65,65,39.8,"MULTIPOLYGON(((13.19330882986908 66.61840632314575,13.190035043624498 66.66323825499983,13.303094865263311 66.66449845008694,13.306164400331461 66.61966382166977,13.19330882986908 66.61840632314575)))"
24250007390000,26,8,18,53,"MULTIPOLYGON(((13.306164400331461 66.61966382166977,13.303094865263311 66.66449845008694,13.416166870866352 66.66567741821613,13.419032085060408 66.62084026679685,13.306164400331461 66.61966382166977)))"
24300007390000,3,1,2,0,"MULTIPOLYGON(((13.419032085060408 66.62084026679685,13.416166870866352 66.66567741821613,13.5292502505972 66.66677514420753,13.531911078842857 66.62193564342913,13.419032085060408 66.62084026679685)))"
24350007390000,8,5,3,56,"MULTIPOLYGON(((13.531911078842857 66.62193564342913,13.5292502505972 66.66677514420753,13.642344194117777 66.66779161392448,13.644800575968853 66.6229499375064,13.531911078842857 66.62193564342913)))"
24100007395000,33,16,17,51.2,"MULTIPOLYGON(((12.963955188863645 66.66047424988392,12.960258517611074 66.70529990803321,13.073496450052698 66.70672556178481,13.07698821524911 66.66189684917744,12.963955188863645 66.66047424988392)))"
24150007395000,52,22,30,40.5,"MULTIPOLYGON(((13.07698821524911 66.66189684917744,13.073496450052698 66.70672556178481,13.186748264021036 66.70806984805846,13.190035043624498 66.66323825499983,13.07698821524911 66.66189684917744)))"
24200007395000,59,29,30,50.6,"MULTIPOLYGON(((13.190035043624498 66.66323825499983,13.186748264021036 66.70806984805846,13.300013146141401 66.70933274949586,13.303094865263311 66.66449845008694,13.190035043624498 66.66323825499983)))"
24250007395000,121,67,54,39.8,"MULTIPOLYGON(((13.303094865263311 66.66449845008694,13.300013146141401 66.70933274949586,13.41329028246087 66.71051424978614,13.416166870866352 66.66567741821613,13.303094865263311 66.66449845008694)))"
24300007395000,186,97,89,42.9,"MULTIPOLYGON(((13.416166870866352 66.66567741821613,13.41329028246087 66.71051424978614,13.526578858484136 66.7116143336666,13.5292502505972 66.66677514420753,13.416166870866352 66.66567741821613)))"
24350007395000,10,3,7,42,"MULTIPOLYGON(((13.5292502505972 66.66677514420753,13.526578858484136 66.7116143336666,13.639878059209384 66.71263298692365,13.642344194117777 66.66779161392448,13.5292502505972 66.66677514420753)))"
24400007395000,2,1,1,0,"MULTIPOLYGON(((13.642344194117777 66.66779161392448,13.639878059209384 66.71263298692365,13.753187069164232 66.7135701963934,13.755447890623936 66.66872681427448,13.642344194117777 66.66779161392448)))"
24200007400000,70,35,35,41.7,"MULTIPOLYGON(((13.186748264021036 66.70806984805846,13.18344841616918 66.7529011022356,13.296919172729979 66.75416671986731,13.300013146141401 66.70933274949586,13.186748264021036 66.70806984805846)))"
24250007400000,28,16,12,56,"MULTIPOLYGON(((13.300013146141401 66.70933274949586,13.296919172729979 66.75416671986731,13.410402254267174 66.75535076153066,13.41329028246087 66.71051424978614,13.300013146141401 66.70933274949586)))"
24300007400000,118,60,58,53.8,"MULTIPOLYGON(((13.41329028246087 66.71051424978614,13.410402254267174 66.75535076153066,13.523896841590664 66.75645321187963,13.526578858484136 66.7116143336666,13.41329028246087 66.71051424978614)))"
24350007400000,560,286,274,41.5,"MULTIPOLYGON(((13.526578858484136 66.7116143336666,13.523896841590664 66.75645321187963,13.637402114998958 66.75747405662301,13.639878059209384 66.71263298692365,13.526578858484136 66.7116143336666)))"
24400007400000,47,28,19,45.1,"MULTIPOLYGON(((13.639878059209384 66.71263298692365,13.637402114998958 66.75747405662301,13.75091725431545 66.75841328252505,13.753187069164232 66.7135701963934,13.639878059209384 66.71263298692365)))"
24450007400000,64,36,28,46.4,"MULTIPOLYGON(((13.753187069164232 66.7135701963934,13.75091725431545 66.75841328252505,13.864441438924766 66.7592708774063,13.86650507244174 66.71442594996257,13.753187069164232 66.7135701963934)))"
24500007400000,6,4,2,80.5,"MULTIPOLYGON(((13.86650507244174 66.71442594996257,13.864441438924766 66.7592708774063,13.977973847809157 66.76004683014412,13.979831252736437 66.715200236569,13.86650507244174 66.71442594996257)))"
24800007400000,6,4,2,48.7,"MULTIPOLYGON(((14.546556215430332 66.71784935163515,14.545730497164115 66.7627016464443,14.659294992389059 66.7629875720013,14.659914297648031 66.71813466309209,14.546556215430332 66.71784935163515)))"
25200007400000,12,6,6,56.2,"MULTIPOLYGON(((15.453443784569634 66.71784935163515,15.454269502835851 66.7627016464443,15.56783070629901 66.76233403423257,15.566798593948361 66.71748252894608,15.453443784569634 66.71784935163515)))"
25300007400000,5,1,4,56.6,"MULTIPOLYGON(((15.680149312550636 66.71703419976959,15.681387795334834 66.76188474013675,15.794939947461003 66.76135376998717,15.79349512262046 66.71650436990426,15.680149312550636 66.71703419976959)))"
23850007405000,8,6,2,68.8,"MULTIPOLYGON(((12.389566907445937 66.74175916185546,12.384809457558042 66.78656608985976,12.49837711434701 66.78840617263063,12.502928502399856 66.74359529316548,12.389566907445937 66.74175916185546)))"
24200007405000,4,3,1,0,"MULTIPOLYGON(((13.18344841616918 66.7529011022356,13.180135424601168 66.79773201744233,13.293812874250895 66.79900036116948,13.296919172729979 66.75416671986731,13.18344841616918 66.7529011022356)))"
24250007405000,46,29,17,36.2,"MULTIPOLYGON(((13.296919172729979 66.75416671986731,13.293812874250895 66.79900036116948,13.407502720201943 66.80018695347137,13.410402254267174 66.75535076153066,13.296919172729979 66.75416671986731)))"
24300007405000,255,122,133,42.5,"MULTIPOLYGON(((13.410402254267174 66.75535076153066,13.407502720201943 66.80018695347137,13.521204138533204 66.80129177891808,13.523896841590664 66.75645321187963,13.410402254267174 66.75535076153066)))"
24350007405000,331,162,169,42.5,"MULTIPOLYGON(((13.523896841590664 66.75645321187963,13.521204138533204 66.80129177891808,13.634916304807208 66.80231482314024,13.637402114998958 66.75747405662301,13.523896841590664 66.75645321187963)))"
24400007405000,39,19,20,51.5,"MULTIPOLYGON(((13.637402114998958 66.75747405662301,13.634916304807208 66.80231482314024,13.748638394106779 66.8032560728296,13.75091725431545 66.75841328252505,13.637402114998958 66.75747405662301)))"
24450007405000,4,3,1,0,"MULTIPOLYGON(((13.75091725431545 66.75841328252505,13.748638394106779 66.8032560728296,13.862369581071725 66.80411551574002,13.864441438924766 66.7592708774063,13.75091725431545 66.75841328252505)))"
24800007405000,53,26,27,48.1,"MULTIPOLYGON(((14.545730497164115 66.7627016464443,14.544901487111671 66.80755367902808,14.65867321816212 66.80784022092668,14.659294992389059 66.7629875720013,14.545730497164115 66.7627016464443)))"
25250007405000,17,8,9,58.5,"MULTIPOLYGON(((15.56783070629901 66.76233403423257,15.56886693310753 66.80718527441195,15.68263121506532 66.80673501187513,15.681387795334834 66.76188474013675,15.56783070629901 66.76233403423257)))"
25300007405000,15,8,7,55.1,"MULTIPOLYGON(((15.681387795334834 66.76188474013675,15.68263121506532 66.80673501187513,15.79639053151643 66.80620289727985,15.794939947461003 66.76135376998717,15.681387795334834 66.76188474013675)))"
24200007410000,77,42,35,52.6,"MULTIPOLYGON(((13.180135424601168 66.79773201744233,13.17680921326541 66.84256259358665,13.290694179378326 66.84383367336791,13.293812874250895 66.79900036116948,13.180135424601168 66.79773201744233)))"
24250007410000,74,39,35,53.4,"MULTIPOLYGON(((13.293812874250895 66.79900036116948,13.290694179378326 66.84383367336791,13.404591613670442 66.84502282562778,13.407502720201943 66.80018695347137,13.293812874250895 66.79900036116948)))"
24300007410000,124,64,60,43.9,"MULTIPOLYGON(((13.407502720201943 66.80018695347137,13.404591613670442 66.84502282562778,13.518500687453042 66.84613003485177,13.521204138533204 66.80129177891808,13.407502720201943 66.80018695347137)))"
24350007410000,63,33,30,53.4,"MULTIPOLYGON(((13.521204138533204 66.80129177891808,13.518500687453042 66.84613003485177,13.632420571516048 66.84715528659159,13.634916304807208 66.80231482314024,13.521204138533204 66.80129177891808)))"
24400007410000,207,115,92,46.2,"MULTIPOLYGON(((13.634916304807208 66.80231482314024,13.632420571516048 66.84715528659159,13.746350436165022 66.8480985674661,13.748638394106779 66.8032560728296,13.634916304807208 66.80231482314024)))"
24450007410000,488,254,234,43.6,"MULTIPOLYGON(((13.748638394106779 66.8032560728296,13.746350436165022 66.8480985674661,13.860289451258197 66.84895986516199,13.862369581071725 66.80411551574002,13.748638394106779 66.8032560728296)))"
24500007410000,992,509,483,38.5,"MULTIPOLYGON(((13.862369581071725 66.80411551574002,13.860289451258197 66.84895986516199,13.974236786243598 66.8497391684344,13.976109039935578 66.80489314068805,13.862369581071725 66.80411551574002)))"
24550007410000,101,53,48,39.3,"MULTIPOLYGON(((13.976109039935578 66.80489314068805,13.974236786243598 66.8497391684344,14.08819161019618 66.85043646710764,14.089855944562384 66.80558893755345,13.976109039935578 66.80489314068805)))"
24800007410000,2,1,1,0,"MULTIPOLYGON(((14.544901487111671 66.80755367902808,14.544069166203343 66.85240544974131,14.658048960663713 66.85269261023618,14.65867321816212 66.80784022092668,14.544901487111671 66.80755367902808)))"
24850007410000,20,10,10,52.7,"MULTIPOLYGON(((14.65867321816212 66.80784022092668,14.658048960663713 66.85269261023618,14.772031252791386 66.85289772755523,14.772447432465519 66.80804489637669,14.65867321816212 66.80784022092668)))"
25100007410000,6,6,0,46.5,"MULTIPOLYGON(((15.227552567534445 66.80804489637669,15.22796874720858 66.85289772755523,15.341951039336253 66.85269261023618,15.341326781837846 66.80784022092668,15.227552567534445 66.80804489637669)))"
25150007410000,27,13,14,54.5,"MULTIPOLYGON(((15.341326781837846 66.80784022092668,15.341951039336253 66.85269261023618,15.455930833796623 66.85240544974131,15.455098512888295 66.80755367902808,15.341326781837846 66.80784022092668)))"
25200007410000,10,8,2,57.9,"MULTIPOLYGON(((15.455098512888295 66.80755367902808,15.455930833796623 66.85240544974131,15.569907298208333 66.85203624982229,15.56886693310753 66.80718527441195,15.455098512888295 66.80755367902808)))"
25250007410000,9,5,4,66.6,"MULTIPOLYGON(((15.56886693310753 66.80718527441195,15.569907298208333 66.85203624982229,15.683879600339479 66.85158501530223,15.68263121506532 66.80673501187513,15.56886693310753 66.80718527441195)))"
24350007415000,2,1,1,0,"MULTIPOLYGON(((13.518500687453042 66.84613003485177,13.515786426011745 66.89096797974848,13.629914857564373 66.8919954470918,13.632420571516048 66.84715528659159,13.518500687453042 66.84613003485177)))"
24400007415000,1805,898,907,43.9,"MULTIPOLYGON(((13.632420571516048 66.84715528659159,13.629914857564373 66.8919954470918,13.744053327710688 66.89294076659246,13.746350436165022 66.8480985674661,13.632420571516048 66.84715528659159)))"
24450007415000,68,34,34,41.6,"MULTIPOLYGON(((13.746350436165022 66.8480985674661,13.744053327710688 66.89294076659246,13.858201001490261 66.89380392586948,13.860289451258197 66.84895986516199,13.746350436165022 66.8480985674661)))"
24800007415000,8,5,3,70.4,"MULTIPOLYGON(((14.544069166203343 66.85240544974131,14.54323351522144 66.89725695893914,14.657422205479326 66.89754474029797,14.658048960663713 66.85269261023618,14.544069166203343 66.85240544974131)))"
24850007415000,50,27,23,48.1,"MULTIPOLYGON(((14.658048960663713 66.85269261023618,14.657422205479326 66.89754474029797,14.771613407930973 66.89775030110607,14.772031252791386 66.85289772755523,14.658048960663713 66.85269261023618)))"
24900007415000,11,5,6,57.7,"MULTIPOLYGON(((14.772031252791386 66.85289772755523,14.771613407930973 66.89775030110607,14.885806285241358 66.89787363866883,14.886015210092884 66.85302079901867,14.772031252791386 66.85289772755523)))"
24950007415000,3,3,0,0,"MULTIPOLYGON(((14.886015210092884 66.85302079901867,14.885806285241358 66.89787363866883,14.999999999999982 66.89791475136938,14.999999999999982 66.85306182301848,14.886015210092884 66.85302079901867)))"
25100007415000,37,19,18,47.5,"MULTIPOLYGON(((15.22796874720858 66.85289772755523,15.228386592068993 66.89775030110607,15.34257779452064 66.89754474029797,15.341951039336253 66.85269261023618,15.22796874720858 66.85289772755523)))"
24300007420000,28,17,11,60.1,"MULTIPOLYGON(((13.401668867561563 66.88985837801721,13.398734414242812 66.93469361065466,13.513061291386489 66.9358056136743,13.515786426011745 66.89096797974848,13.401668867561563 66.88985837801721)))"
24350007420000,318,154,164,40.9,"MULTIPOLYGON(((13.515786426011745 66.89096797974848,13.513061291386489 66.9358056136743,13.627399104943732 66.9368353047542,13.629914857564373 66.8919954470918,13.515786426011745 66.89096797974848)))"
24400007420000,320,163,157,44,"MULTIPOLYGON(((13.629914857564373 66.8919954470918,13.627399104943732 66.9368353047542,13.74174701555406 66.93778267036551,13.744053327710688 66.89294076659246,13.629914857564373 66.8919954470918)))"
24450007420000,4,1,3,0,"MULTIPOLYGON(((13.744053327710688 66.89294076659246,13.74174701555406 66.93778267036551,13.856104183400914 66.93864769805901,13.858201001490261 66.89380392586948,13.744053327710688 66.89294076659246)))"
24850007420000,78,40,38,43.8,"MULTIPOLYGON(((14.657422205479326 66.89754474029797,14.656792938082308 66.94239661148097,14.771193888199242 66.94260261740753,14.771613407930973 66.89775030110607,14.657422205479326 66.89754474029797)))"
24900007420000,103,55,48,43.2,"MULTIPOLYGON(((14.771613407930973 66.89775030110607,14.771193888199242 66.94260261740753,14.885596522935302 66.94272622204728,14.885806285241358 66.89787363866883,14.771613407930973 66.89775030110607)))"
25100007420000,146,76,70,46.5,"MULTIPOLYGON(((15.228386592068993 66.89775030110607,15.228806111800724 66.94260261740753,15.343207061917658 66.94239661148097,15.34257779452064 66.89754474029797,15.228386592068993 66.89775030110607)))"
25150007420000,19,7,12,36.1,"MULTIPOLYGON(((15.34257779452064 66.89754474029797,15.343207061917658 66.94239661148097,15.457605485201162 66.94210820697708,15.456766484778527 66.89725695893914,15.34257779452064 66.89754474029797)))"
25200007420000,10,5,5,49.7,"MULTIPOLYGON(((15.456766484778527 66.89725695893914,15.457605485201162 66.94210820697708,15.572000539551246 66.9417374076889,15.57095182562083 66.89688696080175,15.456766484778527 66.89725695893914)))"
24350007425000,9,4,5,29.3,"MULTIPOLYGON(((13.513061291386489 66.9358056136743,13.510325220265356 66.98064293669344,13.624873255193998 66.98167485969056,13.627399104943732 66.9368353047542,13.513061291386489 66.9358056136743)))"
24400007425000,63,34,29,47.7,"MULTIPOLYGON(((13.627399104943732 66.9368353047542,13.624873255193998 66.98167485969056,13.739431446091196 66.98262427894082,13.74174701555406 66.93778267036551,13.627399104943732 66.9368353047542)))"
24450007425000,101,50,51,48.3,"MULTIPOLYGON(((13.74174701555406 66.93778267036551,13.739431446091196 66.98262427894082,13.85399894824644 66.98349118192624,13.856104183400914 66.93864769805901,13.74174701555406 66.93778267036551)))"
24500007425000,10,5,5,42.5,"MULTIPOLYGON(((13.856104183400914 66.93864769805901,13.85399894824644 66.98349118192624,13.968574916526904 66.98427555721518,13.970469768249504 66.93943037646582,13.856104183400914 66.93864769805901)))"
24550007425000,51,30,21,44.3,"MULTIPOLYGON(((13.970469768249504 66.93943037646582,13.968574916526904 66.98427555721518,14.083158505415671 66.98497739446272,14.084842929484658 66.9401306952978,13.970469768249504 66.93943037646582)))"
24600007425000,11,6,5,67.8,"MULTIPOLYGON(((14.084842929484658 66.9401306952978,14.083158505415671 66.98497739446272,14.197748869050018 66.98559668441142,14.19922282614875 66.94074864534835,14.084842929484658 66.9401306952978)))"
24850007425000,12,5,7,61.5,"MULTIPOLYGON(((14.656792938082308 66.94239661148097,14.656161143832815 66.9872482241544,14.770772683835677 66.9874546768384,14.771193888199242 66.94260261740753,14.656792938082308 66.94239661148097)))"
24900007425000,142,72,70,49.7,"MULTIPOLYGON(((14.771193888199242 66.94260261740753,14.770772683835677 66.9874546768384,14.885385918294276 66.9875785495386,14.885596522935302 66.94272622204728,14.771193888199242 66.94260261740753)))"
25100007425000,421,228,193,44.1,"MULTIPOLYGON(((15.228806111800724 66.94260261740753,15.22922731616429 66.9874546768384,15.343838856167151 66.9872482241544,15.343207061917658 66.94239661148097,15.228806111800724 66.94260261740753)))"
25150007425000,59,27,32,53.7,"MULTIPOLYGON(((15.343207061917658 66.94239661148097,15.343838856167151 66.9872482241544,15.458447854582614 66.98695919421108,15.457605485201162 66.94210820697708,15.343207061917658 66.94239661148097)))"
25200007425000,8,5,3,50.8,"MULTIPOLYGON(((15.457605485201162 66.94210820697708,15.458447854582614 66.98695919421108,15.573053464394423 66.9865875908224,15.572000539551246 66.9417374076889,15.457605485201162 66.94210820697708)))"
24500007430000,5,3,2,61.2,"MULTIPOLYGON(((13.85399894824644 66.98349118192624,13.851885246902732 67.02833437766597,13.966672444138371 67.02912045609563,13.968574916526904 66.98427555721518,13.85399894824644 66.98349118192624)))"
24550007430000,184,91,93,45.1,"MULTIPOLYGON(((13.968574916526904 66.98427555721518,13.966672444138371 67.02912045609563,14.081467306549854 67.02982381735963,14.083158505415671 66.98497739446272,13.968574916526904 66.98427555721518)))"
24600007430000,7,2,5,31.6,"MULTIPOLYGON(((14.083158505415671 66.98497739446272,14.081467306549854 67.02982381735963,14.196268983331047 67.03044445214937,14.197748869050018 66.98559668441142,14.083158505415671 66.98497739446272)))"
24650007430000,10,5,5,52,"MULTIPOLYGON(((14.197748869050018 66.98559668441142,14.196268983331047 67.03044445214937,14.31107662336532 67.03098235225005,14.312345161259747 66.9861334188917,14.197748869050018 66.98559668441142)))"
24750007430000,4,2,2,0,"MULTIPOLYGON(((14.426946535605543 66.9865875908224,14.425889375264296 67.03143751054128,14.540706387406603 67.03180992099745,14.541552145417352 66.98695919421108,14.426946535605543 66.9865875908224)))"
24800007430000,285,138,147,50,"MULTIPOLYGON(((14.541552145417352 66.98695919421108,14.540706387406603 67.03180992099745,14.655526807976676 67.03209957868809,14.656161143832815 66.9872482241544,14.541552145417352 66.98695919421108)))"
24850007430000,164,91,73,48.3,"MULTIPOLYGON(((14.656161143832815 66.9872482241544,14.655526807976676 67.03209957868809,14.770349785003553 67.03230647977809,14.770772683835677 66.9874546768384,14.656161143832815 66.9872482241544)))"
24900007430000,49,25,24,48.3,"MULTIPOLYGON(((14.770772683835677 66.9874546768384,14.770349785003553 67.03230647977809,14.885174466399729 67.03243062152794,14.885385918294276 66.9875785495386,14.770772683835677 66.9874546768384)))"
24950007430000,1,0,1,0,"MULTIPOLYGON(((14.885385918294276 66.9875785495386,14.885174466399729 67.03243062152794,14.999999999999982 67.03247200229387,14.999999999999982 66.98761984062028,14.885385918294276 66.9875785495386)))"
25100007430000,367,197,170,45,"MULTIPOLYGON(((15.22922731616429 66.9874546768384,15.229650214996413 67.03230647977809,15.34447319202329 67.03209957868809,15.343838856167151 66.9872482241544,15.22922731616429 66.9874546768384)))"
25150007430000,69,37,32,38.7,"MULTIPOLYGON(((15.343838856167151 66.9872482241544,15.34447319202329 67.03209957868809,15.459293612593363 67.03180992099745,15.458447854582614 66.98695919421108,15.343838856167151 66.9872482241544)))"
25200007430000,16,6,10,42.8,"MULTIPOLYGON(((15.458447854582614 66.98695919421108,15.459293612593363 67.03180992099745,15.57411062473567 67.03143751054128,15.573053464394423 66.9865875908224,15.458447854582614 66.98695919421108)))"
24550007435000,552,277,275,43.8,"MULTIPOLYGON(((13.966672444138371 67.02912045609563,13.964762306515793 67.07396507333775,14.079769293262583 67.07466996425214,14.081467306549854 67.02982381735963,13.966672444138371 67.02912045609563)))"
24600007435000,13,7,6,59.5,"MULTIPOLYGON(((14.081467306549854 67.02982381735963,14.079769293262583 67.07466996425214,14.194783134313703 67.07529194885493,14.196268983331047 67.03044445214937,14.081467306549854 67.02982381735963)))"
24650007435000,54,28,26,60.5,"MULTIPOLYGON(((14.196268983331047 67.03044445214937,14.194783134313703 67.07529194885493,14.309802973567358 67.07583101888574,14.31107662336532 67.03098235225005,14.196268983331047 67.03044445214937)))"
24700007435000,24,11,13,58.6,"MULTIPOLYGON(((14.31107662336532 67.03098235225005,14.309802973567358 67.07583101888574,14.424827954647352 67.0762871671847,14.425889375264296 67.03143751054128,14.31107662336532 67.03098235225005)))"
24800007435000,24,13,11,58.6,"MULTIPOLYGON(((14.540706387406603 67.03180992099745,14.539857220942192 67.07666038769283,14.6548899156443 67.07695067545224,14.655526807976676 67.03209957868809,14.540706387406603 67.03180992099745)))"
24950007435000,51,25,26,51.2,"MULTIPOLYGON(((14.885174466399729 67.03243062152794,14.884962162294627 67.07728243840107,14.999999999999982 67.07732390918292,14.999999999999982 67.03247200229387,14.885174466399729 67.03243062152794)))"
25000007435000,21,12,9,52.5,"MULTIPOLYGON(((14.999999999999982 67.03247200229387,14.999999999999982 67.07732390918292,15.115037837705339 67.07728243840107,15.114825533600238 67.03243062152794,14.999999999999982 67.03247200229387)))"
25150007435000,408,209,199,43.9,"MULTIPOLYGON(((15.34447319202329 67.03209957868809,15.345110084355666 67.07695067545224,15.460142779057774 67.07666038769283,15.459293612593363 67.03180992099745,15.34447319202329 67.03209957868809)))"
24550007440000,88,43,45,52.1,"MULTIPOLYGON(((13.964762306515793 67.07396507333775,13.962844458741861 67.11880940917167,14.078064425618726 67.11951583540353,14.079769293262583 67.07466996425214,13.964762306515793 67.07396507333775)))"
24650007440000,136,65,71,47.3,"MULTIPOLYGON(((14.194783134313703 67.07529194885493,14.193291287048078 67.12013917482062,14.308524181903852 67.12067941911674,14.309802973567358 67.07583101888574,14.194783134313703 67.07529194885493)))"
24700007440000,103,49,54,47,"MULTIPOLYGON(((14.309802973567358 67.07583101888574,14.308524181903852 67.12067941911674,14.42376224878287 67.12113656109219,14.424827954647352 67.0762871671847,14.309802973567358 67.07583101888574)))"
24950007440000,107,59,48,52.3,"MULTIPOLYGON(((14.884962162294627 67.07728243840107,14.884749000983078 67.12213400054439,14.999999999999982 67.12217556167576,14.999999999999982 67.07732390918292,14.884962162294627 67.07728243840107)))"
25000007440000,171,81,90,51.9,"MULTIPOLYGON(((14.999999999999982 67.07732390918292,14.999999999999982 67.12217556167576,15.115250999016888 67.12213400054439,15.115037837705339 67.07728243840107,14.999999999999982 67.07732390918292)))"
25150007440000,2766,1384,1382,43.6,"MULTIPOLYGON(((15.345110084355666 67.07695067545224,15.345749548150422 67.12180151481759,15.460995373955598 67.12151059465428,15.460142779057774 67.07666038769283,15.345110084355666 67.07695067545224)))"
25200007440000,43,23,20,51.2,"MULTIPOLYGON(((15.460142779057774 67.07666038769283,15.460995373955598 67.12151059465428,15.576237751217096 67.12113656109219,15.575172045352614 67.0762871671847,15.460142779057774 67.07666038769283)))"
24450007445000,2,2,0,0,"MULTIPOLYGON(((13.732428651527316 67.1171473350187,13.730075508373353 67.16198776433535,13.845492848711052 67.16286223805426,13.847632247226933 67.11801990553742,13.732428651527316 67.1171473350187)))"
24500007445000,20,9,11,51.8,"MULTIPOLYGON(((13.847632247226933 67.11801990553742,13.845492848711052 67.16286223805426,13.960918855546646 67.16365346382685,13.962844458741861 67.11880940917167,13.847632247226933 67.11801990553742)))"
24550007445000,294,154,140,47.4,"MULTIPOLYGON(((13.962844458741861 67.11880940917167,13.960918855546646 67.16365346382685,14.076352663369613 67.16436143107664,14.078064425618726 67.11951583540353,13.962844458741861 67.11880940917167)))"
24600007445000,130,64,66,46.8,"MULTIPOLYGON(((14.078064425618726 67.11951583540353,14.076352663369613 67.16436143107664,14.191793406309843 67.16498613033889,14.193291287048078 67.12013917482062,14.078064425618726 67.11951583540353)))"
24650007445000,8,3,5,66.3,"MULTIPOLYGON(((14.193291287048078 67.12013917482062,14.191793406309843 67.16498613033889,14.3072402181775 67.16552755326109,14.308524181903852 67.12067941911674,14.193291287048078 67.12013917482062)))"
24700007445000,44,26,18,53.2,"MULTIPOLYGON(((14.308524181903852 67.12067941911674,14.3072402181775 67.16552755326109,14.422692232502907 67.16598569260341,14.42376224878287 67.12113656109219,14.308524181903852 67.12067941911674)))"
24950007445000,49,24,25,58.8,"MULTIPOLYGON(((14.884749000983078 67.12213400054439,14.884534977429952 67.16698530834485,14.999999999999982 67.16702696016138,14.999999999999982 67.12217556167576,14.884749000983078 67.12213400054439)))"
25000007445000,38,21,17,49.4,"MULTIPOLYGON(((14.999999999999982 67.12217556167576,14.999999999999982 67.16702696016138,15.115465022570012 67.16698530834485,15.115250999016888 67.12213400054439,14.999999999999982 67.12217556167576)))"
25150007445000,111,58,53,49.7,"MULTIPOLYGON(((15.345749548150422 67.12180151481759,15.34639159851142 67.16665209715538,15.461851417423517 67.16636054223923,15.460995373955598 67.12151059465428,15.345749548150422 67.12180151481759)))"
25200007445000,41,22,19,49.8,"MULTIPOLYGON(((15.460995373955598 67.12151059465428,15.461851417423517 67.16636054223923,15.577307767497059 67.16598569260341,15.576237751217096 67.12113656109219,15.460995373955598 67.12151059465428)))"
25400007445000,336,172,164,43.2,"MULTIPOLYGON(((15.92193557438124 67.11951583540353,15.923647336630351 67.16436143107664,16.03908114445332 67.16365346382685,16.037155541258105 67.11880940917167,15.92193557438124 67.11951583540353)))"
25450007445000,240,123,117,51.7,"MULTIPOLYGON(((16.037155541258105 67.11880940917167,16.03908114445332 67.16365346382685,16.154507151288914 67.16286223805426,16.15236775277303 67.11801990553742,16.037155541258105 67.11880940917167)))"
24450007450000,6,5,1,62.2,"MULTIPOLYGON(((13.730075508373353 67.16198776433535,13.727712833537161 67.20682789921422,13.843344783630709 67.20770428321359,13.845492848711052 67.16286223805426,13.730075508373353 67.16198776433535)))"
24650007450000,22,14,8,51.5,"MULTIPOLYGON(((14.191793406309843 67.16498613033889,14.19028945659754 67.20983281570199,14.305951051953414 67.2103754216368,14.3072402181775 67.16552755326109,14.191793406309843 67.16498613033889)))"
24700007450000,58,33,25,49.6,"MULTIPOLYGON(((14.3072402181775 67.16552755326109,14.305951051953414 67.2103754216368,14.421617880441472 67.21083456205821,14.422692232502907 67.16598569260341,14.3072402181775 67.16552755326109)))"
24750007450000,93,51,42,48,"MULTIPOLYGON(((14.422692232502907 67.16598569260341,14.421617880441472 67.21083456205821,14.537289070243315 67.21121023080542,14.538148582576449 67.16636054223923,14.422692232502907 67.16598569260341)))"
24800007450000,86,45,41,44.6,"MULTIPOLYGON(((14.538148582576449 67.16636054223923,14.537289070243315 67.21121023080542,14.652963749338594 67.21150242283721,14.653608401488544 67.16665209715538,14.538148582576449 67.16636054223923)))"
24850007450000,49,24,25,48.7,"MULTIPOLYGON(((14.653608401488544 67.16665209715538,14.652963749338594 67.21150242283721,14.76864104554537 67.21171113423242,14.769070822169587 67.1668603534524,14.653608401488544 67.16665209715538)))"
24900007450000,3,2,1,0,"MULTIPOLYGON(((14.769070822169587 67.1668603534524,14.76864104554537 67.21171113423242,14.88432008656049 67.21183636218997,14.884534977429952 67.16698530834485,14.769070822169587 67.1668603534524)))"
24950007450000,98,53,45,45.2,"MULTIPOLYGON(((14.884534977429952 67.16698530834485,14.88432008656049 67.21183636218997,14.999999999999982 67.21187810502924,14.999999999999982 67.16702696016138,14.884534977429952 67.16698530834485)))"
25050007450000,105,51,54,43.6,"MULTIPOLYGON(((15.115465022570012 67.16698530834485,15.115679913439477 67.21183636218997,15.231358954454596 67.21171113423242,15.230929177830378 67.1668603534524,15.115465022570012 67.16698530834485)))"
25100007450000,1,1,0,0,"MULTIPOLYGON(((15.230929177830378 67.1668603534524,15.231358954454596 67.21171113423242,15.347036250661372 67.21150242283721,15.34639159851142 67.16665209715538,15.230929177830378 67.1668603534524)))"
25150007450000,1,1,0,0,"MULTIPOLYGON(((15.34639159851142 67.16665209715538,15.347036250661372 67.21150242283721,15.462710929756652 67.21121023080542,15.461851417423517 67.16636054223923,15.34639159851142 67.16665209715538)))"
25200007450000,23,12,11,45,"MULTIPOLYGON(((15.461851417423517 67.16636054223923,15.462710929756652 67.21121023080542,15.578382119558494 67.21083456205821,15.577307767497059 67.16598569260341,15.461851417423517 67.16636054223923)))"
25300007450000,6,4,2,50.7,"MULTIPOLYGON(((15.692759781822465 67.16552755326109,15.694048948046552 67.2103754216368,15.809710543402428 67.20983281570199,15.808206593690125 67.16498613033889,15.692759781822465 67.16552755326109)))"
24700007455000,23,11,12,47.2,"MULTIPOLYGON(((14.305951051953414 67.2103754216368,14.304656652556762 67.25522302456203,14.420539167032588 67.2556831697968,14.421617880441472 67.21083456205821,14.305951051953414 67.2103754216368)))"
24750007455000,38,17,21,48.1,"MULTIPOLYGON(((14.421617880441472 67.21083456205821,14.420539167032588 67.2556831697968,14.536426068589808 67.256059660711,14.537289070243315 67.21121023080542,14.421617880441472 67.21083456205821)))"
24800007455000,762,387,375,40.7,"MULTIPOLYGON(((14.537289070243315 67.21121023080542,14.536426068589808 67.256059660711,14.652316480056946 67.25635249223531,14.652963749338594 67.21150242283721,14.537289070243315 67.21121023080542)))"
24850007455000,128,65,63,40.5,"MULTIPOLYGON(((14.652963749338594 67.21150242283721,14.652316480056946 67.25635249223531,14.76820952409934 67.25656166042653,14.76864104554537 67.21171113423242,14.652963749338594 67.21150242283721)))"
24900007455000,12,8,4,53.8,"MULTIPOLYGON(((14.76864104554537 67.21171113423242,14.76820952409934 67.25656166042653,14.884104323259912 67.25668716246795,14.88432008656049 67.21183636218997,14.76864104554537 67.21171113423242)))"
24950007455000,66,40,26,42.8,"MULTIPOLYGON(((14.88432008656049 67.21183636218997,14.884104323259912 67.25668716246795,14.999999999999982 67.25672899666957,14.999999999999982 67.21187810502924,14.88432008656049 67.21183636218997)))"
25000007455000,112,59,53,50.3,"MULTIPOLYGON(((14.999999999999982 67.21187810502924,14.999999999999982 67.25672899666957,15.115895676740054 67.25668716246795,15.115679913439477 67.21183636218997,14.999999999999982 67.21187810502924)))"
25050007455000,25,12,13,55.2,"MULTIPOLYGON(((15.115679913439477 67.21183636218997,15.115895676740054 67.25668716246795,15.231790475900626 67.25656166042653,15.231358954454596 67.21171113423242,15.115679913439477 67.21183636218997)))"
25100007455000,49,25,24,55.2,"MULTIPOLYGON(((15.231358954454596 67.21171113423242,15.231790475900626 67.25656166042653,15.347683519943018 67.25635249223531,15.347036250661372 67.21150242283721,15.231358954454596 67.21171113423242)))"
25150007455000,1331,653,678,44.1,"MULTIPOLYGON(((15.347036250661372 67.21150242283721,15.347683519943018 67.25635249223531,15.463573931410158 67.256059660711,15.462710929756652 67.21121023080542,15.347036250661372 67.21150242283721)))"
25200007455000,164,88,76,44.9,"MULTIPOLYGON(((15.462710929756652 67.21121023080542,15.463573931410158 67.256059660711,15.579460832967376 67.2556831697968,15.578382119558494 67.21083456205821,15.462710929756652 67.21121023080542)))"
25250007455000,17,8,9,35.5,"MULTIPOLYGON(((15.578382119558494 67.21083456205821,15.579460832967376 67.2556831697968,15.695343347443202 67.25522302456203,15.694048948046552 67.2103754216368,15.578382119558494 67.21083456205821)))"
24550007460000,1,1,0,0,"MULTIPOLYGON(((13.957044200028706 67.25334073051538,13.955095055371618 67.29818394300439,14.071175601735899 67.2988965678497,14.072908292474688 67.25405179703779,13.957044200028706 67.25334073051538)))"
24700007460000,16767,8309,8458,44,"MULTIPOLYGON(((14.304656652556762 67.25522302456203,14.303356989070414 67.30007036235496,14.419456066508323 67.30053151615944,14.420539167032588 67.2556831697968,14.304656652556762 67.25522302456203)))"
24750007460000,17338,8645,8693,38.2,"MULTIPOLYGON(((14.420539167032588 67.2556831697968,14.419456066508323 67.30053151615944,14.535559556999186 67.30090883231446,14.536426068589808 67.256059660711,14.420539167032588 67.2556831697968)))"
24800007460000,8702,4432,4270,36.5,"MULTIPOLYGON(((14.536426068589808 67.256059660711,14.535559556999186 67.30090883231446,14.651666578179642 67.30120230572221,14.652316480056946 67.25635249223531,14.536426068589808 67.256059660711)))"
24850007460000,3521,1759,1762,37.6,"MULTIPOLYGON(((14.652316480056946 67.25635249223531,14.651666578179642 67.30120230572221,14.767776247521523 67.3014119324174,14.76820952409934 67.25656166042653,14.652316480056946 67.25635249223531)))"
24900007460000,156,79,77,44.7,"MULTIPOLYGON(((14.76820952409934 67.25656166042653,14.767776247521523 67.3014119324174,14.88388768237304 67.30153770956754,14.884104323259912 67.25668716246795,14.76820952409934 67.25656166042653)))"
24950007460000,28,11,17,40.4,"MULTIPOLYGON(((14.884104323259912 67.25668716246795,14.88388768237304 67.30153770956754,14.999999999999982 67.3015796354731,14.999999999999982 67.25672899666957,14.884104323259912 67.25668716246795)))"
25000007460000,32,14,18,44.8,"MULTIPOLYGON(((14.999999999999982 67.25672899666957,14.999999999999982 67.3015796354731,15.116112317626927 67.30153770956754,15.115895676740054 67.25668716246795,14.999999999999982 67.25672899666957)))"
25050007460000,597,303,294,42.8,"MULTIPOLYGON(((15.115895676740054 67.25668716246795,15.116112317626927 67.30153770956754,15.232223752478443 67.3014119324174,15.231790475900626 67.25656166042653,15.115895676740054 67.25668716246795)))"
25100007460000,132,70,62,47.6,"MULTIPOLYGON(((15.231790475900626 67.25656166042653,15.232223752478443 67.3014119324174,15.348333421820325 67.30120230572221,15.347683519943018 67.25635249223531,15.231790475900626 67.25656166042653)))"
25150007460000,5485,2739,2746,44.1,"MULTIPOLYGON(((15.347683519943018 67.25635249223531,15.348333421820325 67.30120230572221,15.46444044300078 67.30090883231446,15.463573931410158 67.256059660711,15.347683519943018 67.25635249223531)))"
25200007460000,8,3,5,54.6,"MULTIPOLYGON(((15.463573931410158 67.256059660711,15.46444044300078 67.30090883231446,15.580543933491642 67.30053151615944,15.579460832967376 67.2556831697968,15.463573931410158 67.256059660711)))"
24450007465000,13,7,6,48.8,"MULTIPOLYGON(((13.722958663671706 67.29650728625028,13.720567054956138 67.34134653870001,13.836848076155867 67.34222869644373,13.839022449042757 67.2973875122196,13.722958663671706 67.29650728625028)))"
24700007465000,182,102,80,43,"MULTIPOLYGON(((14.303356989070414 67.30007036235496,14.302052030332534 67.34491743533376,14.418368552896775 67.34537960148675,14.419456066508323 67.30053151615944,14.303356989070414 67.30007036235496)))"
24750007465000,2454,1248,1206,37.8,"MULTIPOLYGON(((14.419456066508323 67.30053151615944,14.418368552896775 67.34537960148675,14.534689514691502 67.34575774597467,14.535559556999186 67.30090883231446,14.419456066508323 67.30053151615944)))"
24800007465000,103,52,51,44.6,"MULTIPOLYGON(((14.535559556999186 67.30090883231446,14.534689514691502 67.34575774597467,14.651014028120308 67.34605186367102,14.651666578179642 67.30120230572221,14.535559556999186 67.30090883231446)))"
24850007465000,495,264,231,36.1,"MULTIPOLYGON(((14.651666578179642 67.30120230572221,14.651014028120308 67.34605186367102,14.767341205420333 67.34626195058831,14.767776247521523 67.3014119324174,14.651666578179642 67.30120230572221)))"
24950007465000,8,4,4,67.1,"MULTIPOLYGON(((14.88388768237304 67.30153770956754,14.883670158703875 67.34638800387808,14.999999999999982 67.34643002183124,14.999999999999982 67.3015796354731,14.88388768237304 67.30153770956754)))"
25000007465000,5,3,2,59.2,"MULTIPOLYGON(((14.999999999999982 67.3015796354731,14.999999999999982 67.34643002183124,15.116329841296091 67.34638800387808,15.116112317626927 67.30153770956754,14.999999999999982 67.3015796354731)))"
25050007465000,390,197,193,40.5,"MULTIPOLYGON(((15.116112317626927 67.30153770956754,15.116329841296091 67.34638800387808,15.232658794579633 67.34626195058831,15.232223752478443 67.3014119324174,15.116112317626927 67.30153770956754)))"
25100007465000,202,104,98,44.5,"MULTIPOLYGON(((15.232223752478443 67.3014119324174,15.232658794579633 67.34626195058831,15.348985971879658 67.34605186367102,15.348333421820325 67.30120230572221,15.232223752478443 67.3014119324174)))"
25150007465000,98,52,46,45.3,"MULTIPOLYGON(((15.348333421820325 67.30120230572221,15.348985971879658 67.34605186367102,15.465310485308462 67.34575774597467,15.46444044300078 67.30090883231446,15.348333421820325 67.30120230572221)))"
25200007465000,182,100,82,40,"MULTIPOLYGON(((15.46444044300078 67.30090883231446,15.465310485308462 67.34575774597467,15.581631447103192 67.34537960148675,15.580543933491642 67.30053151615944,15.46444044300078 67.30090883231446)))"
25250007465000,321,173,148,41.5,"MULTIPOLYGON(((15.580543933491642 67.30053151615944,15.581631447103192 67.34537960148675,15.697947969667432 67.34491743533376,15.696643010929552 67.30007036235496,15.580543933491642 67.30053151615944)))"
24650007470000,38,20,18,49.8,"MULTIPOLYGON(((14.185740834387184 67.34437125378074,14.184212248125288 67.3892168614427,14.300741744934173 67.38976424381664,14.302052030332534 67.34491743533376,14.185740834387184 67.34437125378074)))"
24800007470000,562,289,273,37.6,"MULTIPOLYGON(((14.534689514691502 67.34575774597467,14.533815920722002 67.39060640205079,14.650358814168946 67.39090116645531,14.651014028120308 67.34605186367102,14.534689514691502 67.34575774597467)))"
24850007470000,16,5,11,31.7,"MULTIPOLYGON(((14.651014028120308 67.34605186367102,14.650358814168946 67.39090116645531,14.766904387321757 67.39111171532302,14.767341205420333 67.34626195058831,14.651014028120308 67.34605186367102)))"
24900007470000,24,11,13,35.3,"MULTIPOLYGON(((14.767341205420333 67.34626195058831,14.766904387321757 67.39111171532302,14.883451747015203 67.39123804578945,14.883670158703875 67.34638800387808,14.767341205420333 67.34626195058831)))"
25050007470000,20,9,11,39.4,"MULTIPOLYGON(((15.116329841296091 67.34638800387808,15.116548252984764 67.39123804578945,15.233095612678209 67.39111171532302,15.232658794579633 67.34626195058831,15.116329841296091 67.34638800387808)))"
25100007470000,153,85,68,42.5,"MULTIPOLYGON(((15.232658794579633 67.34626195058831,15.233095612678209 67.39111171532302,15.34964118583102 67.39090116645531,15.348985971879658 67.34605186367102,15.232658794579633 67.34626195058831)))"
25150007470000,11,7,4,46.3,"MULTIPOLYGON(((15.348985971879658 67.34605186367102,15.34964118583102 67.39090116645531,15.466184079277964 67.39060640205079,15.465310485308462 67.34575774597467,15.348985971879658 67.34605186367102)))"
25200007470000,174,90,84,42.1,"MULTIPOLYGON(((15.465310485308462 67.34575774597467,15.466184079277964 67.39060640205079,15.582723399979901 67.39022742611945,15.581631447103192 67.34537960148675,15.465310485308462 67.34575774597467)))"
25250007470000,579,294,285,44.9,"MULTIPOLYGON(((15.581631447103192 67.34537960148675,15.582723399979901 67.39022742611945,15.699258255065793 67.38976424381664,15.697947969667432 67.34491743533376,15.581631447103192 67.34537960148675)))"
24500007475000,85,43,42,41.8,"MULTIPOLYGON(((13.834664829937946 67.38706959406522,13.832472657668896 67.4319102052703,13.94919979210013 67.43271189976979,13.951172898680184 67.38786952740584,13.834664829937946 67.38706959406522)))"
24550007475000,2,1,1,0,"MULTIPOLYGON(((13.951172898680184 67.38786952740584,13.94919979210013 67.43271189976979,14.065935008948253 67.43342923474513,14.067689002002314 67.38858528644269,13.951172898680184 67.38786952740584)))"
24700007475000,7,4,3,62.3,"MULTIPOLYGON(((14.300741744934173 67.38976424381664,14.299426101216797 67.4346107881219,14.41618018149229 67.4350749903985,14.417276600020065 67.39022742611945,14.300741744934173 67.38976424381664)))"
24800007475000,130,72,58,39.8,"MULTIPOLYGON(((14.533815920722002 67.39060640205079,14.53293875397948 67.43545480090238,14.649700920490703 67.43575021444903,14.650358814168946 67.39090116645531,14.533815920722002 67.39060640205079)))"
24850007475000,67,37,30,42.4,"MULTIPOLYGON(((14.650358814168946 67.39090116645531,14.649700920490703 67.43575021444903,14.766465782668531 67.43596122700588,14.766904387321757 67.39111171532302,14.650358814168946 67.39090116645531)))"
24900007475000,63,30,33,43.6,"MULTIPOLYGON(((14.766904387321757 67.39111171532302,14.766465782668531 67.43596122700588,14.883232442028188 67.43608783569228,14.883451747015203 67.39123804578945,14.766904387321757 67.39111171532302)))"
25100007475000,10,4,6,53.6,"MULTIPOLYGON(((15.233095612678209 67.39111171532302,15.233534217331435 67.43596122700588,15.350299079509263 67.43575021444903,15.34964118583102 67.39090116645531,15.233095612678209 67.39111171532302)))"
25200007475000,44,25,19,47.4,"MULTIPOLYGON(((15.466184079277964 67.39060640205079,15.467061246020487 67.43545480090238,15.583819818507674 67.4350749903985,15.582723399979901 67.39022742611945,15.466184079277964 67.39060640205079)))"
25250007475000,139,69,70,49.8,"MULTIPOLYGON(((15.582723399979901 67.39022742611945,15.583819818507674 67.4350749903985,15.700573898783167 67.4346107881219,15.699258255065793 67.38976424381664,15.582723399979901 67.39022742611945)))"
25300007475000,12,5,7,49.4,"MULTIPOLYGON(((15.699258255065793 67.38976424381664,15.700573898783167 67.4346107881219,15.817322588871487 67.43406220040842,15.81578775187468 67.3892168614427,15.699258255065793 67.38976424381664)))"
24550007480000,8,5,3,42.5,"MULTIPOLYGON(((13.94919979210013 67.43271189976979,13.9472186030396 67.47755399254234,14.064173830505547 67.4782729093984,14.065935008948253 67.43342923474513,13.94919979210013 67.43271189976979)))"
24850007480000,6,4,2,53.7,"MULTIPOLYGON(((14.649700920490703 67.43575021444903,14.649040331124631 67.48059900802669,14.76602538081933 67.48081048602174,14.766465782668531 67.43596122700588,14.649700920490703 67.43575021444903)))"
24900007480000,12,7,5,54.4,"MULTIPOLYGON(((14.766465782668531 67.43596122700588,14.76602538081933 67.48081048602174,14.883012238421957 67.48093737397761,14.883232442028188 67.43608783569228,14.766465782668531 67.43596122700588)))"
25050007480000,8,4,4,45.3,"MULTIPOLYGON(((15.116767557971778 67.43608783569228,15.11698776157801 67.48093737397761,15.233974619180636 67.48081048602174,15.233534217331435 67.43596122700588,15.116767557971778 67.43608783569228)))"
25150007480000,111,58,53,38.8,"MULTIPOLYGON(((15.350299079509263 67.43575021444903,15.350959668875335 67.48059900802669,15.46794200681534 67.48030294288931,15.467061246020487 67.43545480090238,15.350299079509263 67.43575021444903)))"
25200007480000,215,116,99,47.5,"MULTIPOLYGON(((15.467061246020487 67.43545480090238,15.46794200681534 67.48030294288931,15.584920729282505 67.47992229466509,15.583819818507674 67.4350749903985,15.467061246020487 67.43545480090238)))"
25300007480000,16,10,6,63.7,"MULTIPOLYGON(((15.700573898783167 67.4346107881219,15.701894932730141 67.47945706856775,15.818863713825875 67.47890727096906,15.817322588871487 67.43406220040842,15.700573898783167 67.4346107881219)))"
24850007485000,122,59,63,49.2,"MULTIPOLYGON(((14.649040331124631 67.48059900802669,14.648377029982427 67.52544754756316,14.76558317104791 67.52565949275605,14.76602538081933 67.48081048602174,14.649040331124631 67.48059900802669)))"
24900007485000,131,68,63,52.3,"MULTIPOLYGON(((14.76602538081933 67.48081048602174,14.76558317104791 67.52565949275605,14.882791130833171 67.52578666103715,14.883012238421957 67.48093737397761,14.76602538081933 67.48081048602174)))"
24950007485000,9,4,5,34.9,"MULTIPOLYGON(((14.883012238421957 67.48093737397761,14.882791130833171 67.52578666103715,14.999999999999982 67.52582905065842,14.999999999999982 67.48097967015603,14.883012238421957 67.48093737397761)))"
25000007485000,7,4,3,70,"MULTIPOLYGON(((14.999999999999982 67.48097967015603,14.999999999999982 67.52582905065842,15.117208869166793 67.52578666103715,15.11698776157801 67.48093737397761,14.999999999999982 67.48097967015603)))"
25150007485000,41,21,20,41.9,"MULTIPOLYGON(((15.350959668875335 67.48059900802669,15.351622970017539 67.52544754756316,15.468826383111619 67.52515082837184,15.46794200681534 67.48030294288931,15.350959668875335 67.48059900802669)))"
25200007485000,54,30,24,58.1,"MULTIPOLYGON(((15.46794200681534 67.48030294288931,15.468826383111619 67.52515082837184,15.586026159112574 67.52476933926052,15.584920729282505 67.47992229466509,15.46794200681534 67.48030294288931)))"
25250007485000,7,4,3,60.6,"MULTIPOLYGON(((15.584920729282505 67.47992229466509,15.586026159112574 67.52476933926052,15.703221389071876 67.5243030854725,15.701894932730141 67.47945706856775,15.584920729282505 67.47992229466509)))"
23700007490000,19,8,11,45.5,"MULTIPOLYGON(((11.95522509431975 67.49719579531936,11.949468549983507 67.54198164424177,12.066602881780035 67.54414506691353,12.072139172616396 67.49935445258158,11.95522509431975 67.49719579531936)))"
23750007490000,450,228,222,46.8,"MULTIPOLYGON(((12.072139172616396 67.49935445258158,12.066602881780035 67.54414506691353,12.183759971040395 67.54622388790699,12.189075873263848 67.50142869370084,12.072139172616396 67.49935445258158)))"
24900007490000,66,32,34,45.3,"MULTIPOLYGON(((14.76558317104791 67.52565949275605,14.765139142542271 67.57050824759469,14.882569113855629 67.5706356972632,14.882791130833171 67.52578666103715,14.76558317104791 67.52565949275605)))"
25000007490000,1,1,0,0,"MULTIPOLYGON(((14.999999999999982 67.52582905065842,14.999999999999982 67.57067818068138,15.117430886144337 67.5706356972632,15.117208869166793 67.52578666103715,14.999999999999982 67.52582905065842)))"
25050007490000,6,4,2,64.7,"MULTIPOLYGON(((15.117208869166793 67.52578666103715,15.117430886144337 67.5706356972632,15.234860857457695 67.57050824759469,15.234416828952057 67.52565949275605,15.117208869166793 67.52578666103715)))"
25150007490000,1,0,1,0,"MULTIPOLYGON(((15.351622970017539 67.52544754756316,15.352288999152801 67.57029583343382,15.469714396529882 67.5699984577105,15.468826383111619 67.52515082837184,15.351622970017539 67.52544754756316)))"
25200007490000,7,3,4,58,"MULTIPOLYGON(((15.468826383111619 67.52515082837184,15.469714396529882 67.5699984577105,15.587136135020375 67.56961612452633,15.586026159112574 67.52476933926052,15.468826383111619 67.52515082837184)))"
24950007495000,10,5,5,53.5,"MULTIPOLYGON(((14.882569113855629 67.5706356972632,14.882346182039797 67.61548448304863,14.999999999999982 67.61552706061991,14.999999999999982 67.57067818068138,14.882569113855629 67.5706356972632)))"
25300007495000,19,8,11,71,"MULTIPOLYGON(((15.704553300230636 67.5691488391544,15.705890698888373 67.61399432993169,15.82352519313284 67.61344087512956,15.821964977985633 67.56859660803896,15.704553300230636 67.5691488391544)))"
25350007495000,70,31,39,51,"MULTIPOLYGON(((15.821964977985633 67.56859660803896,15.82352519313284 67.61344087512956,15.94115324758152 67.61280229405622,15.939370254372612 67.56795943879509,15.821964977985633 67.56859660803896)))"
25400007495000,5,3,2,62,"MULTIPOLYGON(((15.939370254372612 67.56795943879509,15.94115324758152 67.61280229405622,16.058773943146658 67.61207859554713,16.056768215784725 67.56723734020822,15.939370254372612 67.56795943879509)))"
25300007500000,1,0,1,0,"MULTIPOLYGON(((15.705890698888373 67.61399432993169,15.707233617989324 67.65883955812266,15.825091848127334 67.6582848749778,15.82352519313284 67.61344087512956,15.705890698888373 67.61399432993169)))"
25350007500000,7,4,3,56,"MULTIPOLYGON(((15.82352519313284 67.61344087512956,15.825091848127334 67.6582848749778,15.942943599732795 67.65764487670357,15.94115324758152 67.61280229405622,15.82352519313284 67.61344087512956)))"
25400007500000,2,1,1,0,"MULTIPOLYGON(((15.94115324758152 67.61280229405622,15.942943599732795 67.65764487670357,16.060787948193028 67.65691957218583,16.058773943146658 67.61207859554713,15.94115324758152 67.61280229405622)))"
24000007505000,645,338,307,44.8,"MULTIPOLYGON(((12.643676819837104 67.64331473477822,12.63918867174314 67.68812521197877,12.75711441497026 67.68979165246961,12.761378842940598 67.64497748361967,12.643676819837104 67.64331473477822)))"
24900007505000,1,0,1,0,"MULTIPOLYGON(((14.7642455856464 67.66020500313148,14.763796035195602 67.7050530046042,14.881897551876001 67.7051813048721,14.882122329892406 67.66033301878693,14.7642455856464 67.66020500313148)))"
24950007505000,19,9,10,57.8,"MULTIPOLYGON(((14.882122329892406 67.66033301878693,14.881897551876001 67.7051813048721,14.999999999999982 67.70522407182675,14.999999999999982 67.66037569086963,14.882122329892406 67.66033301878693)))"
25000007505000,58,28,30,48.4,"MULTIPOLYGON(((14.999999999999982 67.66037569086963,14.999999999999982 67.70522407182675,15.118102448123965 67.7051813048721,15.11787767010756 67.66033301878693,14.999999999999982 67.66037569086963)))"
25100007505000,3,2,1,0,"MULTIPOLYGON(((15.235754414353565 67.66020500313148,15.236203964804362 67.7050530046042,15.354303618642675 67.70483917281135,15.35362930692105 67.65999164568142,15.235754414353565 67.66020500313148)))"
25300007505000,14,8,6,53.7,"MULTIPOLYGON(((15.707233617989324 67.65883955812266,15.708582090742652 67.70368452404553,15.826664981706395 67.70312860787374,15.825091848127334 67.6582848749778,15.707233617989324 67.65883955812266)))"
25350007505000,31,16,15,55.9,"MULTIPOLYGON(((15.825091848127334 67.6582848749778,15.826664981706395 67.70312860787374,15.94474135508873 67.7024871869947,15.942943599732795 67.65764487670357,15.825091848127334 67.6582848749778)))"
24000007510000,37,20,17,48.4,"MULTIPOLYGON(((12.63918867174314 67.68812521197877,12.634681954438431 67.73293529556305,12.752832340707913 67.73460544178218,12.75711441497026 67.68979165246961,12.63918867174314 67.68812521197877)))"
24900007510000,394,198,196,43.2,"MULTIPOLYGON(((14.763796035195602 67.7050530046042,14.763344621887695 67.74990075573038,14.881671842408505 67.75002934169878,14.881897551876001 67.7051813048721,14.763796035195602 67.7050530046042)))"
24950007510000,56,32,24,54.7,"MULTIPOLYGON(((14.881897551876001 67.7051813048721,14.881671842408505 67.75002934169878,14.999999999999982 67.7500722038881,14.999999999999982 67.70522407182675,14.881897551876001 67.7051813048721)))"
25000007510000,43,22,21,57.3,"MULTIPOLYGON(((14.999999999999982 67.70522407182675,14.999999999999982 67.7500722038881,15.118328157591462 67.75002934169878,15.118102448123965 67.7051813048721,14.999999999999982 67.70522407182675)))"
25050007510000,63,33,30,46.3,"MULTIPOLYGON(((15.118102448123965 67.7051813048721,15.118328157591462 67.75002934169878,15.236655378112271 67.74990075573038,15.236203964804362 67.7050530046042,15.118102448123965 67.7051813048721)))"
25300007510000,3,2,1,0,"MULTIPOLYGON(((15.708582090742652 67.70368452404553,15.709936150625104 67.74852922801851,15.828244632919404 67.74797207410722,15.826664981706395 67.70312860787374,15.708582090742652 67.70368452404553)))"
25350007510000,41,22,19,56.3,"MULTIPOLYGON(((15.826664981706395 67.70312860787374,15.828244632919404 67.74797207410722,15.946546558268194 67.74732922518676,15.94474135508873 67.7024871869947,15.826664981706395 67.70312860787374)))"
24900007515000,5,2,3,61,"MULTIPOLYGON(((14.763344621887695 67.74990075573038,14.762891334468804 67.79474825689863,14.881445195862748 67.79487712966218,14.881671842408505 67.75002934169878,14.763344621887695 67.74990075573038)))"
24950007515000,28,16,12,43.9,"MULTIPOLYGON(((14.881671842408505 67.75002934169878,14.881445195862748 67.79487712966218,14.999999999999982 67.79492008745103,14.999999999999982 67.7500722038881,14.881671842408505 67.75002934169878)))"
25000007515000,447,229,218,42.9,"MULTIPOLYGON(((14.999999999999982 67.7500722038881,14.999999999999982 67.79492008745103,15.118554804137219 67.79487712966218,15.118328157591462 67.75002934169878,14.999999999999982 67.7500722038881)))"
25050007515000,226,105,121,37.9,"MULTIPOLYGON(((15.118328157591462 67.75002934169878,15.118554804137219 67.79487712966218,15.237108665531162 67.79474825689863,15.236655378112271 67.74990075573038,15.118328157591462 67.75002934169878)))"
25100007515000,147,72,75,45.3,"MULTIPOLYGON(((15.236655378112271 67.74990075573038,15.237108665531162 67.79474825689863,15.35566064148452 67.79453347096921,15.354980724537278 67.74968644778141,15.236655378112271 67.74990075573038)))"
24850007520000,2,1,1,0,"MULTIPOLYGON(((14.644339358515447 67.79453347096921,14.64365661349931 67.83938024275277,14.762436161593996 67.83959550849809,14.762891334468804 67.79474825689863,14.644339358515447 67.79453347096921)))"
24900007520000,102,54,48,54.3,"MULTIPOLYGON(((14.762891334468804 67.79474825689863,14.762436161593996 67.83959550849809,14.881217606566036 67.83972466915813,14.881445195862748 67.79487712966218,14.762891334468804 67.79474825689863)))"
24950007520000,4,2,2,0,"MULTIPOLYGON(((14.881445195862748 67.79487712966218,14.881217606566036 67.83972466915813,14.999999999999982 67.83976772291362,14.999999999999982 67.79492008745103,14.881445195862748 67.79487712966218)))"
25000007520000,14,7,7,38.4,"MULTIPOLYGON(((14.999999999999982 67.79492008745103,14.999999999999982 67.83976772291362,15.11878239343393 67.83972466915813,15.118554804137219 67.79487712966218,14.999999999999982 67.79492008745103)))"
25050007520000,11,5,6,53.8,"MULTIPOLYGON(((15.118554804137219 67.79487712966218,15.11878239343393 67.83972466915813,15.23756383840597 67.83959550849809,15.237108665531162 67.79474825689863,15.118554804137219 67.79487712966218)))"
25100007520000,10,4,6,46.1,"MULTIPOLYGON(((15.237108665531162 67.79474825689863,15.23756383840597 67.83959550849809,15.356343386500656 67.83938024275277,15.35566064148452 67.79453347096921,15.237108665531162 67.79474825689863)))"
25150007520000,4,3,1,0,"MULTIPOLYGON(((15.35566064148452 67.79453347096921,15.356343386500656 67.83938024275277,15.475120089395459 67.83907887495415,15.474209789391978 67.79423277488854,15.35566064148452 67.79453347096921)))"
25400007520000,5,3,2,26.2,"MULTIPOLYGON(((15.94835925425023 67.79217099153631,15.950179488377703 67.83701248629937,16.068927746937245 67.83628069614257,16.066880129285284 67.79144083210468,15.94835925425023 67.79217099153631)))"
24900007525000,3,2,1,0,"MULTIPOLYGON(((14.762436161593996 67.83959550849809,14.761979091826346 67.88444251091839,14.880989068799671 67.88457196058295,14.881217606566036 67.83972466915813,14.762436161593996 67.83959550849809)))"
24950007525000,31,17,14,52.2,"MULTIPOLYGON(((14.881217606566036 67.83972466915813,14.880989068799671 67.88457196058295,14.999999999999982 67.88461511067443,14.999999999999982 67.83976772291362,14.881217606566036 67.83972466915813)))"
25000007525000,23,12,11,53.9,"MULTIPOLYGON(((14.999999999999982 67.83976772291362,14.999999999999982 67.88461511067443,15.119010931200295 67.88457196058295,15.11878239343393 67.83972466915813,14.999999999999982 67.83976772291362)))"
25050007525000,39,27,12,44.8,"MULTIPOLYGON(((15.11878239343393 67.83972466915813,15.119010931200295 67.88457196058295,15.23802090817362 67.88444251091839,15.23756383840597 67.83959550849809,15.11878239343393 67.83972466915813)))"
25100007525000,5,3,2,62,"MULTIPOLYGON(((15.23756383840597 67.83959550849809,15.23802090817362 67.88444251091839,15.357028976739905 67.88422676351057,15.356343386500656 67.83938024275277,15.23756383840597 67.83959550849809)))"
25350007525000,6,5,1,71,"MULTIPOLYGON(((15.83142364602423 67.8376582077448,15.833023087603854 67.8825008757272,15.952007306360983 67.88185370973146,15.950179488377703 67.83701248629937,15.83142364602423 67.8376582077448)))"
25400007525000,1,1,0,0,"MULTIPOLYGON(((15.950179488377703 67.83701248629937,15.952007306360983 67.88185370973146,16.070983895243216 67.8811202825761,16.068927746937245 67.83628069614257,15.950179488377703 67.83701248629937)))"
24100007530000,6,4,2,42.7,"MULTIPOLYGON(((12.858727157351495 67.87063979686235,12.854601925766499 67.91545563477791,12.97369564654394 67.91696817871905,12.97759227351529 67.87214896232253,12.858727157351495 67.87063979686235)))"
24150007530000,542,297,245,48.6,"MULTIPOLYGON(((12.97759227351529 67.87214896232253,12.97369564654394 67.91696817871905,13.092805649364001 67.91839440609711,13.096473573306797 67.8735720036181,12.97759227351529 67.87214896232253)))"
24950007530000,22,13,9,51.3,"MULTIPOLYGON(((14.880989068799671 67.88457196058295,14.880759576798495 67.92941900433357,14.999999999999982 67.92946225113266,14.999999999999982 67.88461511067443,14.880989068799671 67.88457196058295)))"
25000007530000,245,124,121,43.1,"MULTIPOLYGON(((14.999999999999982 67.88461511067443,14.999999999999982 67.92946225113266,15.119240423201472 67.92941900433357,15.119010931200295 67.88457196058295,14.999999999999982 67.88461511067443)))"
25050007530000,305,157,148,46.4,"MULTIPOLYGON(((15.119010931200295 67.88457196058295,15.119240423201472 67.92941900433357,15.238479886363956 67.92928926454974,15.23802090817362 67.88444251091839,15.119010931200295 67.88457196058295)))"
25100007530000,59,27,32,39.8,"MULTIPOLYGON(((15.23802090817362 67.88444251091839,15.238479886363956 67.92928926454974,15.35771742949585 67.92907303362149,15.357028976739905 67.88422676351057,15.23802090817362 67.88444251091839)))"
25150007530000,14,8,6,43.6,"MULTIPOLYGON(((15.357028976739905 67.88422676351057,15.35771742949585 67.92907303362149,15.47695209270038 67.92877031461593,15.476034182812954 67.88392472140892,15.357028976739905 67.88422676351057)))"
25200007530000,4,3,1,0,"MULTIPOLYGON(((15.476034182812954 67.88392472140892,15.47695209270038 67.92877031461593,15.596182916222986 67.9283811118268,15.595035572447362 67.88353638888245,15.476034182812954 67.88392472140892)))"
25350007530000,16,9,7,55.4,"MULTIPOLYGON(((15.833023087603854 67.8825008757272,15.834629206199514 67.92734327820374,15.953842754281661 67.92669466208744,15.952007306360983 67.88185370973146,15.833023087603854 67.8825008757272)))"
25500007530000,24,17,7,58.1,"MULTIPOLYGON(((16.18995190171197 67.88030060462258,16.192245863119982 67.92513807722847,16.31143350763539 67.92423013055233,16.308910373650395 67.87939468744918,16.18995190171197 67.88030060462258)))"
24150007535000,311,162,149,47.1,"MULTIPOLYGON(((12.97369564654394 67.91696817871905,12.969782737396422 67.96178704035653,13.089122396861633 67.96321646611298,13.092805649364001 67.91839440609711,12.97369564654394 67.91696817871905)))"
24200007535000,115,64,51,48.3,"MULTIPOLYGON(((13.092805649364001 67.91839440609711,13.089122396861633 67.96321646611298,13.208477478182976 67.96455936186214,13.211930980617863 67.91973429672274,13.092805649364001 67.91839440609711)))"
24950007535000,83,39,44,38.8,"MULTIPOLYGON(((14.880759576798495 67.92941900433357,14.880529124750415 67.97426580080754,14.999999999999982 67.97430914468814,14.999999999999982 67.92946225113266,14.880759576798495 67.92941900433357)))"
25000007535000,83,41,42,43.2,"MULTIPOLYGON(((14.999999999999982 67.92946225113266,14.999999999999982 67.97430914468814,15.11947087524955 67.97426580080754,15.119240423201472 67.92941900433357,14.999999999999982 67.92946225113266)))"
25050007535000,64,35,29,42,"MULTIPOLYGON(((15.119240423201472 67.92941900433357,15.11947087524955 67.97426580080754,15.238940784600688 67.9741357697828,15.238479886363956 67.92928926454974,15.119240423201472 67.92941900433357)))"
25100007535000,33,18,15,43,"MULTIPOLYGON(((15.238479886363956 67.92928926454974,15.238940784600688 67.9741357697828,15.358408762202862 67.97391905346488,15.35771742949585 67.92907303362149,15.238479886363956 67.92928926454974)))"
25150007535000,7,3,4,71.9,"MULTIPOLYGON(((15.35771742949585 67.92907303362149,15.358408762202862 67.97391905346488,15.477873842301324 67.97361565493867,15.47695209270038 67.92877031461593,15.35771742949585 67.92907303362149)))"
25200007535000,3,1,2,0,"MULTIPOLYGON(((15.47695209270038 67.92877031461593,15.477873842301324 67.97361565493867,15.597335059284996 67.97322557852273,15.596182916222986 67.9283811118268,15.47695209270038 67.92877031461593)))"
25350007535000,197,104,93,45,"MULTIPOLYGON(((15.834629206199514 67.92734327820374,15.836242042469102 67.97218541546283,15.95568587859633 67.97153534362174,15.953842754281661 67.92669466208744,15.834629206199514 67.92734327820374)))"
25600007535000,1,1,0,0,"MULTIPOLYGON(((16.43061060214495 67.92323576446196,16.43337435189427 67.9680686843801,16.552769934980933 67.96698548823811,16.549776189734683 67.92215499304837,16.43061060214495 67.92323576446196)))"
24150007540000,3,2,1,0,"MULTIPOLYGON(((12.969782737396422 67.96178704035653,12.96585344685521 68.00660554697467,13.085423722376081 68.00803818348074,13.089122396861633 67.96321646611298,12.969782737396422 67.96178704035653)))"
24200007540000,23,11,12,59.6,"MULTIPOLYGON(((13.089122396861633 67.96321646611298,13.085423722376081 68.00803818348074,13.205009513937746 68.0093840959795,13.208477478182976 67.96455936186214,13.089122396861633 67.96321646611298)))"
24250007540000,48,24,24,47.5,"MULTIPOLYGON(((13.208477478182976 67.96455936186214,13.205009513937746 68.0093840959795,13.324609855526512 68.01064326527883,13.327847021195478 67.96581570852244,13.208477478182976 67.96455936186214)))"
25000007540000,3,2,1,0,"MULTIPOLYGON(((14.999999999999982 67.97430914468814,14.999999999999982 68.01915579174123,15.119702293204044 68.01911235040298,15.11947087524955 67.97426580080754,14.999999999999982 67.97430914468814)))"
25050007540000,1,0,1,0,"MULTIPOLYGON(((15.11947087524955 67.97426580080754,15.119702293204044 68.01911235040298,15.239403614602349 68.01898202700882,15.238940784600688 67.9741357697828,15.11947087524955 67.97426580080754)))"
25100007540000,142,70,72,50.5,"MULTIPOLYGON(((15.238940784600688 67.9741357697828,15.239403614602349 68.01898202700882,15.35910299243753 68.01876482342047,15.358408762202862 67.97391905346488,15.238940784600688 67.9741357697828)))"
25150007540000,36,18,18,51.9,"MULTIPOLYGON(((15.358408762202862 67.97391905346488,15.35910299243753 68.01876482342047,15.478799455048982 68.01846074274077,15.477873842301324 67.97361565493867,15.358408762202862 67.97391905346488)))"
25200007540000,20,12,8,54.2,"MULTIPOLYGON(((15.477873842301324 67.97361565493867,15.478799455048982 68.01846074274077,15.598492030921243 68.01806978931334,15.597335059284996 67.97322557852273,15.477873842301324 67.97361565493867)))"
25250007540000,10,2,8,45.2,"MULTIPOLYGON(((15.597335059284996 67.97322557852273,15.598492030921243 68.01806978931334,15.718179748732329 68.01759196872246,15.716791447734316 67.97274882976909,15.597335059284996 67.97322557852273)))"
25300007540000,11,6,5,61.1,"MULTIPOLYGON(((15.716791447734316 67.97274882976909,15.718179748732329 68.01759196872246,15.837861637402073 68.01702728779256,15.836242042469102 67.97218541546283,15.716791447734316 67.97274882976909)))"
25350007540000,14,9,5,53.1,"MULTIPOLYGON(((15.836242042469102 67.97218541546283,15.837861637402073 68.01702728779256,15.957536726140416 68.01637575458803,15.95568587859633 67.97153534362174,15.836242042469102 67.97218541546283)))"
25400007540000,3,2,1,0,"MULTIPOLYGON(((15.95568587859633 67.97153534362174,15.957536726140416 68.01637575458803,16.077204044495673 68.01563737841253,16.075121991557925 67.97079862349581,15.95568587859633 67.97153534362174)))"
25450007540000,35,17,18,42.4,"MULTIPOLYGON(((16.075121991557925 67.97079862349581,16.077204044495673 68.01563737841253,16.19686262240273 68.01481216980862,16.194549417178482 67.9699752655667,16.075121991557925 67.97079862349581)))"
25550007540000,1,1,0,0,"MULTIPOLYGON(((16.313967191712948 67.96906528154715,16.31651149023125 68.01390014055693,16.436149678833758 68.01290130367558,16.43337435189427 67.9680686843801,16.313967191712948 67.96906528154715)))"
24150007545000,1,1,0,0,"MULTIPOLYGON(((12.96585344685521 68.00660554697467,12.961907674893332 68.05142369830853,13.081709531721383 68.0528595580112,13.085423722376081 68.00803818348074,12.96585344685521 68.00660554697467)))"
24200007545000,82,42,40,50.3,"MULTIPOLYGON(((13.085423722376081 68.00803818348074,13.081709531721383 68.0528595580112,13.201526999545 68.054208498957,13.205009513937746 68.0093840959795,13.085423722376081 68.00803818348074)))"
24250007545000,61,33,28,45.3,"MULTIPOLYGON(((13.205009513937746 68.0093840959795,13.201526999545 68.054208498957,13.321359106454114 68.05547050184222,13.324609855526512 68.01064326527883,13.205009513937746 68.0093840959795)))"
24300007545000,21,8,13,49.4,"MULTIPOLYGON(((13.324609855526512 68.01064326527883,13.321359106454114 68.05547050184222,13.441204879808831 68.05664554860314,13.444223780406265 68.01181567341933,13.324609855526512 68.01064326527883)))"
25100007545000,29,14,15,60,"MULTIPOLYGON(((15.239403614602349 68.01898202700882,15.239868388183263 68.06382803661953,15.359800137920116 68.06361034386849,15.35910299243753 68.01876482342047,15.239403614602349 68.01898202700882)))"
25150007545000,60,27,33,52.1,"MULTIPOLYGON(((15.35910299243753 68.01876482342047,15.359800137920116 68.06361034386849,15.479728954568083 68.0633055783863,15.478799455048982 68.01846074274077,15.35910299243753 68.01876482342047)))"
25300007545000,3,2,1,0,"MULTIPOLYGON(((15.718179748732329 68.01759196872246,15.719573878920032 68.06243484795195,15.839488032322837 68.06186889548073,15.837861637402073 68.01702728779256,15.718179748732329 68.01759196872246)))"
25400007545000,227,115,112,45,"MULTIPOLYGON(((15.957536726140416 68.01637575458803,15.959395344132027 68.06121589523949,16.079294837954073 68.06047585658608,16.077204044495673 68.01563737841253,15.957536726140416 68.01637575458803)))"
25450007545000,474,258,216,41.7,"MULTIPOLYGON(((16.077204044495673 68.01563737841253,16.079294837954073 68.06047585658608,16.199185537786004 68.0596487901243,16.19686262240273 68.01481216980862,16.077204044495673 68.01563737841253)))"
24200007550000,177,90,87,45.8,"MULTIPOLYGON(((13.081709531721383 68.0528595580112,13.077979729941454 68.09768058951094,13.19802984594512 68.09903257067305,13.201526999545 68.054208498957,13.081709531721383 68.0528595580112)))"
24250007550000,278,134,144,47.8,"MULTIPOLYGON(((13.201526999545 68.054208498957,13.19802984594512 68.09903257067305,13.318094690822516 68.10029741815835,13.321359106454114 68.05547050184222,13.201526999545 68.054208498957)))"
24300007550000,12,7,5,39.2,"MULTIPOLYGON(((13.321359106454114 68.05547050184222,13.318094690822516 68.10029741815835,13.438173285981726 68.10147511379793,13.441204879808831 68.05664554860314,13.321359106454114 68.05547050184222)))"
24350007550000,1063,540,523,39.9,"MULTIPOLYGON(((13.441204879808831 68.05664554860314,13.438173285981726 68.10147511379793,13.55826465214226 68.10256564067107,13.561063346287671 68.05773362241708,13.441204879808831 68.05664554860314)))"
24400007550000,58,30,28,43.3,"MULTIPOLYGON(((13.561063346287671 68.05773362241708,13.55826465214226 68.10256564067107,13.678367809383884 68.10356898310633,13.680933531935906 68.05873470770337,13.561063346287671 68.05773362241708)))"
24450007550000,18,12,6,41.1,"MULTIPOLYGON(((13.680933531935906 68.05873470770337,13.678367809383884 68.10356898310633,13.79848177719551 68.10448512668248,13.800814462213962 68.0596487901243,13.680933531935906 68.05873470770337)))"
25150007550000,22,11,11,48,"MULTIPOLYGON(((15.359800137920116 68.06361034386849,15.36050021651602 68.10845561518951,15.480662364676848 68.10815016223953,15.479728954568083 68.0633055783863,15.359800137920116 68.06361034386849)))"
25200007550000,66,31,35,46.1,"MULTIPOLYGON(((15.479728954568083 68.0633055783863,15.480662364676848 68.10815016223953,15.600820578267227 68.1077574445516,15.599653860658966 68.06291374454187,15.479728954568083 68.0633055783863)))"
25250007550000,572,274,298,44,"MULTIPOLYGON(((15.599653860658966 68.06291374454187,15.600820578267227 68.1077574445516,15.720973874014847 68.10727746777526,15.719573878920032 68.06243484795195,15.599653860658966 68.06291374454187)))"
25350007550000,23,13,10,53.9,"MULTIPOLYGON(((15.839488032322837 68.06186889548073,15.841121268894197 68.10671023881477,15.961261780175871 68.10605576582866,15.959395344132027 68.06121589523949,15.839488032322837 68.06186889548073)))"
25550007550000,779,413,366,49.2,"MULTIPOLYGON(((16.319066468064058 68.05873470770337,16.32163219061608 68.10356898310633,16.441735347857705 68.10256564067107,16.438936653712293 68.05773362241708,16.319066468064058 68.05873470770337)))"
24200007555000,2,2,0,0,"MULTIPOLYGON(((13.077979729941454 68.09768058951094,13.074234221302195 68.14250127778232,13.194517963348623 68.14385631100248,13.19802984594512 68.09903257067305,13.077979729941454 68.09768058951094)))"
24250007555000,93,41,52,53.6,"MULTIPOLYGON(((13.19802984594512 68.09903257067305,13.194517963348623 68.14385631100248,13.314816524794338 68.14512401416988,13.318094690822516 68.10029741815835,13.19802984594512 68.09903257067305)))"
24300007555000,255,134,121,43.2,"MULTIPOLYGON(((13.318094690822516 68.10029741815835,13.314816524794338 68.14512401416988,13.435128921046667 68.14630436900954,13.438173285981726 68.10147511379793,13.318094690822516 68.10029741815835)))"
24350007555000,1912,949,963,40.6,"MULTIPOLYGON(((13.438173285981726 68.10147511379793,13.435128921046667 68.14630436900954,13.555454166817286 68.14739735850196,13.55826465214226 68.10256564067107,13.438173285981726 68.10147511379793)))"
24400007555000,3063,1487,1576,41.7,"MULTIPOLYGON(((13.55826465214226 68.10256564067107,13.555454166817286 68.14739735850196,13.675791276171546 68.14840296688416,13.678367809383884 68.10356898310633,13.55826465214226 68.10256564067107)))"
24450007555000,228,113,115,49.6,"MULTIPOLYGON(((13.678367809383884 68.10356898310633,13.675791276171546 68.14840296688416,13.796139262577874 68.14932117965067,13.79848177719551 68.10448512668248,13.678367809383884 68.10356898310633)))"
24500007555000,1170,577,593,42.7,"MULTIPOLYGON(((13.79848177719551 68.10448512668248,13.796139262577874 68.14932117965067,13.916497138957245 68.15015198355438,13.918605574524175 68.10531405822934,13.79848177719551 68.10448512668248)))"
24650007555000,114,56,58,43.3,"MULTIPOLYGON(((14.158878731105768 68.10671023881477,14.157238610879167 68.15155131808177,14.27762022997269 68.15211982851005,14.27902612598512 68.10727746777526,14.158878731105768 68.10671023881477)))"
24850007555000,1,1,0,0,"MULTIPOLYGON(((14.639499783483947 68.10845561518951,14.638796753762687 68.15330063776456,14.759196186174966 68.15351931456453,14.759664882745438 68.10867379900718,14.639499783483947 68.10845561518951)))"
25150007555000,25,13,12,64,"MULTIPOLYGON(((15.36050021651602 68.10845561518951,15.361203246237277 68.15330063776456,15.481599709388977 68.15299449466501,15.480662364676848 68.10815016223953,15.36050021651602 68.10845561518951)))"
25200007555000,28,19,9,48.8,"MULTIPOLYGON(((15.480662364676848 68.10815016223953,15.481599709388977 68.15299449466501,15.60199221375938 68.15260088968601,15.600820578267227 68.1077574445516,15.480662364676848 68.10815016223953)))"
25250007555000,51,27,24,48,"MULTIPOLYGON(((15.600820578267227 68.1077574445516,15.60199221375938 68.15260088968601,15.722379770027276 68.15211982851005,15.720973874014847 68.10727746777526,15.600820578267227 68.1077574445516)))"
25300007555000,5,3,2,77.2,"MULTIPOLYGON(((15.720973874014847 68.10727746777526,15.722379770027276 68.15211982851005,15.842761389120797 68.15155131808177,15.841121268894197 68.10671023881477,15.720973874014847 68.10727746777526)))"
25350007555000,251,131,120,45.6,"MULTIPOLYGON(((15.841121268894197 68.10671023881477,15.842761389120797 68.15155131808177,15.963136082267221 68.15089536660741,15.961261780175871 68.10605576582866,15.841121268894197 68.10671023881477)))"
25450007555000,2,1,1,0,"MULTIPOLYGON(((16.08139442547579 68.10531405822934,16.08350286104272 68.15015198355438,16.20386073742209 68.14932117965067,16.201518222804456 68.10448512668248,16.08139442547579 68.10531405822934)))"
25500007555000,19,10,9,63.6,"MULTIPOLYGON(((16.201518222804456 68.10448512668248,16.20386073742209 68.14932117965067,16.32420872382842 68.14840296688416,16.32163219061608 68.10356898310633,16.201518222804456 68.10448512668248)))"
25550007555000,10,6,4,34.2,"MULTIPOLYGON(((16.32163219061608 68.10356898310633,16.32420872382842 68.14840296688416,16.44454583318268 68.14739735850196,16.441735347857705 68.10256564067107,16.32163219061608 68.10356898310633)))"
24300007560000,23,15,8,59.9,"MULTIPOLYGON(((13.314816524794338 68.14512401416988,13.311524523843604 68.1899502898162,13.432071706485594 68.19113331424109,13.435128921046667 68.14630436900954,13.314816524794338 68.14512401416988)))"
24350007560000,82,37,45,39.2,"MULTIPOLYGON(((13.435128921046667 68.14630436900954,13.432071706485594 68.19113331424109,13.552631817809182 68.19222877597186,13.555454166817286 68.14739735850196,13.435128921046667 68.14630436900954)))"
24400007560000,1840,923,917,39.3,"MULTIPOLYGON(((13.555454166817286 68.14739735850196,13.552631817809182 68.19222877597186,13.673203865815902 68.19323665915327,13.675791276171546 68.14840296688416,13.555454166817286 68.14739735850196)))"
24450007560000,172,95,77,41.4,"MULTIPOLYGON(((13.675791276171546 68.14840296688416,13.673203865815902 68.19323665915327,13.793786857904209 68.19415694919496,13.796139262577874 68.14932117965067,13.675791276171546 68.14840296688416)))"
24500007560000,68,35,33,51.5,"MULTIPOLYGON(((13.796139262577874 68.14932117965067,13.793786857904209 68.19415694919496,13.914379800919473 68.19498963277223,13.916497138957245 68.15015198355438,13.796139262577874 68.14932117965067)))"
24550007560000,19,12,7,62.8,"MULTIPOLYGON(((13.916497138957245 68.15015198355438,13.914379800919473 68.19498963277223,14.034981701204034 68.195734697827,14.036863917732745 68.15089536660741,13.916497138957245 68.15015198355438)))"
24650007560000,394,203,191,40.3,"MULTIPOLYGON(((14.157238610879167 68.15155131808177,14.155591564647318 68.1963921335685,14.27620839673603 68.1969619304738,14.27762022997269 68.15211982851005,14.157238610879167 68.15155131808177)))"
24700007560000,64,36,28,31.5,"MULTIPOLYGON(((14.27762022997269 68.15211982851005,14.27620839673603 68.1969619304738,14.39683120260437 68.19744408028862,14.398007786240587 68.15260088968601,14.27762022997269 68.15211982851005)))"
24750007560000,5,4,1,14.2,"MULTIPOLYGON(((14.398007786240587 68.15260088968601,14.39683120260437 68.19744408028862,14.517458987084309 68.19783857602765,14.51840029061099 68.15299449466501,14.398007786240587 68.15260088968601)))"
24850007560000,195,101,94,46.2,"MULTIPOLYGON(((14.638796753762687 68.15330063776456,14.63809075475591 68.19814541197508,14.758725509997664 68.1983645836849,14.759196186174966 68.15351931456453,14.638796753762687 68.15330063776456)))"
25200007560000,3,0,3,0,"MULTIPOLYGON(((15.481599709388977 68.15299449466501,15.482541012915657 68.19783857602765,15.603168797395597 68.19744408028862,15.60199221375938 68.15260088968601,15.481599709388977 68.15299449466501)))"
25250007560000,97,48,49,47.2,"MULTIPOLYGON(((15.60199221375938 68.15260088968601,15.603168797395597 68.19744408028862,15.723791603263935 68.1969619304738,15.722379770027276 68.15211982851005,15.60199221375938 68.15260088968601)))"
25350007560000,8,5,3,74.5,"MULTIPOLYGON(((15.842761389120797 68.15155131808177,15.84440843535265 68.1963921335685,15.965018298795934 68.195734697827,15.963136082267221 68.15089536660741,15.842761389120797 68.15155131808177)))"
25400007560000,84,55,29,50.9,"MULTIPOLYGON(((15.963136082267221 68.15089536660741,15.965018298795934 68.195734697827,16.085620199080495 68.19498963277223,16.08350286104272 68.15015198355438,15.963136082267221 68.15089536660741)))"
25450007560000,11,7,4,55,"MULTIPOLYGON(((16.08350286104272 68.15015198355438,16.085620199080495 68.19498963277223,16.20621314209576 68.19415694919496,16.20386073742209 68.14932117965067,16.08350286104272 68.15015198355438)))"
25550007560000,1,1,0,0,"MULTIPOLYGON(((16.32420872382842 68.14840296688416,16.326796134184065 68.19323665915327,16.447368182190786 68.19222877597186,16.44454583318268 68.14739735850196,16.32420872382842 68.14840296688416)))"
25600007560000,3,2,1,0,"MULTIPOLYGON(((16.44454583318268 68.14739735850196,16.447368182190786 68.19222877597186,16.56792829351437 68.19113331424109,16.5648710789533 68.14630436900954,16.44454583318268 68.14739735850196)))"
26050007560000,2,1,1,0,"MULTIPOLYGON(((17.526927792088266 68.13441688825417,17.531860573359108 68.17921896037892,17.652268703402388 68.17733615661474,17.64710198644067 68.13253832865097,17.526927792088266 68.13441688825417)))"
24350007565000,35,22,13,38.2,"MULTIPOLYGON(((13.432071706485594 68.19113331424109,13.429001563134086 68.23596194949303,13.549797532017429 68.23705989314077,13.552631817809182 68.19222877597186,13.432071706485594 68.19113331424109)))"
24400007565000,84,41,43,37.4,"MULTIPOLYGON(((13.552631817809182 68.19222877597186,13.549797532017429 68.23705989314077,13.670605511286483 68.23807006002846,13.673203865815902 68.19323665915327,13.552631817809182 68.19222877597186)))"
24450007565000,426,233,193,41.5,"MULTIPOLYGON(((13.673203865815902 68.19323665915327,13.670605511286483 68.23807006002846,13.791424502219746 68.23899243548014,13.793786857904209 68.19415694919496,13.673203865815902 68.19323665915327)))"
24500007565000,52,33,19,50.5,"MULTIPOLYGON(((13.793786857904209 68.19415694919496,13.791424502219746 68.23899243548014,13.912253505536917 68.23982700609298,13.914379800919473 68.19498963277223,13.793786857904209 68.19415694919496)))"
24550007565000,34,19,15,55.4,"MULTIPOLYGON(((13.914379800919473 68.19498963277223,13.912253505536917 68.23982700609298,14.03309152144947 68.24057375973808,14.034981701204034 68.195734697827,13.914379800919473 68.19498963277223)))"
24600007565000,52,26,26,50.2,"MULTIPOLYGON(((14.034981701204034 68.195734697827,14.03309152144947 68.24057375973808,14.153937549711289 68.24123268556133,14.155591564647318 68.1963921335685,14.034981701204034 68.195734697827)))"
24650007565000,41,25,16,54.4,"MULTIPOLYGON(((14.155591564647318 68.1963921335685,14.153937549711289 68.24123268556133,14.27479058966937 68.24180377398393,14.27620839673603 68.1969619304738,14.155591564647318 68.1963921335685)))"
24700007565000,374,187,187,39.6,"MULTIPOLYGON(((14.27620839673603 68.1969619304738,14.27479058966937 68.24180377398393,14.395649640314565 68.2422870167031,14.39683120260437 68.19744408028862,14.27620839673603 68.1969619304738)))"
24750007565000,2464,1240,1224,39.4,"MULTIPOLYGON(((14.39683120260437 68.19744408028862,14.395649640314565 68.2422870167031,14.516513700332371 68.24268240669257,14.517458987084309 68.19783857602765,14.39683120260437 68.19744408028862)))"
24800007565000,3705,1865,1840,44.2,"MULTIPOLYGON(((14.517458987084309 68.19783857602765,14.516513700332371 68.24268240669257,14.637381768153778 68.24298993820291,14.63809075475591 68.19814541197508,14.517458987084309 68.19783857602765)))"
24850007565000,4,1,3,0,"MULTIPOLYGON(((14.63809075475591 68.19814541197508,14.637381768153778 68.24298993820291,14.75825284200611 68.24320960676205,14.758725509997664 68.1983645836849,14.63809075475591 68.19814541197508)))"
24900007565000,11,6,5,57.5,"MULTIPOLYGON(((14.758725509997664 68.1983645836849,14.75825284200611 68.24320960676205,14.879125919963942 68.2433414091754,14.87936225703686 68.1984960879812,14.758725509997664 68.1983645836849)))"
25400007565000,82,39,43,49.8,"MULTIPOLYGON(((15.965018298795934 68.195734697827,15.966908478550497 68.24057375973808,16.087746494463047 68.23982700609298,16.085620199080495 68.19498963277223,15.965018298795934 68.195734697827)))"
25500007565000,4,3,1,0,"MULTIPOLYGON(((16.20621314209576 68.19415694919496,16.20857549778022 68.23899243548014,16.329394488713483 68.23807006002846,16.326796134184065 68.19323665915327,16.20621314209576 68.19415694919496)))"
25550007565000,5,4,1,72.2,"MULTIPOLYGON(((16.326796134184065 68.19323665915327,16.329394488713483 68.23807006002846,16.450202467982535 68.23705989314077,16.447368182190786 68.19222877597186,16.326796134184065 68.19323665915327)))"
25950007565000,7,5,2,58.4,"MULTIPOLYGON(((17.290982787692958 68.18272237062315,17.29546618678055 68.22753195767486,17.416150176285907 68.2258200943702,17.41143160632771 68.18101437369258,17.290982787692958 68.18272237062315)))"
26000007565000,26,13,13,47.5,"MULTIPOLYGON(((17.41143160632771 68.18101437369258,17.416150176285907 68.2258200943702,17.536814191792867 68.22402061742225,17.531860573359108 68.17921896037892,17.41143160632771 68.18101437369258)))"
26050007565000,14,7,7,54.2,"MULTIPOLYGON(((17.531860573359108 68.17921896037892,17.536814191792867 68.22402061742225,17.65745724187115 68.22213355291542,17.652268703402388 68.17733615661474,17.531860573359108 68.17921896037892)))"
24400007570000,177,90,87,40.2,"MULTIPOLYGON(((13.549797532017429 68.23705989314077,13.546951235738415 68.28189071006638,13.667996144999723 68.28290316962263,13.670605511286483 68.23807006002846,13.549797532017429 68.23705989314077)))"
24450007570000,574,280,294,39.5,"MULTIPOLYGON(((13.670605511286483 68.23807006002846,13.667996144999723 68.28290316962263,13.789052134066669 68.28382763866962,13.791424502219746 68.23899243548014,13.670605511286483 68.23807006002846)))"
24500007570000,145,73,72,44.8,"MULTIPOLYGON(((13.791424502219746 68.23899243548014,13.789052134066669 68.28382763866962,13.910118197482713 68.28466410372566,13.912253505536917 68.23982700609298,13.791424502219746 68.23899243548014)))"
24550007570000,107,59,48,52,"MULTIPOLYGON(((13.912253505536917 68.23982700609298,13.910118197482713 68.28466410372566,14.031193329277823 68.28541255259054,14.03309152144947 68.24057375973808,13.912253505536917 68.23982700609298)))"
24600007570000,64,34,30,48.7,"MULTIPOLYGON(((14.03309152144947 68.24057375973808,14.031193329277823 68.28541255259054,14.15227652301964 68.28607297434627,14.153937549711289 68.24123268556133,14.03309152144947 68.24057375973808)))"
24650007570000,29,16,13,37.6,"MULTIPOLYGON(((14.153937549711289 68.24123268556133,14.15227652301964 68.28607297434627,14.273366771864707 68.28664535935769,14.27479058966937 68.24180377398393,14.153937549711289 68.24123268556133)))"
24700007570000,86,42,44,47,"MULTIPOLYGON(((14.27479058966937 68.24180377398393,14.273366771864707 68.28664535935769,14.394463068609726 68.28712969927322,14.395649640314565 68.2422870167031,14.27479058966937 68.24180377398393)))"
24800007570000,1054,525,529,38.7,"MULTIPOLYGON(((14.516513700332371 68.24268240669257,14.515564405742897 68.28752598702518,14.636669775495255 68.28783421683036,14.637381768153778 68.24298993820291,14.516513700332371 68.24268240669257)))"
24850007570000,45,22,23,41.2,"MULTIPOLYGON(((14.637381768153778 68.24298993820291,14.636669775495255 68.28783421683036,14.757778169892086 68.2880543841903,14.75825284200611 68.24320960676205,14.637381768153778 68.24298993820291)))"
24950007570000,9,7,2,67.6,"MULTIPOLYGON(((14.879125919963942 68.2433414091754,14.87888858080432 68.28818648589167,14.999999999999982 68.28823052000637,14.999999999999982 68.24338534352619,14.879125919963942 68.2433414091754)))"
25000007570000,14,7,7,56.9,"MULTIPOLYGON(((14.999999999999982 68.24338534352619,14.999999999999982 68.28823052000637,15.121111419195646 68.28818648589167,15.120874080036025 68.2433414091754,14.999999999999982 68.24338534352619)))"
25350007570000,1,0,1,0,"MULTIPOLYGON(((15.846062450288674 68.24123268556133,15.847723476980326 68.28607297434627,15.968806670722143 68.28541255259054,15.966908478550497 68.24057375973808,15.846062450288674 68.24123268556133)))"
25400007570000,35,17,18,58.2,"MULTIPOLYGON(((15.966908478550497 68.24057375973808,15.968806670722143 68.28541255259054,16.089881802517255 68.28466410372566,16.087746494463047 68.23982700609298,15.966908478550497 68.24057375973808)))"
25500007570000,1,1,0,0,"MULTIPOLYGON(((16.20857549778022 68.23899243548014,16.2109478659333 68.28382763866962,16.332003855000245 68.28290316962263,16.329394488713483 68.23807006002846,16.20857549778022 68.23899243548014)))"
25550007570000,13,7,6,61.5,"MULTIPOLYGON(((16.329394488713483 68.23807006002846,16.332003855000245 68.28290316962263,16.45304876426155 68.28189071006638,16.450202467982535 68.23705989314077,16.329394488713483 68.23807006002846)))"
25650007570000,7,5,2,72.6,"MULTIPOLYGON(((16.570998436865878 68.23596194949303,16.574081588825248 68.2807902747631,16.695101324414996 68.27960187975486,16.691781397251315 68.23477624503353,16.570998436865878 68.23596194949303)))"
25700007570000,15,8,7,62.2,"MULTIPOLYGON(((16.691781397251315 68.23477624503353,16.695101324414996 68.27960187975486,16.81610696742098 68.27832554236232,16.81255035168638 68.23350279698177,16.691781397251315 68.23477624503353)))"
25950007570000,197,98,99,49.4,"MULTIPOLYGON(((17.29546618678055 68.22753195767486,17.29996856758631 68.27234116005718,17.420888720410844 68.27062541523023,17.416150176285907 68.2258200943702,17.29546618678055 68.22753195767486)))"
26000007570000,7,4,3,36.6,"MULTIPOLYGON(((17.416150176285907 68.2258200943702,17.420888720410844 68.27062541523023,17.541788775831908 68.26882185873113,17.536814191792867 68.22402061742225,17.416150176285907 68.2258200943702)))"
24450007575000,88,48,40,43.9,"MULTIPOLYGON(((13.667996144999723 68.28290316962263,13.665375698813218 68.32773598804691,13.786669691478911 68.32866255892534,13.789052134066669 68.28382763866962,13.667996144999723 68.28290316962263)))"
24500007575000,80,42,38,51.4,"MULTIPOLYGON(((13.789052134066669 68.28382763866962,13.786669691478911 68.32866255892534,13.907973820972389 68.32950092587829,13.910118197482713 68.28466410372566,13.789052134066669 68.28382763866962)))"
24550007575000,56,32,24,43.6,"MULTIPOLYGON(((13.910118197482713 68.28466410372566,13.907973820972389 68.32950092587829,14.029287075090949 68.33025107663362,14.031193329277823 68.28541255259054,13.910118197482713 68.28466410372566)))"
24600007575000,32,19,13,37.4,"MULTIPOLYGON(((14.031193329277823 68.28541255259054,14.029287075090949 68.33025107663362,14.150608441164772 68.33091300020892,14.15227652301964 68.28607297434627,14.031193329277823 68.28541255259054)))"
24650007575000,99,47,52,46.6,"MULTIPOLYGON(((14.15227652301964 68.28607297434627,14.150608441164772 68.33091300020892,14.27193690610867 68.33148668691229,14.273366771864707 68.28664535935769,14.15227652301964 68.28607297434627)))"
24700007575000,177,96,81,42,"MULTIPOLYGON(((14.273366771864707 68.28664535935769,14.27193690610867 68.33148668691229,14.39327145647388 68.33197212834281,14.394463068609726 68.28712969927322,14.273366771864707 68.28664535935769)))"
24750007575000,4,2,2,0,"MULTIPOLYGON(((14.394463068609726 68.28712969927322,14.39327145647388 68.33197212834281,14.514611078499934 68.33236931739118,14.515564405742897 68.28752598702518,14.394463068609726 68.28712969927322)))"
24800007575000,3,1,2,0,"MULTIPOLYGON(((14.515564405742897 68.28752598702518,14.514611078499934 68.33236931739118,14.635954758166541 68.33267824824004,14.636669775495255 68.28783421683036,14.515564405742897 68.28752598702518)))"
24850007575000,57,30,27,46.7,"MULTIPOLYGON(((14.636669775495255 68.28783421683036,14.635954758166541 68.33267824824004,14.757301481245506 68.33289891636444,14.757778169892086 68.2880543841903,14.636669775495255 68.28783421683036)))"
24900007575000,11,6,5,53.4,"MULTIPOLYGON(((14.757778169892086 68.2880543841903,14.757301481245506 68.33289891636444,14.87865023335269 68.33303131853208,14.87888858080432 68.28818648589167,14.757778169892086 68.2880543841903)))"
24950007575000,50,22,28,54.5,"MULTIPOLYGON(((14.87888858080432 68.28818648589167,14.87865023335269 68.33303131853208,14.999999999999982 68.33307545280346,14.999999999999982 68.28823052000637,14.87888858080432 68.28818648589167)))"
25000007575000,38,20,18,49.9,"MULTIPOLYGON(((14.999999999999982 68.28823052000637,14.999999999999982 68.33307545280346,15.121349766647276 68.33303131853208,15.121111419195646 68.28818648589167,14.999999999999982 68.28823052000637)))"
25050007575000,4,2,2,0,"MULTIPOLYGON(((15.121111419195646 68.28818648589167,15.121349766647276 68.33303131853208,15.24269851875446 68.33289891636444,15.24222183010788 68.2880543841903,15.121111419195646 68.28818648589167)))"
25200007575000,9,6,3,52.3,"MULTIPOLYGON(((15.484435594257068 68.28752598702518,15.485388921500032 68.33236931739118,15.606728543526087 68.33197212834281,15.60553693139024 68.28712969927322,15.484435594257068 68.28752598702518)))"
25250007575000,58,28,30,51.7,"MULTIPOLYGON(((15.60553693139024 68.28712969927322,15.606728543526087 68.33197212834281,15.728063093891299 68.33148668691229,15.726633228135258 68.28664535935769,15.60553693139024 68.28712969927322)))"
25550007575000,20,10,10,60.1,"MULTIPOLYGON(((16.332003855000245 68.28290316962263,16.334624301186746 68.32773598804691,16.45590714534077 68.32672122680411,16.45304876426155 68.28189071006638,16.332003855000245 68.28290316962263)))"
25600007575000,5,3,2,60.4,"MULTIPOLYGON(((16.45304876426155 68.28189071006638,16.45590714534077 68.32672122680411,16.577177829869672 68.32561829004622,16.574081588825248 68.2807902747631,16.45304876426155 68.28189071006638)))"
25650007575000,32,20,12,52.4,"MULTIPOLYGON(((16.574081588825248 68.2807902747631,16.577177829869672 68.32561829004622,16.698435344282 68.3244271939098,16.695101324414996 68.27960187975486,16.574081588825248 68.2807902747631)))"
25700007575000,74,39,35,47.7,"MULTIPOLYGON(((16.695101324414996 68.27960187975486,16.698435344282 68.3244271939098,16.81967867875976 68.32314795581757,16.81610696742098 68.27832554236232,16.695101324414996 68.27960187975486)))"
25800007575000,1,0,1,0,"MULTIPOLYGON(((16.93709751495082 68.27696128118392,16.9409068242098 68.32178059447745,17.06211877231513 68.32032512988141,17.058071964880316 68.27550911609448,16.93709751495082 68.27696128118392)))"
25850007575000,4,3,1,0,"MULTIPOLYGON(((17.058071964880316 68.27550911609448,17.06211877231513 68.32032512988141,17.183313515586086 68.31878158330409,17.179029315904117 68.2739690682442,17.058071964880316 68.27550911609448)))"
25900007575000,9,6,3,69.2,"MULTIPOLYGON(((17.179029315904117 68.2739690682442,17.183313515586086 68.31878158330409,17.304490047411427 68.3171499773016,17.29996856758631 68.27234116005718,17.179029315904117 68.2739690682442)))"
25950007575000,6,3,3,73.3,"MULTIPOLYGON(((17.29996856758631 68.27234116005718,17.304490047411427 68.3171499773016,17.42564736210933 68.31543033571013,17.420888720410844 68.27062541523023,17.29996856758631 68.27234116005718)))"
24500007580000,3,3,0,0,"MULTIPOLYGON(((13.786669691478911 68.32866255892534,13.7842771119769 68.37349719640794,13.905820319759124 68.3743374727579,13.907973820972389 68.32950092587829,13.786669691478911 68.32866255892534)))"
24550007580000,14,8,6,57.2,"MULTIPOLYGON(((13.907973820972389 68.32950092587829,13.905820319759124 68.3743374727579,14.027372708879582 68.37508933211585,14.029287075090949 68.33025107663362,13.907973820972389 68.32950092587829)))"
24600007580000,24,14,10,49.8,"MULTIPOLYGON(((14.029287075090949 68.33025107663362,14.027372708879582 68.37508933211585,14.148933260379236 68.37575276343452,14.150608441164772 68.33091300020892,14.029287075090949 68.33025107663362)))"
24650007580000,31,18,13,38.5,"MULTIPOLYGON(((14.150608441164772 68.33091300020892,14.148933260379236 68.37575276343452,14.270500954879362 68.37632775696468,14.27193690610867 68.33148668691229,14.150608441164772 68.33091300020892)))"
24750007580000,37,22,15,43.5,"MULTIPOLYGON(((14.39327145647388 68.33197212834281,14.392074772633883 68.3768143042558,14.513653693581771 68.37721239815649,14.514611078499934 68.33236931739118,14.39327145647388 68.33197212834281)))"
24850007580000,186,102,84,50.4,"MULTIPOLYGON(((14.635954758166541 68.33267824824004,14.635236697399474 68.37752203281508,14.756822763553375 68.37774320367981,14.757301481245506 68.33289891636444,14.635954758166541 68.33267824824004)))"
24900007580000,10,6,4,56.1,"MULTIPOLYGON(((14.757301481245506 68.33289891636444,14.756822763553375 68.37774320367981,14.878410871352294 68.37787590749929,14.87865023335269 68.33303131853208,14.757301481245506 68.33289891636444)))"
25000007580000,1,1,0,0,"MULTIPOLYGON(((14.999999999999982 68.33307545280346,14.999999999999982 68.37792014232255,15.121589128647672 68.37787590749929,15.121349766647276 68.33303131853208,14.999999999999982 68.33307545280346)))"
25050007580000,1,1,0,0,"MULTIPOLYGON(((15.121349766647276 68.33303131853208,15.121589128647672 68.37787590749929,15.243177236446591 68.37774320367981,15.24269851875446 68.33289891636444,15.121349766647276 68.33303131853208)))"
25100007580000,8,5,3,52.3,"MULTIPOLYGON(((15.24269851875446 68.33289891636444,15.243177236446591 68.37774320367981,15.36476330260049 68.37752203281508,15.364045241833425 68.33267824824004,15.24269851875446 68.33289891636444)))"
25150007580000,47,20,27,60.7,"MULTIPOLYGON(((15.364045241833425 68.33267824824004,15.36476330260049 68.37752203281508,15.486346306418195 68.37721239815649,15.485388921500032 68.33236931739118,15.364045241833425 68.33267824824004)))"
25200007580000,75,41,34,58.3,"MULTIPOLYGON(((15.485388921500032 68.33236931739118,15.486346306418195 68.37721239815649,15.607925227366083 68.3768143042558,15.606728543526087 68.33197212834281,15.485388921500032 68.33236931739118)))"
25250007580000,33,18,15,50.1,"MULTIPOLYGON(((15.606728543526087 68.33197212834281,15.607925227366083 68.3768143042558,15.729499045120603 68.37632775696468,15.728063093891299 68.33148668691229,15.606728543526087 68.33197212834281)))"
25300007580000,14,4,10,49.5,"MULTIPOLYGON(((15.728063093891299 68.33148668691229,15.729499045120603 68.37632775696468,15.851066739620729 68.37575276343452,15.849391558835194 68.33091300020892,15.728063093891299 68.33148668691229)))"
25500007580000,16,9,7,66.3,"MULTIPOLYGON(((16.213330308521055 68.32866255892534,16.215722888023066 68.37349719640794,16.337255895979993 68.3725685154106,16.334624301186746 68.32773598804691,16.213330308521055 68.32866255892534)))"
25550007580000,13,9,4,54.1,"MULTIPOLYGON(((16.334624301186746 68.32773598804691,16.337255895979993 68.3725685154106,16.458777686148775 68.37155144340713,16.45590714534077 68.32672122680411,16.334624301186746 68.32773598804691)))"
25600007580000,10,6,4,61.2,"MULTIPOLYGON(((16.45590714534077 68.32672122680411,16.458777686148775 68.37155144340713,16.58028724114292 68.37044599533455,16.577177829869672 68.32561829004622,16.45590714534077 68.32672122680411)))"
25650007580000,45,23,22,42.5,"MULTIPOLYGON(((16.577177829869672 68.32561829004622,16.58028724114292 68.37044599533455,16.701783544204392 68.36925218742466,16.698435344282 68.3244271939098,16.577177829869672 68.32561829004622)))"
25700007580000,717,356,361,41.5,"MULTIPOLYGON(((16.698435344282 68.3244271939098,16.701783544204392 68.36925218742466,16.823265579255615 68.36797003720308,16.81967867875976 68.32314795581757,16.698435344282 68.3244271939098)))"
25750007580000,854,433,421,44.1,"MULTIPOLYGON(((16.81967867875976 68.32314795581757,16.823265579255615 68.36797003720308,16.944732330951393 68.36659956348818,16.9409068242098 68.32178059447745,16.81967867875976 68.32314795581757)))"
25800007580000,78,37,41,59.1,"MULTIPOLYGON(((16.9409068242098 68.32178059447745,16.944732330951393 68.36659956348818,17.066182784730735 68.3651407863899,17.06211877231513 68.32032512988141,16.9409068242098 68.32178059447745)))"
25900007580000,31,16,15,39,"MULTIPOLYGON(((17.183313515586086 68.31878158330409,17.187615926868563 68.36359372730837,17.309030744527366 68.36195840893285,17.304490047411427 68.3171499773016,17.183313515586086 68.31878158330409)))"
26000007580000,4,2,2,0,"MULTIPOLYGON(((17.42564736210933 68.31543033571013,17.430426225808656 68.36023485524004,17.551801359804386 68.3584230914928,17.546784454978223 68.31362268364445,17.42564736210933 68.31543033571013)))"
24750007585000,356,188,168,43.3,"MULTIPOLYGON(((14.392074772633883 68.3768143042558,14.390872985556763 68.42165622735614,14.512692225758784 68.42205522968734,14.513653693581771 68.37721239815649,14.392074772633883 68.3768143042558)))"
24800007585000,23,14,9,43.8,"MULTIPOLYGON(((14.513653693581771 68.37721239815649,14.512692225758784 68.42205522968734,14.634515574269948 68.42236557093891,14.635236697399474 68.37752203281508,14.513653693581771 68.37721239815649)))"
24850007585000,4,2,2,0,"MULTIPOLYGON(((14.635236697399474 68.37752203281508,14.634515574269948 68.42236557093891,14.756342004198723 68.4225872465322,14.756822763553375 68.37774320367981,14.635236697399474 68.37752203281508)))"
24900007585000,1,0,1,0,"MULTIPOLYGON(((14.756822763553375 68.37774320367981,14.756342004198723 68.4225872465322,14.878170488494364 68.42272025319653,14.878410871352294 68.37787590749929,14.756822763553375 68.37774320367981)))"
25000007585000,3,1,2,0,"MULTIPOLYGON(((14.999999999999982 68.37792014232255,14.999999999999982 68.42276458896934,15.121829511505602 68.42272025319653,15.121589128647672 68.37787590749929,14.999999999999982 68.37792014232255)))"
25050007585000,10,6,4,42.6,"MULTIPOLYGON(((15.121589128647672 68.37787590749929,15.121829511505602 68.42272025319653,15.243657995801243 68.4225872465322,15.243177236446591 68.37774320367981,15.121589128647672 68.37787590749929)))"
25100007585000,4,1,3,0,"MULTIPOLYGON(((15.243177236446591 68.37774320367981,15.243657995801243 68.4225872465322,15.365484425730019 68.42236557093891,15.36476330260049 68.37752203281508,15.243177236446591 68.37774320367981)))"
25150007585000,2,1,1,0,"MULTIPOLYGON(((15.36476330260049 68.37752203281508,15.365484425730019 68.42236557093891,15.487307774241183 68.42205522968734,15.486346306418195 68.37721239815649,15.36476330260049 68.37752203281508)))"
25250007585000,19,11,8,47.2,"MULTIPOLYGON(((15.607925227366083 68.3768143042558,15.609127014443203 68.42165622735614,15.730941119656803 68.42116856983175,15.729499045120603 68.37632775696468,15.607925227366083 68.3768143042558)))"
25300007585000,15,8,7,58.8,"MULTIPOLYGON(((15.729499045120603 68.37632775696468,15.730941119656803 68.42116856983175,15.85274906346796 68.42059226430786,15.851066739620729 68.37575276343452,15.729499045120603 68.37632775696468)))"
25350007585000,311,158,153,54.2,"MULTIPOLYGON(((15.851066739620729 68.37575276343452,15.85274906346796 68.42059226430786,15.974549819780895 68.41992731928508,15.972627291120386 68.37508933211585,15.851066739620729 68.37575276343452)))"
25400007585000,1314,637,677,46.1,"MULTIPOLYGON(((15.972627291120386 68.37508933211585,15.974549819780895 68.41992731928508,16.096342362871006 68.41917374457037,16.094179680240842 68.3743374727579,15.972627291120386 68.37508933211585)))"
25500007585000,1,0,1,0,"MULTIPOLYGON(((16.215722888023066 68.37349719640794,16.218125667437743 68.41833155127645,16.339898708657458 68.41740075182109,16.337255895979993 68.3725685154106,16.215722888023066 68.37349719640794)))"
25550007585000,1,1,0,0,"MULTIPOLYGON(((16.337255895979993 68.3725685154106,16.339898708657458 68.41740075182109,16.46166046223616 68.41638135992623,16.458777686148775 68.37155144340713,16.337255895979993 68.3725685154106)))"
25600007585000,8,4,4,61.6,"MULTIPOLYGON(((16.458777686148775 68.37155144340713,16.46166046223616 68.41638135992623,16.583409904462247 68.41527339061736,16.58028724114292 68.37044599533455,16.458777686148775 68.37155144340713)))"
25650007585000,168,83,85,59.2,"MULTIPOLYGON(((16.58028724114292 68.37044599533455,16.583409904462247 68.41527339061736,16.705146012259092 68.41407686022235,16.701783544204392 68.36925218742466,16.58028724114292 68.37044599533455)))"
25700007585000,26,14,12,62.8,"MULTIPOLYGON(((16.701783544204392 68.36925218742466,16.705146012259092 68.41407686022235,16.826867763237615 68.41279178637053,16.823265579255615 68.36797003720308,16.701783544204392 68.36925218742466)))"
25750007585000,191,101,90,43.9,"MULTIPOLYGON(((16.823265579255615 68.36797003720308,16.826867763237615 68.41279178637053,16.948574135748746 68.41141818799161,16.944732330951393 68.36659956348818,16.823265579255615 68.36797003720308)))"
25800007585000,9,7,2,67.7,"MULTIPOLYGON(((16.944732330951393 68.36659956348818,16.948574135748746 68.41141818799161,17.070264108935767 68.40995608531446,17.066182784730735 68.3651407863899,16.944732330951393 68.36659956348818)))"
25850007585000,64,34,30,45.3,"MULTIPOLYGON(((17.066182784730735 68.3651407863899,17.070264108935767 68.40995608531446,17.191936662786592 68.40840549986584,17.187615926868563 68.36359372730837,17.066182784730735 68.3651407863899)))"
25900007585000,279,142,137,39.9,"MULTIPOLYGON(((17.187615926868563 68.36359372730837,17.191936662786592 68.40840549986584,17.31359077818589 68.40676645446905,17.309030744527366 68.36195840893285,17.187615926868563 68.36359372730837)))"
25950007585000,433,221,212,35.6,"MULTIPOLYGON(((17.309030744527366 68.36195840893285,17.31359077818589 68.40676645446905,17.435225436967162 68.40503897324257,17.430426225808656 68.36023485524004,17.309030744527366 68.36195840893285)))"
26000007585000,25,12,13,57.8,"MULTIPOLYGON(((17.430426225808656 68.36023485524004,17.435225436967162 68.40503897324257,17.55683962196461 68.40322308159851,17.551801359804386 68.3584230914928,17.430426225808656 68.36023485524004)))"
26050007585000,823,418,405,36.3,"MULTIPOLYGON(((17.551801359804386 68.3584230914928,17.55683962196461 68.40322308159851,17.67843231706495 68.40131880624102,17.67315513664819 68.35652314423844,17.551801359804386 68.3584230914928)))"
24800007590000,19,10,9,52.2,"MULTIPOLYGON(((14.512692225758784 68.42205522968734,14.511726649591278 68.46689781235017,14.633791369696274 68.46720886299546,14.634515574269948 68.42236557093891,14.512692225758784 68.42205522968734)))"
24850007590000,76,45,31,55.4,"MULTIPOLYGON(((14.634515574269948 68.42236557093891,14.633791369696274 68.46720886299546,14.755859190459507 68.46743104531797,14.756342004198723 68.4225872465322,14.634515574269948 68.42236557093891)))"
24900007590000,55,32,23,45.2,"MULTIPOLYGON(((14.756342004198723 68.4225872465322,14.755859190459507 68.46743104531797,14.877929078417617 68.4675643560276,14.878170488494364 68.42272025319653,14.756342004198723 68.4225872465322)))"
24950007590000,13,7,6,51.9,"MULTIPOLYGON(((14.878170488494364 68.42272025319653,14.877929078417617 68.4675643560276,14.999999999999982 68.46760879315015,14.999999999999982 68.42276458896934,14.878170488494364 68.42272025319653)))"
25000007590000,7,3,4,65.6,"MULTIPOLYGON(((14.999999999999982 68.42276458896934,14.999999999999982 68.46760879315015,15.122070921582349 68.4675643560276,15.121829511505602 68.42272025319653,14.999999999999982 68.42276458896934)))"
25050007590000,15,10,5,54.5,"MULTIPOLYGON(((15.121829511505602 68.42272025319653,15.122070921582349 68.4675643560276,15.24414080954046 68.46743104531797,15.243657995801243 68.4225872465322,15.121829511505602 68.42272025319653)))"
25300007590000,4,0,4,0,"MULTIPOLYGON(((15.730941119656803 68.42116856983175,15.73238935564848 68.46600912583021,15.854438574875276 68.46543150311332,15.85274906346796 68.42059226430786,15.730941119656803 68.42116856983175)))"
25350007590000,14,10,4,49.8,"MULTIPOLYGON(((15.85274906346796 68.42059226430786,15.854438574875276 68.46543150311332,15.976480561734917 68.46476503838839,15.974549819780895 68.41992731928508,15.85274906346796 68.42059226430786)))"
25400007590000,42,25,17,58.5,"MULTIPOLYGON(((15.974549819780895 68.41992731928508,15.976480561734917 68.46476503838839,16.098514284104027 68.46400974152061,16.096342362871006 68.41917374457037,15.974549819780895 68.41992731928508)))"
25450007590000,42,18,24,62.2,"MULTIPOLYGON(((16.096342362871006 68.41917374457037,16.098514284104027 68.46400974152061,16.22053871028772 68.46316562368862,16.218125667437743 68.41833155127645,16.096342362871006 68.41917374457037)))"
25500007590000,34,13,21,54.4,"MULTIPOLYGON(((16.218125667437743 68.41833155127645,16.22053871028772 68.46316562368862,16.342552809072988 68.46223269738391,16.339898708657458 68.41740075182109,16.218125667437743 68.41833155127645)))"
25550007590000,22,13,9,44.9,"MULTIPOLYGON(((16.339898708657458 68.41740075182109,16.342552809072988 68.46223269738391,16.46455554978201 68.46121097640989,16.46166046223616 68.41638135992623,16.339898708657458 68.41740075182109)))"
25600007590000,5,3,2,50.6,"MULTIPOLYGON(((16.46166046223616 68.41638135992623,16.46455554978201 68.46121097640989,16.586545902325412 68.46010047588113,16.583409904462247 68.41527339061736,16.46166046223616 68.41638135992623)))"
25650007590000,111,57,54,43.2,"MULTIPOLYGON(((16.583409904462247 68.41527339061736,16.586545902325412 68.46010047588113,16.708522837255444 68.4589012122224,16.705146012259092 68.41407686022235,16.583409904462247 68.41527339061736)))"
25700007590000,16,10,6,49.9,"MULTIPOLYGON(((16.705146012259092 68.41407686022235,16.708522837255444 68.4589012122224,16.830485325819073 68.45761320316761,16.826867763237615 68.41279178637053,16.705146012259092 68.41407686022235)))"
25900007590000,239,122,117,39,"MULTIPOLYGON(((17.191936662786592 68.40840549986584,17.19627583731427 68.45321690057916,17.31817026862924 68.4515741134215,17.31359077818589 68.40676645446905,17.191936662786592 68.40840549986584)))"
25950007590000,10537,5316,5221,43.1,"MULTIPOLYGON(((17.31359077818589 68.40676645446905,17.31817026862924 68.4515741134215,17.440045122084907 68.44984268913275,17.435225436967162 68.40503897324257,17.31359077818589 68.40676645446905)))"
26000007590000,3566,1840,1726,41.8,"MULTIPOLYGON(((17.435225436967162 68.40503897324257,17.440045122084907 68.44984268913275,17.561899374205964 68.44802265327554,17.55683962196461 68.40322308159851,17.435225436967162 68.40503897324257)))"
26050007590000,239,116,123,42.1,"MULTIPOLYGON(((17.55683962196461 68.40322308159851,17.561899374205964 68.44802265327554,17.68373200258056 68.4461140327121,17.67843231706495 68.40131880624102,17.55683962196461 68.40322308159851)))"
26100007590000,10,5,5,54.2,"MULTIPOLYGON(((17.67843231706495 68.40131880624102,17.68373200258056 68.4461140327121,17.805541985912484 68.44411685560269,17.80000250725907 68.39932617516465,17.67843231706495 68.40131880624102)))"
24850007595000,35,19,16,47,"MULTIPOLYGON(((14.633791369696274 68.46720886299546,14.633064064437544 68.51205190936898,14.755374309507532 68.5122746004339,14.755859190459507 68.46743104531797,14.633791369696274 68.46720886299546)))"
24900007595000,2349,1160,1189,42.5,"MULTIPOLYGON(((14.755859190459507 68.46743104531797,14.755374309507532 68.5122746004339,14.87768663470767 68.51240821639682,14.877929078417617 68.4675643560276,14.755859190459507 68.46743104531797)))"
24950007595000,65,36,29,44,"MULTIPOLYGON(((14.877929078417617 68.4675643560276,14.87768663470767 68.51240821639682,14.999999999999982 68.51245275527177,14.999999999999982 68.46760879315015,14.877929078417617 68.4675643560276)))"
25050007595000,13,8,5,75.5,"MULTIPOLYGON(((15.122070921582349 68.4675643560276,15.122313365292296 68.51240821639682,15.244625690492434 68.5122746004339,15.24414080954046 68.46743104531797,15.122070921582349 68.4675643560276)))"
25100007595000,3,1,2,0,"MULTIPOLYGON(((15.24414080954046 68.46743104531797,15.244625690492434 68.5122746004339,15.366935935562422 68.51205190936898,15.366208630303692 68.46720886299546,15.24414080954046 68.46743104531797)))"
25400007595000,10,4,6,60.2,"MULTIPOLYGON(((15.976480561734917 68.46476503838839,15.97841956825088 68.50960248967216,16.100695501602775 68.50884546381234,16.098514284104027 68.46400974152061,15.976480561734917 68.46476503838839)))"
25600007595000,334,177,157,43.7,"MULTIPOLYGON(((16.46455554978201 68.46121097640989,16.467463025600413 68.5060402929041,16.58969531791773 68.50492725110934,16.586545902325412 68.46010047588113,16.46455554978201 68.46121097640989)))"
25650007595000,95,46,49,49.6,"MULTIPOLYGON(((16.586545902325412 68.46010047588113,16.58969531791773 68.50492725110934,16.711914108742825 68.50372524334081,16.708522837255444 68.4589012122224,16.586545902325412 68.46010047588113)))"
25700007595000,114,60,54,48.1,"MULTIPOLYGON(((16.708522837255444 68.4589012122224,16.711914108742825 68.50372524334081,16.83411836290569 68.50243428743784,16.830485325819073 68.45761320316761,16.708522837255444 68.4589012122224)))"
25750007595000,377,173,204,47.1,"MULTIPOLYGON(((16.830485325819073 68.45761320316761,16.83411836290569 68.50243428743784,16.95630704599187 68.50105440255552,16.95243234001098 68.45623646775867,16.830485325819073 68.45761320316761)))"
25800007595000,17,9,8,58.9,"MULTIPOLYGON(((16.95243234001098 68.45623646775867,16.95630704599187 68.50105440255552,17.07847912439588 68.49958560916357,17.07436285262647 68.45477102634442,16.95243234001098 68.45623646775867)))"
25850007595000,4,2,2,0,"MULTIPOLYGON(((17.07436285262647 68.45477102634442,17.07847912439588 68.49958560916357,17.20063356537458 68.49802792904498,17.19627583731427 68.45321690057916,17.07436285262647 68.45477102634442)))"
25900007595000,4,3,1,0,"MULTIPOLYGON(((17.19627583731427 68.45321690057916,17.20063356537458 68.49802792904498,17.32276933710041 68.49638138529465,17.31817026862924 68.4515741134215,17.19627583731427 68.45321690057916)))"
26000007595000,126,63,63,51.1,"MULTIPOLYGON(((17.440045122084907 68.44984268913275,17.444885408714512 68.49464600231796,17.56698075037973 68.4928218058293,17.561899374205964 68.44802265327554,17.440045122084907 68.44984268913275)))"
26050007595000,46,25,21,50.1,"MULTIPOLYGON(((17.561899374205964 68.44802265327554,17.56698075037973 68.4928218058293,17.68905433333345 68.49090882285023,17.68373200258056 68.4461140327121,17.561899374205964 68.44802265327554)))"
26100007595000,48,28,20,54.3,"MULTIPOLYGON(((17.68373200258056 68.4461140327121,17.68905433333345 68.49090882285023,17.811105129940344 68.48890708170808,17.805541985912484 68.44411685560269,17.68373200258056 68.4461140327121)))"
24850007600000,94,53,41,43.6,"MULTIPOLYGON(((14.633064064437544 68.51205190936898,14.632333639091978 68.55689471044413,14.754887348407346 68.55711791227736,14.755374309507532 68.5122746004339,14.633064064437544 68.51205190936898)))"
24950007600000,492,261,231,43.7,"MULTIPOLYGON(((14.87768663470767 68.51240821639682,14.87744315089652 68.55725183470912,14.999999999999982 68.5572964757417,14.999999999999982 68.51245275527177,14.87768663470767 68.51240821639682)))"
25050007600000,163,81,82,53.2,"MULTIPOLYGON(((15.122313365292296 68.51240821639682,15.122556849103447 68.55725183470912,15.24511265159262 68.55711791227736,15.244625690492434 68.5122746004339,15.122313365292296 68.51240821639682)))"
25100007600000,70,40,30,63.7,"MULTIPOLYGON(((15.244625690492434 68.5122746004339,15.24511265159262 68.55711791227736,15.367666360907988 68.55689471044413,15.366935935562422 68.51205190936898,15.244625690492434 68.5122746004339)))"
25250007600000,2,1,1,0,"MULTIPOLYGON(((15.611546025756125 68.51133931649538,15.612763314381535 68.55618048322258,15.73530446618723 68.55568946848734,15.733843791562483 68.5108494252766,15.611546025756125 68.51133931649538)))"
25300007600000,14,9,5,42.3,"MULTIPOLYGON(((15.733843791562483 68.5108494252766,15.73530446618723 68.55568946848734,15.857839340223544 68.55510919565604,15.856135318712255 68.51027048013489,15.733843791562483 68.5108494252766)))"
25450007600000,5,2,3,53,"MULTIPOLYGON(((16.100695501602775 68.50884546381234,16.10288607351202 68.55368091164824,16.225395843038108 68.55283292176702,16.22296208062533 68.5079994138006,16.100695501602775 68.50884546381234)))"
25500007600000,9,4,5,63.2,"MULTIPOLYGON(((16.22296208062533 68.5079994138006,16.225395843038108 68.55283292176702,16.347895155451745 68.551895716379,16.345218267662844 68.50706435220265,16.22296208062533 68.5079994138006)))"
25550007600000,28,12,16,55.3,"MULTIPOLYGON(((16.345218267662844 68.50706435220265,16.347895155451745 68.551895716379,16.47038296714712 68.55086930945248,16.467463025600413 68.5060402929041,16.345218267662844 68.50706435220265)))"
25600007600000,119,59,60,57.4,"MULTIPOLYGON(((16.467463025600413 68.5060402929041,16.47038296714712 68.55086930945248,16.592858235119277 68.54975371628257,16.58969531791773 68.50492725110934,16.467463025600413 68.5060402929041)))"
25650007600000,327,163,164,44.8,"MULTIPOLYGON(((16.58969531791773 68.50492725110934,16.592858235119277 68.54975371628257,16.715319917018352 68.54854895349013,16.711914108742825 68.50372524334081,16.58969531791773 68.50492725110934)))"
25700007600000,150,77,73,47.9,"MULTIPOLYGON(((16.711914108742825 68.50372524334081,16.715319917018352 68.54854895349013,16.837766971203838 68.54725503902074,16.83411836290569 68.50243428743784,16.711914108742825 68.50372524334081)))"
25750007600000,55,30,25,53.5,"MULTIPOLYGON(((16.83411836290569 68.50243428743784,16.837766971203838 68.54725503902074,16.96019835679866 68.5458719921436,16.95630704599187 68.50105440255552,16.83411836290569 68.50243428743784)))"
25800007600000,454,243,211,46.7,"MULTIPOLYGON(((16.95630704599187 68.50105440255552,16.96019835679866 68.5458719921436,17.0826130337432 68.54439983345038,17.07847912439588 68.49958560916357,16.95630704599187 68.50105440255552)))"
25850007600000,31,16,15,53.4,"MULTIPOLYGON(((17.07847912439588 68.49958560916357,17.0826130337432 68.54439983345038,17.20500996284921 68.54283858485373,17.20063356537458 68.49802792904498,17.07847912439588 68.49958560916357)))"
25900007600000,5,4,1,36,"MULTIPOLYGON(((17.20063356537458 68.49802792904498,17.20500996284921 68.54283858485373,17.327388105853597 68.54118826958602,17.32276933710041 68.49638138529465,17.20063356537458 68.49802792904498)))"
25950007600000,3,2,1,0,"MULTIPOLYGON(((17.32276933710041 68.49638138529465,17.327388105853597 68.54118826958602,17.449746425472114 68.53944891219786,17.444885408714512 68.49464600231796,17.32276933710041 68.49638138529465)))"
26000007600000,111,60,51,50.8,"MULTIPOLYGON(((17.444885408714512 68.49464600231796,17.449746425472114 68.53944891219786,17.572083885452876 68.53762053855658,17.56698075037973 68.4928218058293,17.444885408714512 68.49464600231796)))"
26050007600000,15,9,6,34.5,"MULTIPOLYGON(((17.56698075037973 68.4928218058293,17.572083885452876 68.53762053855658,17.694399450629803 68.5357031758445,17.68905433333345 68.49090882285023,17.56698075037973 68.4928218058293)))"
24700007605000,3,2,1,0,"MULTIPOLYGON(((14.264695533812736 68.55568946848734,14.263228581363885 68.60052925577858,14.386014164971101 68.60102139851384,14.387236685618431 68.55618048322258,14.264695533812736 68.55568946848734)))"
24800007605000,3,1,2,0,"MULTIPOLYGON(((14.509783069400429 68.55658223253891,14.508805013427505 68.60142407079896,14.631600074095223 68.601737266606,14.632333639091978 68.55689471044413,14.509783069400429 68.55658223253891)))"
24850007605000,115,61,54,46.3,"MULTIPOLYGON(((14.632333639091978 68.55689471044413,14.631600074095223 68.601737266606,14.75439829411509 68.60196098124611,14.754887348407346 68.55711791227736,14.632333639091978 68.55689471044413)))"
24900007605000,580,302,278,38.5,"MULTIPOLYGON(((14.754887348407346 68.55711791227736,14.75439829411509 68.60196098124611,14.877198620461954 68.60209521136998,14.87744315089652 68.55725183470912,14.754887348407346 68.55711791227736)))"
24950007605000,3298,1656,1642,42.6,"MULTIPOLYGON(((14.87744315089652 68.55725183470912,14.877198620461954 68.60209521136998,14.999999999999982 68.60213995496792,14.999999999999982 68.5572964757417,14.87744315089652 68.55725183470912)))"
25000007605000,85,43,42,39.9,"MULTIPOLYGON(((14.999999999999982 68.5572964757417,14.999999999999982 68.60213995496792,15.122801379538013 68.60209521136998,15.122556849103447 68.55725183470912,14.999999999999982 68.5572964757417)))"
25050007605000,47,22,25,51.4,"MULTIPOLYGON(((15.122556849103447 68.55725183470912,15.122801379538013 68.60209521136998,15.245601705884877 68.60196098124611,15.24511265159262 68.55711791227736,15.122556849103447 68.55725183470912)))"
25100007605000,55,27,28,55.2,"MULTIPOLYGON(((15.24511265159262 68.55711791227736,15.245601705884877 68.60196098124611,15.368399925904743 68.601737266606,15.367666360907988 68.55689471044413,15.24511265159262 68.55711791227736)))"
25150007605000,28,15,13,56.9,"MULTIPOLYGON(((15.367666360907988 68.55689471044413,15.368399925904743 68.601737266606,15.491194986572461 68.60142407079896,15.490216930599535 68.55658223253891,15.367666360907988 68.55689471044413)))"
25300007605000,55,30,25,54.5,"MULTIPOLYGON(((15.73530446618723 68.55568946848734,15.73677141863608 68.60052925577858,15.859550685032783 68.59994764995986,15.857839340223544 68.55510919565604,15.73530446618723 68.55568946848734)))"
25400007605000,1,1,0,0,"MULTIPOLYGON(((15.980366891025739 68.55443967338199,15.98232258218943 68.59927658976268,16.105086058463463 68.5985160852298,16.10288607351202 68.55368091164824,15.980366891025739 68.55443967338199)))"
25500007605000,280,141,139,46.1,"MULTIPOLYGON(((16.225395843038108 68.55283292176702,16.227840062654426 68.59766614774102,16.35058354405904 68.59672679001257,16.347895155451745 68.551895716379,16.225395843038108 68.55283292176702)))"
25550007605000,89,43,46,46.7,"MULTIPOLYGON(((16.347895155451745 68.551895716379,16.35058354405904 68.59672679001257,16.47331545252625 68.59569802609622,16.47038296714712 68.55086930945248,16.347895155451745 68.551895716379)))"
25600007605000,1303,657,646,43.1,"MULTIPOLYGON(((16.47038296714712 68.55086930945248,16.47331545252625 68.59569802609622,16.596034738512117 68.5945798713784,16.592858235119277 68.54975371628257,16.47038296714712 68.55086930945248)))"
25650007605000,328,163,165,44.3,"MULTIPOLYGON(((16.592858235119277 68.54975371628257,16.596034738512117 68.5945798713784,16.718740353134713 68.59337234257926,16.715319917018352 68.54854895349013,16.592858235119277 68.54975371628257)))"
25700007605000,138,71,67,45.5,"MULTIPOLYGON(((16.715319917018352 68.54854895349013,16.718740353134713 68.59337234257926,16.841431248228897 68.59207545775155,16.837766971203838 68.54725503902074,16.715319917018352 68.54854895349013)))"
26000007605000,1226,616,610,45.6,"MULTIPOLYGON(((17.449746425472114 68.53944891219786,17.45462830204843 68.5842514181642,17.577208915519705 68.58241885074554,17.572083885452876 68.53762053855658,17.449746425472114 68.53944891219786)))"
26050007605000,152,86,66,47,"MULTIPOLYGON(((17.572083885452876 68.53762053855658,17.577208915519705 68.58241885074554,17.699767496955715 68.58049709087447,17.694399450629803 68.5357031758445,17.572083885452876 68.53762053855658)))"
26100007605000,62,34,28,56.8,"MULTIPOLYGON(((17.694399450629803 68.5357031758445,17.699767496955715 68.58049709087447,17.82230300588462 68.57848616721647,17.81669208697587 68.53369685255736,17.694399450629803 68.5357031758445)))"
24750007610000,892,460,432,45.7,"MULTIPOLYGON(((14.386014164971101 68.60102139851384,14.384786379428483 68.64586206271346,14.507822745206385 68.64626566165936,14.508805013427505 68.60142407079896,14.386014164971101 68.60102139851384)))"
24800007610000,172,88,84,48.8,"MULTIPOLYGON(((14.508805013427505 68.60142407079896,14.507822745206385 68.64626566165936,14.63086334971865 68.64657957824002,14.631600074095223 68.601737266606,14.508805013427505 68.60142407079896)))"
24850007610000,4,2,2,0,"MULTIPOLYGON(((14.631600074095223 68.601737266606,14.63086334971865 68.64657957824002,14.753907133477396 68.64680380773852,14.75439829411509 68.60196098124611,14.631600074095223 68.601737266606)))"
24900007610000,143,74,69,44.3,"MULTIPOLYGON(((14.75439829411509 68.60196098124611,14.753907133477396 68.64680380773852,14.876953036826993 68.64693834678546,14.877198620461954 68.60209521136998,14.75439829411509 68.60196098124611)))"
24950007610000,2,1,1,0,"MULTIPOLYGON(((14.877198620461954 68.60209521136998,14.876953036826993 68.64693834678546,14.999999999999982 68.64698319335909,14.999999999999982 68.60213995496792,14.877198620461954 68.60209521136998)))"
25000007610000,135,74,61,40.4,"MULTIPOLYGON(((14.999999999999982 68.60213995496792,14.999999999999982 68.64698319335909,15.123046963172973 68.64693834678546,15.122801379538013 68.60209521136998,14.999999999999982 68.60213995496792)))"
25050007610000,244,127,117,47.4,"MULTIPOLYGON(((15.122801379538013 68.60209521136998,15.123046963172973 68.64693834678546,15.24609286652257 68.64680380773852,15.245601705884877 68.60196098124611,15.122801379538013 68.60209521136998)))"
25100007610000,177,87,90,41.4,"MULTIPOLYGON(((15.245601705884877 68.60196098124611,15.24609286652257 68.64680380773852,15.369136650281316 68.64657957824002,15.368399925904743 68.601737266606,15.245601705884877 68.60196098124611)))"
25150007610000,49,24,25,53.8,"MULTIPOLYGON(((15.368399925904743 68.601737266606,15.369136650281316 68.64657957824002,15.492177254793582 68.64626566165936,15.491194986572461 68.60142407079896,15.368399925904743 68.601737266606)))"
25200007610000,433,230,203,37.8,"MULTIPOLYGON(((15.491194986572461 68.60142407079896,15.492177254793582 68.64626566165936,15.615213620571483 68.64586206271346,15.613985835028865 68.60102139851384,15.491194986572461 68.60142407079896)))"
25250007610000,16,8,8,40.6,"MULTIPOLYGON(((15.613985835028865 68.60102139851384,15.615213620571483 68.64586206271346,15.738244688350743 68.64536878746635,15.73677141863608 68.60052925577858,15.613985835028865 68.60102139851384)))"
25300007610000,32,18,14,52.5,"MULTIPOLYGON(((15.73677141863608 68.60052925577858,15.738244688350743 68.64536878746635,15.861269399146565 68.64478584332895,15.859550685032783 68.59994764995986,15.73677141863608 68.60052925577858)))"
25400007610000,2,1,1,0,"MULTIPOLYGON(((15.98232258218943 68.59927658976268,15.984286694309425 68.64411323905831,16.107295515580848 68.6433509847574,16.105086058463463 68.5985160852298,15.98232258218943 68.59927658976268)))"
25600007610000,332,176,156,47.3,"MULTIPOLYGON(((16.47331545252625 68.59569802609622,16.476260560497057 68.64052644287396,16.599224913387694 68.63940571637137,16.596034738512117 68.5945798713784,16.47331545252625 68.59569802609622)))"
25650007610000,40,21,19,47.1,"MULTIPOLYGON(((16.596034738512117 68.5945798713784,16.599224913387694 68.63940571637137,16.722175508908077 68.63819541051359,16.718740353134713 68.59337234257926,16.596034738512117 68.5945798713784)))"
25700007610000,2,1,1,0,"MULTIPOLYGON(((16.718740353134713 68.59337234257926,16.722175508908077 68.63819541051359,16.845111292313742 68.63689554346139,16.841431248228897 68.59207545775155,16.718740353134713 68.59337234257926)))"
25900007610000,14,6,8,60.3,"MULTIPOLYGON(((17.2094051465886 68.58764886758956,17.213819234422076 68.63245877683045,17.336685238342156 68.63080087337818,17.33202669816473 68.58599476578605,17.2094051465886 68.58764886758956)))"
24750007615000,604,280,324,49.2,"MULTIPOLYGON(((14.384786379428483 68.64586206271346,14.383553295840654 68.69070247616571,14.506836238213625 68.69110700548772,14.507822745206385 68.64626566165936,14.384786379428483 68.64586206271346)))"
24800007615000,117,58,59,52.4,"MULTIPOLYGON(((14.507822745206385 68.64626566165936,14.506836238213625 68.69110700548772,14.63012344606764 68.691421645732,14.63086334971865 68.64657957824002,14.507822745206385 68.64626566165936)))"
24850007615000,89,44,45,54.9,"MULTIPOLYGON(((14.63086334971865 68.64657957824002,14.63012344606764 68.691421645732,14.753413853230208 68.69164639215337,14.753907133477396 68.64680380773852,14.63086334971865 68.64657957824002)))"
24900007615000,7,5,2,64.6,"MULTIPOLYGON(((14.753907133477396 68.64680380773852,14.753413853230208 68.69164639215337,14.87670639335933 68.6917812413621,14.876953036826993 68.64693834678546,14.753907133477396 68.64680380773852)))"
24950007615000,44,24,20,52.5,"MULTIPOLYGON(((14.876953036826993 68.64693834678546,14.87670639335933 68.6917812413621,14.999999999999982 68.69182619132434,14.999999999999982 68.64698319335909,14.876953036826993 68.64693834678546)))"
25000007615000,20,8,12,47.5,"MULTIPOLYGON(((14.999999999999982 68.64698319335909,14.999999999999982 68.69182619132434,15.123293606640635 68.6917812413621,15.123046963172973 68.64693834678546,14.999999999999982 68.64698319335909)))"
25050007615000,4,3,1,0,"MULTIPOLYGON(((15.123046963172973 68.64693834678546,15.123293606640635 68.6917812413621,15.246586146769758 68.69164639215337,15.24609286652257 68.64680380773852,15.123046963172973 68.64693834678546)))"
25100007615000,396,212,184,40.1,"MULTIPOLYGON(((15.24609286652257 68.64680380773852,15.246586146769758 68.69164639215337,15.369876553932325 68.691421645732,15.369136650281316 68.64657957824002,15.24609286652257 68.64680380773852)))"
25150007615000,2706,1352,1354,40.3,"MULTIPOLYGON(((15.369136650281316 68.64657957824002,15.369876553932325 68.691421645732,15.493163761786342 68.69110700548772,15.492177254793582 68.64626566165936,15.369136650281316 68.64657957824002)))"
25200007615000,428,216,212,41.8,"MULTIPOLYGON(((15.492177254793582 68.64626566165936,15.493163761786342 68.69110700548772,15.616446704159312 68.69070247616571,15.615213620571483 68.64586206271346,15.492177254793582 68.64626566165936)))"
25250007615000,2,1,1,0,"MULTIPOLYGON(((15.615213620571483 68.64586206271346,15.616446704159312 68.69070247616571,15.739724315104725 68.69020806386646,15.738244688350743 68.64536878746635,15.615213620571483 68.64586206271346)))"
25300007615000,8,4,4,51.9,"MULTIPOLYGON(((15.738244688350743 68.64536878746635,15.739724315104725 68.69020806386646,15.86299552895849 68.68962377604534,15.861269399146565 68.64478584332895,15.738244688350743 68.64536878746635)))"
25350007615000,97,54,43,51.3,"MULTIPOLYGON(((15.861269399146565 68.64478584332895,15.86299552895849 68.68962377604534,15.98625928039532 68.68894962151208,15.984286694309425 68.64411323905831,15.861269399146565 68.64478584332895)))"
25400007615000,101,55,46,39.6,"MULTIPOLYGON(((15.984286694309425 68.64411323905831,15.98625928039532 68.68894962151208,16.10951450448512 68.68818561043024,16.107295515580848 68.6433509847574,15.984286694309425 68.64411323905831)))"
25500007615000,18,9,9,49.3,"MULTIPOLYGON(((16.23029480514912 68.64249909187421,16.23276013674926 68.68733175431655,16.35599511321683 68.68638806604014,16.353283505704947 68.6415575732011,16.23029480514912 68.64249909187421)))"
25550007615000,39,24,15,45,"MULTIPOLYGON(((16.353283505704947 68.6415575732011,16.35599511321683 68.68638806604014,16.479218370480826 68.6853545598218,16.476260560497057 68.64052644287396,16.353283505704947 68.6415575732011)))"
25600007615000,641,333,308,44,"MULTIPOLYGON(((16.476260560497057 68.64052644287396,16.479218370480826 68.6853545598218,16.602428845754243 68.68423125123299,16.599224913387694 68.63940571637137,16.476260560497057 68.64052644287396)))"
25650007615000,49,26,23,43.9,"MULTIPOLYGON(((16.599224913387694 68.63940571637137,16.602428845754243 68.68423125123299,16.72562547692609 68.68301815719482,16.722175508908077 68.63819541051359,16.599224913387694 68.63940571637137)))"
25700007615000,189,96,93,49,"MULTIPOLYGON(((16.722175508908077 68.63819541051359,16.72562547692609 68.68301815719482,16.848807202617333 68.68171529597707,16.845111292313742 68.63689554346139,16.722175508908077 68.63819541051359)))"
25750007615000,65,32,33,49.4,"MULTIPOLYGON(((16.845111292313742 68.63689554346139,16.848807202617333 68.68171529597707,16.971972962236713 68.6803226871969,16.96803120963979 68.63550613471504,16.845111292313742 68.63689554346139)))"
25800007615000,2,2,0,0,"MULTIPOLYGON(((16.96803120963979 68.63550613471504,16.971972962236713 68.6803226871969,17.095121696036497 68.67884035181774,17.09093420775604 68.63402720511297,16.96803120963979 68.63550613471504)))"
25850007615000,349,182,167,48.2,"MULTIPOLYGON(((17.09093420775604 68.63402720511297,17.095121696036497 68.67884035181774,17.21825234516808 68.67726831214776,17.213819234422076 68.63245877683045,17.09093420775604 68.63402720511297)))"
25900007615000,24,17,7,63.7,"MULTIPOLYGON(((17.213819234422076 68.63245877683045,17.21825234516808 68.67726831214776,17.34136385173748 68.67560659183856,17.336685238342156 68.63080087337818,17.213819234422076 68.63245877683045)))"
26000007615000,14,9,5,29.1,"MULTIPOLYGON(((17.459531169220043 68.62905351960087,17.464455158860737 68.67385521588373,17.58752521071912 68.67201421061704,17.582355977813638 68.62721674167555,17.459531169220043 68.62905351960087)))"
26050007615000,136,74,62,43.5,"MULTIPOLYGON(((17.582355977813638 68.62721674167555,17.58752521071912 68.67201421061704,17.71057295261426 68.67008360371095,17.70515861598952 68.62529056710996,17.582355977813638 68.62721674167555)))"
26100007615000,112,67,45,45.1,"MULTIPOLYGON(((17.70515861598952 68.62529056710996,17.71057295261426 68.67008360371095,17.833597331023086 68.66806342417473,17.827938036777358 68.62327502474075,17.70515861598952 68.62529056710996)))"
26300007615000,63,33,30,39.8,"MULTIPOLYGON(((18.196126543692955 68.61669249907368,18.202519768880002 68.66146575989177,18.325440183533285 68.6590876065986,18.31880265038131 68.61431980037011,18.196126543692955 68.61669249907368)))"
24750007620000,81,45,36,40.1,"MULTIPOLYGON(((14.383553295840654 68.69070247616571,14.382314880778198 68.73554263921498,14.505845465702158 68.73594810265195,14.506836238213625 68.69110700548772,14.383553295840654 68.69070247616571)))"
24800007620000,244,136,108,48.7,"MULTIPOLYGON(((14.506836238213625 68.69110700548772,14.505845465702158 68.73594810265195,14.629380343079825 68.7362634694682,14.63012344606764 68.691421645732,14.506836238213625 68.69110700548772)))"
24850007620000,61,32,29,53.7,"MULTIPOLYGON(((14.63012344606764 68.691421645732,14.629380343079825 68.7362634694682,14.75291843999763 68.73648873488992,14.753413853230208 68.69164639215337,14.63012344606764 68.691421645732)))"
25000007620000,27,16,11,55.9,"MULTIPOLYGON(((14.999999999999982 68.69182619132434,14.999999999999982 68.73666894927344,15.123541316629254 68.73662389550705,15.123293606640635 68.6917812413621,14.999999999999982 68.69182619132434)))"
25050007620000,506,264,242,40.9,"MULTIPOLYGON(((15.123293606640635 68.6917812413621,15.123541316629254 68.73662389550705,15.247081560002336 68.73648873488992,15.246586146769758 68.69164639215337,15.123293606640635 68.6917812413621)))"
25100007620000,24,14,10,40.1,"MULTIPOLYGON(((15.246586146769758 68.69164639215337,15.247081560002336 68.73648873488992,15.370619656920141 68.7362634694682,15.369876553932325 68.691421645732,15.246586146769758 68.69164639215337)))"
25150007620000,4243,2129,2114,41.3,"MULTIPOLYGON(((15.369876553932325 68.691421645732,15.370619656920141 68.7362634694682,15.494154534297806 68.73594810265195,15.493163761786342 68.69110700548772,15.369876553932325 68.691421645732)))"
25200007620000,145,77,68,39.7,"MULTIPOLYGON(((15.493163761786342 68.69110700548772,15.494154534297806 68.73594810265195,15.617685119221768 68.73554263921498,15.616446704159312 68.69070247616571,15.493163761786342 68.69110700548772)))"
25300007620000,2,1,1,0,"MULTIPOLYGON(((15.739724315104725 68.69020806386646,15.74121033900683 68.7350470852945,15.864729121253205 68.73446144839072,15.86299552895849 68.68962377604534,15.739724315104725 68.69020806386646)))"
25350007620000,19,9,10,52.1,"MULTIPOLYGON(((15.86299552895849 68.68962377604534,15.864729121253205 68.73446144839072,15.9882403939035 68.7337857373664,15.98625928039532 68.68894962151208,15.86299552895849 68.68962377604534)))"
25400007620000,37,19,18,51.4,"MULTIPOLYGON(((15.98625928039532 68.68894962151208,15.9882403939035 68.7337857373664,16.111743085299675 68.73301996244628,16.10951450448512 68.68818561043024,15.98625928039532 68.68894962151208)))"
25500007620000,51,25,26,40.1,"MULTIPOLYGON(((16.23276013674926 68.68733175431655,16.235236124239947 68.7321641352164,16.35871844003562 68.73121826862331,16.35599511321683 68.68638806604014,16.23276013674926 68.68733175431655)))"
25600007620000,853,442,411,43.7,"MULTIPOLYGON(((16.479218370480826 68.6853545598218,16.48218896256785 68.73018237697333,16.605646622344356 68.72905647593159,16.602428845754243 68.68423125123299,16.479218370480826 68.6853545598218)))"
25700007620000,65,31,34,54.4,"MULTIPOLYGON(((16.72562547692609 68.68301815719482,16.72909035055601 68.72784058252095,16.852519079133366 68.72653471512102,16.848807202617333 68.68171529597707,16.72562547692609 68.68301815719482)))"
25750007620000,129,61,68,50.8,"MULTIPOLYGON(((16.848807202617333 68.68171529597707,16.852519079133366 68.72653471512102,16.975931740803095 68.72513889346695,16.971972962236713 68.6803226871969,16.848807202617333 68.68171529597707)))"
25800007620000,15,7,8,49.5,"MULTIPOLYGON(((16.971972962236713 68.6803226871969,16.975931740803095 68.72513889346695,17.09932726914427 68.72365313864805,17.095121696036497 68.67884035181774,16.971972962236713 68.6803226871969)))"
25850007620000,170,123,47,48.5,"MULTIPOLYGON(((17.095121696036497 68.67884035181774,17.09932726914427 68.72365313864805,17.222704598644597 68.72207747310655,17.21825234516808 68.67726831214776,17.095121696036497 68.67884035181774)))"
25950007620000,117,65,52,45.5,"MULTIPOLYGON(((17.34136385173748 68.67560659183856,17.346062664756495 68.72041192063617,17.46940040395302 68.7186565063805,17.464455158860737 68.67385521588373,17.34136385173748 68.67560659183856)))"
26000007620000,323,165,158,45.4,"MULTIPOLYGON(((17.464455158860737 68.67385521588373,17.46940040395302 68.7186565063805,17.592716753783737 68.71681125683145,17.58752521071912 68.67201421061704,17.464455158860737 68.67385521588373)))"
26050007620000,106,53,53,42.5,"MULTIPOLYGON(((17.58752521071912 68.67201421061704,17.592716753783737 68.71681125683145,17.716010652930343 68.71487619982753,17.71057295261426 68.67008360371095,17.58752521071912 68.67201421061704)))"
26150007620000,6,4,2,55,"MULTIPOLYGON(((17.833597331023086 68.66806342417473,17.839281041262236 68.7128513645521,17.96252685989186 68.7107367815314,17.95659729365261 68.66595370235272,17.833597331023086 68.66806342417473)))"
26200007620000,101,54,47,42.6,"MULTIPOLYGON(((17.95659729365261 68.66595370235272,17.96252685989186 68.7107367815314,18.08574705122993 68.7085324826327,18.079571789494597 68.66375446992228,17.95659729365261 68.66595370235272)))"
26250007620000,40,20,20,50.8,"MULTIPOLYGON(((18.079571789494597 68.66375446992228,18.08574705122993 68.7085324826327,18.20894055904045 68.70623850106227,18.202519768880002 68.66146575989177,18.079571789494597 68.66375446992228)))"
26400007620000,33,17,16,55.9,"MULTIPOLYGON(((18.448331986626503 68.65662004570686,18.45524330623033 68.70138162941305,18.578350440396974 68.6988188124219,18.57119413283324 68.65406311420516,18.448331986626503 68.65662004570686)))"
26500007620000,10,6,4,53,"MULTIPOLYGON(((18.69402557838234 68.65141685040427,18.70142668071942 68.69616645892977,18.8244709785472 68.6934246088041,18.816825281111395 68.64868129393462,18.69402557838234 68.65141685040427)))"
24750007625000,56,27,29,54.6,"MULTIPOLYGON(((14.382314880778198 68.73554263921498,14.381071100529274 68.78038255220567,14.504850400698928 68.78078895352022,14.505845465702158 68.73594810265195,14.382314880778198 68.73554263921498)))"
24800007625000,124,61,63,49.9,"MULTIPOLYGON(((14.505845465702158 68.73594810265195,14.504850400698928 68.78078895352022,14.628634020523316 68.78110504983519,14.629380343079825 68.7362634694682,14.505845465702158 68.73594810265195)))"
24850007625000,111,53,58,50.7,"MULTIPOLYGON(((14.629380343079825 68.7362634694682,14.628634020523316 68.78110504983519,14.752420880290744 68.781330836348,14.75291843999763 68.73648873488992,14.629380343079825 68.7362634694682)))"
24950007625000,5,3,2,62.8,"MULTIPOLYGON(((14.87645868337071 68.73662389550705,14.876209900116379 68.781466309628,14.999999999999982 68.78151146761675,14.999999999999982 68.73666894927344,14.87645868337071 68.73662389550705)))"
25000007625000,62,36,26,47.2,"MULTIPOLYGON(((14.999999999999982 68.73666894927344,14.999999999999982 68.78151146761675,15.123790099883585 68.781466309628,15.123541316629254 68.73662389550705,14.999999999999982 68.73666894927344)))"
25050007625000,210,108,102,43.4,"MULTIPOLYGON(((15.123541316629254 68.73662389550705,15.123790099883585 68.781466309628,15.24757911970922 68.781330836348,15.247081560002336 68.73648873488992,15.123541316629254 68.73662389550705)))"
25100007625000,270,140,130,39.3,"MULTIPOLYGON(((15.247081560002336 68.73648873488992,15.24757911970922 68.781330836348,15.371365979476648 68.78110504983519,15.370619656920141 68.7362634694682,15.247081560002336 68.73648873488992)))"
25150007625000,201,108,93,44.1,"MULTIPOLYGON(((15.370619656920141 68.7362634694682,15.371365979476648 68.78110504983519,15.495149599301039 68.78078895352022,15.494154534297806 68.73594810265195,15.370619656920141 68.7362634694682)))"
25200007625000,293,155,138,41.7,"MULTIPOLYGON(((15.494154534297806 68.73594810265195,15.495149599301039 68.78078895352022,15.618928899470692 68.78038255220567,15.617685119221768 68.73554263921498,15.494154534297806 68.73594810265195)))"
25250007625000,58,30,28,42.1,"MULTIPOLYGON(((15.617685119221768 68.73554263921498,15.618928899470692 68.78038255220567,15.742702800504693 68.77988585206586,15.74121033900683 68.7350470852945,15.617685119221768 68.73554263921498)))"
25300007625000,30,18,12,37.7,"MULTIPOLYGON(((15.74121033900683 68.7350470852945,15.742702800504693 68.77988585206586,15.866470223210559 68.77929886064615,15.864729121253205 68.73446144839072,15.74121033900683 68.7350470852945)))"
25350007625000,19,10,9,54.8,"MULTIPOLYGON(((15.864729121253205 68.73446144839072,15.866470223210559 68.77929886064615,15.990230088741837 68.77862158686288,15.9882403939035 68.7337857373664,15.864729121253205 68.73446144839072)))"
25400007625000,59,32,27,50,"MULTIPOLYGON(((15.9882403939035 68.7337857373664,15.990230088741837 68.77862158686288,16.11398131865565 68.77785404100239,16.111743085299675 68.73301996244628,15.9882403939035 68.7337857373664)))"
25450007625000,1221,587,634,44.3,"MULTIPOLYGON(((16.111743085299675 68.73301996244628,16.11398131865565 68.77785404100239,16.237722834970217 68.77699623472056,16.235236124239947 68.7321641352164,16.111743085299675 68.73301996244628)))"
25500007625000,393,200,193,42,"MULTIPOLYGON(((16.235236124239947 68.7321641352164,16.237722834970217 68.77699623472056,16.36145356022228 68.77604818104209,16.35871844003562 68.73121826862331,16.235236124239947 68.7321641352164)))"
25550007625000,117,68,49,40,"MULTIPOLYGON(((16.35871844003562 68.73121826862331,16.36145356022228 68.77604818104209,16.485172417524467 68.77500989435954,16.48218896256785 68.73018237697333,16.35871844003562 68.73121826862331)))"
25600007625000,4893,2467,2426,39.4,"MULTIPOLYGON(((16.48218896256785 68.73018237697333,16.485172417524467 68.77500989435954,16.608878330622606 68.77388139043244,16.605646622344356 68.72905647593159,16.48218896256785 68.73018237697333)))"
25700007625000,35,18,17,54.1,"MULTIPOLYGON(((16.72909035055601 68.72784058252095,16.73257022395291 68.7726626863863,16.856247022699108 68.77135380071145,16.852519079133366 68.72653471512102,16.72909035055601 68.72784058252095)))"
25750007625000,1,1,0,0,"MULTIPOLYGON(((16.852519079133366 68.72653471512102,16.856247022699108 68.77135380071145,16.979907652849466 68.7699547532619,16.975931740803095 68.72513889346695,16.852519079133366 68.72653471512102)))"
25800007625000,5,5,0,53,"MULTIPOLYGON(((16.975931740803095 68.72513889346695,16.979907652849466 68.7699547532619,17.103551041253674 68.76846556525408,17.09932726914427 68.72365313864805,16.975931740803095 68.72513889346695)))"
25850007625000,113,55,58,51.6,"MULTIPOLYGON(((17.09932726914427 68.72365313864805,17.103551041253674 68.76846556525408,17.22717611567967 68.76688625926532,17.222704598644597 68.72207747310655,17.09932726914427 68.72365313864805)))"
25900007625000,71,33,38,45.2,"MULTIPOLYGON(((17.222704598644597 68.72207747310655,17.22717611567967 68.76688625926532,17.350781804870287 68.76521685923255,17.346062664756495 68.72041192063617,17.222704598644597 68.72207747310655)))"
25950007625000,62,36,26,53.8,"MULTIPOLYGON(((17.346062664756495 68.72041192063617,17.350781804870287 68.76521685923255,17.47436703859982 68.76345739045075,17.46940040395302 68.7186565063805,17.346062664756495 68.72041192063617)))"
26000007625000,15,6,9,51.7,"MULTIPOLYGON(((17.46940040395302 68.7186565063805,17.47436703859982 68.76345739045075,17.597930747730413 68.76160787957117,17.592716753783737 68.71681125683145,17.46940040395302 68.7186565063805)))"
26100007625000,476,234,242,42.3,"MULTIPOLYGON(((17.716010652930343 68.71487619982753,17.72147186426832 68.75966835459982,17.844989321420034 68.7576388448955,17.839281041262236 68.7128513645521,17.716010652930343 68.71487619982753)))"
26150007625000,74,42,32,47.2,"MULTIPOLYGON(((17.839281041262236 68.7128513645521,17.844989321420034 68.7576388448955,17.96848205364822 68.75551938116794,17.96252685989186 68.7107367815314,17.839281041262236 68.7128513645521)))"
26250007625000,20,9,11,53.8,"MULTIPOLYGON(((18.08574705122993 68.7085324826327,18.09194899672751 68.75330999547593,18.215389087800087 68.75101072122517,18.20894055904045 68.70623850106227,18.08574705122993 68.7085324826327)))"
26400007625000,36,20,16,43.1,"MULTIPOLYGON(((18.45524330623033 68.70138162941305,18.462184469664184 68.74614264739174,18.585537642075867 68.74357392133534,18.578350440396974 68.6988188124219,18.45524330623033 68.70138162941305)))"
26450007625000,4,1,3,0,"MULTIPOLYGON(((18.578350440396974 68.6988188124219,18.585537642075867 68.74357392133534,18.708859725831083 68.74091545376801,18.70142668071942 68.69616645892977,18.578350440396974 68.6988188124219)))"
24800007630000,13,5,8,65.5,"MULTIPOLYGON(((14.504850400698928 68.78078895352022,14.503851016002493 68.8256295584608,14.627884457994924 68.82594638721991,14.628634020523316 68.78110504983519,14.504850400698928 68.78078895352022)))"
24850007630000,7,5,2,45,"MULTIPOLYGON(((14.628634020523316 68.78110504983519,14.627884457994924 68.82594638721991,14.751921160506404 68.82617269692787,14.752420880290744 68.781330836348,14.628634020523316 68.78110504983519)))"
24900007630000,6,4,2,57.2,"MULTIPOLYGON(((14.752420880290744 68.781330836348,14.751921160506404 68.82617269692787,14.875960036794469 68.82630848413326,14.876209900116379 68.781466309628,14.752420880290744 68.781330836348)))"
24950007630000,21,11,10,63.2,"MULTIPOLYGON(((14.876209900116379 68.781466309628,14.875960036794469 68.82630848413326,14.999999999999982 68.82635374676515,14.999999999999982 68.78151146761675,14.876209900116379 68.781466309628)))"
25000007630000,75,42,33,49.8,"MULTIPOLYGON(((14.999999999999982 68.78151146761675,14.999999999999982 68.82635374676515,15.124039963205497 68.82630848413326,15.123790099883585 68.781466309628,14.999999999999982 68.78151146761675)))"
25050007630000,121,63,58,44,"MULTIPOLYGON(((15.123790099883585 68.781466309628,15.124039963205497 68.82630848413326,15.24807883949356 68.82617269692787,15.24757911970922 68.781330836348,15.123790099883585 68.781466309628)))"
25100007630000,47,26,21,41.1,"MULTIPOLYGON(((15.24757911970922 68.781330836348,15.24807883949356 68.82617269692787,15.372115542005043 68.82594638721991,15.371365979476648 68.78110504983519,15.24757911970922 68.781330836348)))"
25150007630000,18,10,8,36,"MULTIPOLYGON(((15.371365979476648 68.78110504983519,15.372115542005043 68.82594638721991,15.496148983997474 68.8256295584608,15.495149599301039 68.78078895352022,15.371365979476648 68.78110504983519)))"
25200007630000,16,6,10,48.8,"MULTIPOLYGON(((15.495149599301039 68.78078895352022,15.496148983997474 68.8256295584608,15.62017807890334 68.82522221548219,15.618928899470692 68.78038255220567,15.495149599301039 68.78078895352022)))"
25350007630000,28,13,15,48.7,"MULTIPOLYGON(((15.866470223210559 68.77929886064615,15.86821888240977 68.82413601309229,15.992228419274484 68.82345717024221,15.990230088741837 68.77862158686288,15.866470223210559 68.77929886064615)))"
25400007630000,217,112,105,47.2,"MULTIPOLYGON(((15.990230088741837 68.77862158686288,15.992228419274484 68.82345717024221,16.116229265697292 68.82268784629403,16.11398131865565 68.77785404100239,15.990230088741837 68.77862158686288)))"
25450007630000,408,190,218,41.6,"MULTIPOLYGON(((16.11398131865565 68.77785404100239,16.116229265697292 68.82268784629403,16.24022033685898 68.82182805297411,16.237722834970217 68.77699623472056,16.11398131865565 68.77785404100239)))"
25500007630000,5,1,4,26.2,"MULTIPOLYGON(((16.237722834970217 68.77699623472056,16.24022033685898 68.82182805297411,16.364200548464346 68.82087780338583,16.36145356022228 68.77604818104209,16.237722834970217 68.77699623472056)))"
25550007630000,416,217,199,37.6,"MULTIPOLYGON(((16.36145356022228 68.77604818104209,16.364200548464346 68.82087780338583,16.4881688168002 68.81983711200873,16.485172417524467 68.77500989435954,16.36145356022228 68.77604818104209)))"
25600007630000,15695,7762,7933,42.4,"MULTIPOLYGON(((16.485172417524467 68.77500989435954,16.4881688168002 68.81983711200873,16.612124058793274 68.81870599469758,16.608878330622606 68.77388139043244,16.485172417524467 68.77500989435954)))"
25800007630000,31,15,16,49.5,"MULTIPOLYGON(((16.979907652849466 68.7699547532619,16.983900806795024 68.81477026631345,17.10779312750378 68.8132776312802,17.103551041253674 68.76846556525408,16.979907652849466 68.7699547532619)))"
25850007630000,587,305,282,46.6,"MULTIPOLYGON(((17.103551041253674 68.76846556525408,17.10779312750378 68.8132776312802,17.231667018122025 68.8116946701759,17.22717611567967 68.76688625926532,17.103551041253674 68.76846556525408)))"
25900007630000,54,27,27,55.2,"MULTIPOLYGON(((17.22717611567967 68.76688625926532,17.231667018122025 68.8116946701759,17.355521400626483 68.8100214070819,17.350781804870287 68.76521685923255,17.22717611567967 68.76688625926532)))"
25950007630000,56,31,25,55.1,"MULTIPOLYGON(((17.350781804870287 68.76521685923255,17.355521400626483 68.8100214070819,17.479355198036252 68.80825786744573,17.47436703859982 68.76345739045075,17.350781804870287 68.76521685923255)))"
26000007630000,9,6,3,69.4,"MULTIPOLYGON(((17.47436703859982 68.76345739045075,17.479355198036252 68.80825786744573,17.60316733446981 68.8064040780794,17.597930747730413 68.76160787957117,17.47436703859982 68.76345739045075)))"
26050007630000,31,15,16,57.1,"MULTIPOLYGON(((17.597930747730413 68.76160787957117,17.60316733446981 68.8064040780794,17.726956735201856 68.80446006715773,17.72147186426832 68.75966835459982,17.597930747730413 68.76160787957117)))"
26100007630000,286,139,147,48.6,"MULTIPOLYGON(((17.72147186426832 68.75966835459982,17.726956735201856 68.80446006715773,17.850722326720025 68.80242586421646,17.844989321420034 68.7576388448955,17.72147186426832 68.75966835459982)))"
26250007630000,35,16,19,52.8,"MULTIPOLYGON(((18.09194899672751 68.75330999547593,18.09817779446896 68.7980870072113,18.221865530247612 68.79578241900602,18.215389087800087 68.75101072122517,18.09194899672751 68.75330999547593)))"
26400007630000,67,35,32,44.6,"MULTIPOLYGON(((18.462184469664184 68.74614264739174,18.469155665184065 68.79090309798583,18.592755932685026 68.78832843913938,18.585537642075867 68.74357392133534,18.462184469664184 68.74614264739174)))"
26450007630000,26,12,14,36.7,"MULTIPOLYGON(((18.585537642075867 68.74357392133534,18.592755932685026 68.78832843913938,18.716324915074452 68.7856638329589,18.708859725831083 68.74091545376801,18.585537642075867 68.74357392133534)))"
24950007635000,1,1,0,0,"MULTIPOLYGON(((14.875960036794469 68.82630848413326,14.87570908654538 68.87115041943156,14.999999999999982 68.87119578713018,14.999999999999982 68.82635374676515,14.875960036794469 68.82630848413326)))"
25000007635000,33,16,17,53.3,"MULTIPOLYGON(((14.999999999999982 68.82635374676515,14.999999999999982 68.87119578713018,15.124290913454587 68.87115041943156,15.124039963205497 68.82630848413326,14.999999999999982 68.82635374676515)))"
25050007635000,24,12,12,53,"MULTIPOLYGON(((15.124039963205497 68.82630848413326,15.124290913454587 68.87115041943156,15.248580733073918 68.87101431703027,15.24807883949356 68.82617269692787,15.124039963205497 68.82630848413326)))"
25100007635000,44,24,20,42.4,"MULTIPOLYGON(((15.24807883949356 68.82617269692787,15.248580733073918 68.87101431703027,15.37286836508165 68.87078748200975,15.372115542005043 68.82594638721991,15.24807883949356 68.82617269692787)))"
25150007635000,6,3,3,53.3,"MULTIPOLYGON(((15.372115542005043 68.82594638721991,15.37286836508165 68.87078748200975,15.497152715819349 68.87046991784234,15.496148983997474 68.8256295584608,15.372115542005043 68.82594638721991)))"
25200007635000,71,44,27,43.3,"MULTIPOLYGON(((15.496148983997474 68.8256295584608,15.497152715819349 68.87046991784234,15.62143269180541 68.87006162938897,15.62017807890334 68.82522221548219,15.496148983997474 68.8256295584608)))"
25250007635000,45,25,20,49.3,"MULTIPOLYGON(((15.62017807890334 68.82522221548219,15.62143269180541 68.87006162938897,15.745707199793943 68.86956262289887,15.744201740388366 68.82472436449564,15.62017807890334 68.82522221548219)))"
25400007635000,19,11,8,54.8,"MULTIPOLYGON(((15.992228419274484 68.82345717024221,15.994235440326696 68.8682924877443,16.1184869880874 68.86752137851562,16.116229265697292 68.82268784629403,15.992228419274484 68.82345717024221)))"
25450007635000,93,47,46,45.8,"MULTIPOLYGON(((16.116229265697292 68.82268784629403,16.1184869880874 68.86752137851562,16.242728698401063 68.86665959012053,16.24022033685898 68.82182805297411,16.116229265697292 68.82268784629403)))"
25500007635000,263,136,127,43,"MULTIPOLYGON(((16.24022033685898 68.82182805297411,16.242728698401063 68.86665959012053,16.366959480082567 68.86570713574177,16.364200548464346 68.82087780338583,16.24022033685898 68.82182805297411)))"
25550007635000,577,292,285,42.7,"MULTIPOLYGON(((16.364200548464346 68.82087780338583,16.366959480082567 68.86570713574177,16.491178242535014 68.86466402994662,16.4881688168002 68.81983711200873,16.364200548464346 68.82087780338583)))"
25600007635000,217,102,115,45.8,"MULTIPOLYGON(((16.4881688168002 68.81983711200873,16.491178242535014 68.86466402994662,16.6153838958082 68.86353028868582,16.612124058793274 68.81870599469758,16.4881688168002 68.81983711200873)))"
25800007635000,128,64,64,53.3,"MULTIPOLYGON(((16.983900806795024 68.81477026631345,16.987911311977243 68.859585432348,17.112053644008608 68.85808933636487,17.10779312750378 68.8132776312802,16.983900806795024 68.81477026631345)))"
25850007635000,112,56,56,50.9,"MULTIPOLYGON(((17.10779312750378 68.8132776312802,17.112053644008608 68.85808933636487,17.236177428851903 68.85650270538349,17.231667018122025 68.8116946701759,17.10779312750378 68.8132776312802)))"
25950007635000,44,23,21,61.4,"MULTIPOLYGON(((17.355521400626483 68.8100214070819,17.3602815816606 68.85482556363084,17.484365018641604 68.85305793670832,17.479355198036252 68.80825786744573,17.355521400626483 68.8100214070819)))"
26000007635000,8,5,3,50.6,"MULTIPOLYGON(((17.479355198036252 68.80825786744573,17.484365018641604 68.85305793670832,17.608426657112872 68.85119985159002,17.60316733446981 68.8064040780794,17.479355198036252 68.80825786744573)))"
26150007635000,12,6,6,55.9,"MULTIPOLYGON(((17.850722326720025 68.80242586421646,17.856480213697775 68.84721242151532,17.980469972518808 68.84508313735442,17.97446303678142 68.80030150015037,17.850722326720025 68.80242586421646)))"
26250007635000,85,45,40,46.1,"MULTIPOLYGON(((18.09817779446896 68.7980870072113,18.10443361435898 68.84286351658479,18.22837006295002 68.84055359301601,18.221865530247612 68.79578241900602,18.09817779446896 68.7980870072113)))"
26300007635000,11,5,6,36.9,"MULTIPOLYGON(((18.221865530247612 68.79578241900602,18.22837006295002 68.84055359301601,18.352278243476867 68.83815340181852,18.345525176020367 68.79338777049416,18.221865530247612 68.79578241900602)))"
26350007635000,168,83,85,41,"MULTIPOLYGON(((18.345525176020367 68.79338777049416,18.352278243476867 68.83815340181852,18.47615708263417 68.83566297952137,18.469155665184065 68.79090309798583,18.345525176020367 68.79338777049416)))"
26400007635000,138,73,65,41.2,"MULTIPOLYGON(((18.469155665184065 68.79090309798583,18.47615708263417 68.83566297952137,18.600005508682404 68.83308236400985,18.592755932685026 68.78832843913938,18.469155665184065 68.79090309798583)))"
26900007635000,9,6,3,48.6,"MULTIPOLYGON(((19.70362346944407 68.76111400202889,19.713096762970693 68.80580504887358,19.836582496489683 68.80232488142192,19.82686332258531 68.75764184577382,19.70362346944407 68.76111400202889)))"
24950007640000,13,6,7,71.5,"MULTIPOLYGON(((14.87570908654538 68.87115041943156,14.875457042451185 68.9159921159323,14.999999999999982 68.91603758912386,14.999999999999982 68.87119578713018,14.87570908654538 68.87115041943156)))"
25000007640000,1661,869,792,42.7,"MULTIPOLYGON(((14.999999999999982 68.87119578713018,14.999999999999982 68.91603758912386,15.124542957548782 68.9159921159323,15.124290913454587 68.87115041943156,14.999999999999982 68.87119578713018)))"
25050007640000,289,150,139,42.7,"MULTIPOLYGON(((15.124290913454587 68.87115041943156,15.124542957548782 68.9159921159323,15.249084814285526 68.91585569705644,15.248580733073918 68.87101431703027,15.124290913454587 68.87115041943156)))"
25100007640000,545,271,274,44.5,"MULTIPOLYGON(((15.248580733073918 68.87101431703027,15.249084814285526 68.91585569705644,15.373624469457758 68.91562833459237,15.37286836508165 68.87078748200975,15.248580733073918 68.87101431703027)))"
25150007640000,9,4,5,71.9,"MULTIPOLYGON(((15.37286836508165 68.87078748200975,15.373624469457758 68.91562833459237,15.498160822432153 68.91531003203353,15.497152715819349 68.87046991784234,15.37286836508165 68.87078748200975)))"
25200007640000,37,17,20,54.5,"MULTIPOLYGON(((15.497152715819349 68.87046991784234,15.498160822432153 68.91531003203353,15.622692772754105 68.9149007942704,15.62143269180541 68.87006162938897,15.497152715819349 68.87046991784234)))"
25500007640000,61,27,34,49.6,"MULTIPOLYGON(((16.242728698401063 68.86665959012053,16.24524798867333 68.91149084630149,16.369730431037645 68.91053617819495,16.366959480082567 68.86570713574177,16.242728698401063 68.86665959012053)))"
25550007640000,41,22,19,47.8,"MULTIPOLYGON(((16.366959480082567 68.86570713574177,16.369730431037645 68.91053617819495,16.49420077756661 68.90949064819615,16.491178242535014 68.86466402994662,16.366959480082567 68.86570713574177)))"
25600007640000,199,93,106,47.8,"MULTIPOLYGON(((16.491178242535014 68.86466402994662,16.49420077756661 68.90949064819615,16.61865793137469 68.90835427235275,16.6153838958082 68.86353028868582,16.491178242535014 68.86466402994662)))"
25650007640000,17,8,9,48.5,"MULTIPOLYGON(((16.6153838958082 68.86353028868582,16.61865793137469 68.90835427235275,16.743100796288992 68.90712706810318,16.739575350657073 68.86230592929269,16.6153838958082 68.86353028868582)))"
25800007640000,23,12,11,68.3,"MULTIPOLYGON(((16.987911311977243 68.859585432348,16.991939278661604 68.9044002510868,17.116332707867453 68.90290068014055,17.112053644008608 68.85808933636487,16.987911311977243 68.859585432348)))"
25850007640000,32,16,16,48.8,"MULTIPOLYGON(((17.112053644008608 68.85808933636487,17.116332707867453 68.90290068014055,17.240707471791957 68.90131036442645,17.236177428851903 68.85650270538349,17.112053644008608 68.85808933636487)))"
25900007640000,11,7,4,64.5,"MULTIPOLYGON(((17.236177428851903 68.85650270538349,17.240707471791957 68.90131036442645,17.365062478707586 68.8996293283184,17.3602815816606 68.85482556363084,17.236177428851903 68.85650270538349)))"
25950007640000,9,4,5,73.8,"MULTIPOLYGON(((17.3602815816606 68.85482556363084,17.365062478707586 68.8996293283184,17.48939663795145 68.8978575975729,17.484365018641604 68.85305793670832,17.3602815816606 68.85482556363084)))"
26050007640000,48,23,25,43,"MULTIPOLYGON(((17.608426657112872 68.85119985159002,17.613708859983536 68.89599519932747,17.737998056444727 68.8940421620988,17.732465415560853 68.84925133662095,17.608426657112872 68.85119985159002)))"
26100007640000,1033,522,511,44,"MULTIPOLYGON(((17.732465415560853 68.84925133662095,17.737998056444727 68.8940421620988,17.862263140214736 68.89199851578094,17.856480213697775 68.84721242151532,17.732465415560853 68.84925133662095)))"
26150007640000,54,30,24,51.1,"MULTIPOLYGON(((17.856480213697775 68.84721242151532,17.862263140214736 68.89199851578094,17.986503025469826 68.88986429164335,17.980469972518808 68.84508313735442,17.856480213697775 68.84721242151532)))"
26200007640000,284,156,128,43,"MULTIPOLYGON(((17.980469972518808 68.84508313735442,17.986503025469826 68.88986429164335,18.110716627740366 68.88763952232887,18.10443361435898 68.84286351658479,17.980469972518808 68.84508313735442)))"
26250007640000,4,2,2,0,"MULTIPOLYGON(((18.10443361435898 68.84286351658479,18.110716627740366 68.88763952232887,18.234902863968212 68.88532424185152,18.22837006295002 68.84055359301601,18.10443361435898 68.84286351658479)))"
26300007640000,2343,1173,1170,39.3,"MULTIPOLYGON(((18.22837006295002 68.84055359301601,18.234902863968212 68.88532424185152,18.359060652563908 68.88291848559439,18.352278243476867 68.83815340181852,18.22837006295002 68.84055359301601)))"
26350007640000,265,160,105,35.2,"MULTIPOLYGON(((18.352278243476867 68.83815340181852,18.359060652563908 68.88291848559439,18.483188913463657 68.88042229030725,18.47615708263417 68.83566297952137,18.352278243476867 68.83815340181852)))"
26600007640000,4,2,2,0,"MULTIPOLYGON(((18.97135761543984 68.82479975733362,18.97938513539992 68.86953390155392,19.10334961422463 68.86658611002714,19.095073704929074 68.82185877485483,18.97135761543984 68.82479975733362)))"
25000007645000,1039,528,511,42.4,"MULTIPOLYGON(((14.999999999999982 68.91603758912386,14.999999999999982 68.96087915315884,15.124796102464948 68.96083357404541,15.124542957548782 68.9159921159323,14.999999999999982 68.91603758912386)))"
25050007645000,232,117,115,42.3,"MULTIPOLYGON(((15.124542957548782 68.9159921159323,15.124796102464948 68.96083357404541,15.249591097081511 68.96069683740814,15.249084814285526 68.91585569705644,15.124542957548782 68.9159921159323)))"
25100007645000,104,54,50,45.3,"MULTIPOLYGON(((15.249084814285526 68.91585569705644,15.249591097081511 68.96069683740814,15.374383876061486 68.96046894535591,15.373624469457758 68.91562833459237,15.249084814285526 68.91585569705644)))"
25200007645000,9,6,3,60.4,"MULTIPOLYGON(((15.498160822432153 68.91531003203353,15.49917333173711 68.96014990140343,15.623958356621243 68.95973971047091,15.622692772754105 68.9149007942704,15.498160822432153 68.91531003203353)))"
25250007645000,58,30,28,54.9,"MULTIPOLYGON(((15.622692772754105 68.9149007942704,15.623958356621243 68.95973971047091,15.748737843467525 68.95923837888388,15.747219220207242 68.91440062759013,15.622692772754105 68.9149007942704)))"
25350007645000,2,1,1,0,"MULTIPOLYGON(((15.87173906487293 68.91380953967625,15.873510685330523 68.95864591437261,15.998275775625817 68.95796232607168,15.996251207189736 68.91312753960808,15.87173906487293 68.91380953967625)))"
25500007645000,19,12,7,55.1,"MULTIPOLYGON(((16.24524798867333 68.91149084630149,16.24777827734088 68.95632182165707,16.372513477937 68.9553649308282,16.369730431037645 68.91053617819495,16.24524798867333 68.91149084630149)))"
25600007645000,10,7,3,63,"MULTIPOLYGON(((16.49420077756661 68.90949064819615,16.497236505437872 68.95431696677761,16.621946255963557 68.9531779456506,16.61865793137469 68.90835427235275,16.49420077756661 68.90949064819615)))"
25650007645000,108,51,57,54.8,"MULTIPOLYGON(((16.61865793137469 68.90835427235275,16.621946255963557 68.9531779456506,16.746641626354382 68.9519478849917,16.743100796288992 68.90712706810318,16.61865793137469 68.90835427235275)))"
25850007645000,132,67,65,52.2,"MULTIPOLYGON(((17.116332707867453 68.90290068014055,17.120630437175368 68.94771166223366,17.245257271918337 68.94611764683638,17.240707471791957 68.90131036442645,17.116332707867453 68.90290068014055)))"
25900007645000,24,13,11,54.3,"MULTIPOLYGON(((17.240707471791957 68.90131036442645,17.245257271918337 68.94611764683638,17.36986422361348 68.94443270057593,17.365062478707586 68.8996293283184,17.240707471791957 68.90131036442645)))"
26050007645000,251,131,120,47.5,"MULTIPOLYGON(((17.613708859983536 68.89599519932747,17.619014088631562 68.94079012050675,17.743554810235885 68.9388325426901,17.737998056444727 68.8940421620988,17.613708859983536 68.89599519932747)))"
26100007645000,235,127,108,46.6,"MULTIPOLYGON(((17.737998056444727 68.8940421620988,17.743554810235885 68.9388325426901,17.868071265472313 68.93678414599077,17.862263140214736 68.89199851578094,17.737998056444727 68.8940421620988)))"
26150007645000,60,31,29,51.4,"MULTIPOLYGON(((17.862263140214736 68.89199851578094,17.868071265472313 68.93678414599077,17.992562361640655 68.93464496186796,17.986503025469826 68.88986429164335,17.862263140214736 68.89199851578094)))"
26200007645000,19,12,7,59.4,"MULTIPOLYGON(((17.986503025469826 68.88986429164335,17.992562361640655 68.93464496186796,18.117027007409224 68.93241502316238,18.110716627740366 68.88763952232887,17.986503025469826 68.88986429164335)))"
26300007645000,18,10,8,53.9,"MULTIPOLYGON(((18.234902863968212 68.88532424185152,18.241464112872855 68.93009436409426,18.365872589610646 68.92768302026107,18.359060652563908 68.88291848559439,18.234902863968212 68.88532424185152)))"
26350007645000,133,61,72,44,"MULTIPOLYGON(((18.359060652563908 68.88291848559439,18.365872589610646 68.92768302026107,18.49025135074361 68.92518102863522,18.483188913463657 68.88042229030725,18.359060652563908 68.88291848559439)))"
26600007645000,48,29,19,52.5,"MULTIPOLYGON(((18.97938513539992 68.86953390155392,18.98744755882034 68.91426737163704,19.111661496714625 68.91131274358173,19.10334961422463 68.86658611002714,18.97938513539992 68.86953390155392)))"
26800007645000,9,4,5,62.2,"MULTIPOLYGON(((19.475022944198848 68.85720178195434,19.48408180661817 68.90190666350824,19.608144500391507 68.89859073110333,19.598837132636145 68.85389351339762,19.475022944198848 68.85720178195434)))"
28300007645000,9,6,3,70.9,"MULTIPOLYGON(((23.167713288667453 68.71905057106888,23.184090289171774 68.76343735839964,23.30648501585319 68.75744325587962,23.289869923157468 68.71307014919903,23.167713288667453 68.71905057106888)))"
25000007650000,36,18,18,43.2,"MULTIPOLYGON(((14.999999999999982 68.96087915315884,14.999999999999982 69.00572047964833,15.125050355239557 69.0056747941813,15.124796102464948 68.96083357404541,14.999999999999982 68.96087915315884)))"
25050007650000,135,74,61,45.7,"MULTIPOLYGON(((15.124796102464948 68.96083357404541,15.125050355239557 69.0056747941813,15.250099595534158 69.00553773848752,15.249591097081511 68.96069683740814,15.124796102464948 68.96083357404541)))"
25150007650000,13,7,6,47.8,"MULTIPOLYGON(((15.374383876061486 68.96046894535591,15.375146605999667 69.00530931468874,15.50019027187369 69.00498952632111,15.49917333173711 68.96014990140343,15.374383876061486 68.96046894535591)))"
25200007650000,9,5,4,60.7,"MULTIPOLYGON(((15.49917333173711 68.96014990140343,15.50019027187369 69.00498952632111,15.625229478576381 69.00457837833493,15.623958356621243 68.95973971047091,15.49917333173711 68.96014990140343)))"
25250007650000,244,128,116,44.9,"MULTIPOLYGON(((15.623958356621243 68.95973971047091,15.625229478576381 69.00457837833493,15.750263111771263 69.00407587709425,15.748737843467525 68.95923837888388,15.623958356621243 68.95973971047091)))"
25500007650000,65,37,28,51.9,"MULTIPOLYGON(((16.24777827734088 68.95632182165707,16.250319634663295 69.00115251632545,16.375308698041707 69.00019339372204,16.372513477937 68.9553649308282,16.24777827734088 68.95632182165707)))"
25550007650000,13,9,4,50.9,"MULTIPOLYGON(((16.372513477937 68.9553649308282,16.375308698041707 69.00019339372204,16.500285510404368 68.99914298570843,16.497236505437872 68.95431696677761,16.372513477937 68.9553649308282)))"
25600007650000,173,87,86,53.4,"MULTIPOLYGON(((16.497236505437872 68.95431696677761,16.500285510404368 68.99914298570843,16.62524896081726 68.99800130852827,16.621946255963557 68.9531779456506,16.497236505437872 68.95431696677761)))"
25650007650000,29,13,16,51.7,"MULTIPOLYGON(((16.621946255963557 68.9531779456506,16.62524896081726 68.99800130852827,16.75019793907435 68.99676837983307,16.746641626354382 68.9519478849917,16.621946255963557 68.9531779456506)))"
25700007650000,1,1,0,0,"MULTIPOLYGON(((16.746641626354382 68.9519478849917,16.75019793907435 68.99676837983307,16.87513133575778 68.99544421868097,16.87132151423052 68.95062680374356,16.746641626354382 68.9519478849917)))"
25950007650000,12,7,5,46.5,"MULTIPOLYGON(((17.36986422361348 68.94443270057593,17.37468694934723 68.989235679827,17.499525828682057 68.98745569140263,17.49445019466991 68.94265684936532,17.36986422361348 68.94443270057593)))"
26000007650000,23,12,11,62,"MULTIPOLYGON(((17.49445019466991 68.94265684936532,17.499525828682057 68.98745569140263,17.6243424898456 68.98558461433318,17.619014088631562 68.94079012050675,17.49445019466991 68.94265684936532)))"
26050007650000,26,13,13,60.3,"MULTIPOLYGON(((17.619014088631562 68.94079012050675,17.6243424898456 68.98558461433318,17.749135830613323 68.98362247748302,17.743554810235885 68.9388325426901,17.619014088631562 68.94079012050675)))"
26100007650000,26,14,12,46.3,"MULTIPOLYGON(((17.743554810235885 68.9388325426901,17.749135830613323 68.98362247748302,17.873904750026067 68.98156931111055,17.868071265472313 68.93678414599077,17.743554810235885 68.9388325426901)))"
26200007650000,6,1,5,65.8,"MULTIPOLYGON(((17.992562361640655 68.93464496186796,17.998648148449004 68.97942514686616,18.123364927630423 68.97719001779019,18.117027007409224 68.93241502316238,17.992562361640655 68.93464496186796)))"
26350007650000,55,34,21,54.9,"MULTIPOLYGON(((18.365872589610646 68.92768302026107,18.372714242528772 68.97244700424164,18.497344589184202 68.96993919277949,18.49025135074361 68.92518102863522,18.365872589610646 68.92768302026107)))"
26400007650000,2,1,1,0,"MULTIPOLYGON(((18.49025135074361 68.92518102863522,18.497344589184202 68.96993919277949,18.621943938591304 68.96734056250197,18.614599310991988 68.92258842756156,18.49025135074361 68.92518102863522)))"
26550007650000,27,13,14,57.4,"MULTIPOLYGON(((18.86319849605522 68.91713155729781,18.87104528554709 68.96187100669944,18.995545107425404 68.95900016521003,18.98744755882034 68.91426737163704,18.86319849605522 68.91713155729781)))"
26750007650000,8,4,4,53.8,"MULTIPOLYGON(((19.35997969410787 68.90513234231638,19.36882815140368 68.94984391937474,19.49318008812532 68.94661075299047,19.48408180661817 68.90190666350824,19.35997969410787 68.90513234231638)))"
26800007650000,31,18,13,41.1,"MULTIPOLYGON(((19.48408180661817 68.90190666350824,19.49318008812532 68.94661075299047,19.617492355585718 68.94328712579632,19.608144500391507 68.89859073110333,19.48408180661817 68.90190666350824)))"
28400007650000,3,1,2,0,"MULTIPOLYGON(((23.428808444894837 68.75136107480445,23.445733464704436 68.79571813569953,23.568222797282214 68.78953384376528,23.551059598804912 68.74519090549062,23.428808444894837 68.75136107480445)))"
25000007655000,27,12,15,55,"MULTIPOLYGON(((14.999999999999982 69.00572047964833,14.999999999999982 69.05056156900612,15.125305722969287 69.050515776751,15.125050355239557 69.0056747941813,14.999999999999982 69.00572047964833)))"
25050007655000,123,64,59,48.1,"MULTIPOLYGON(((15.125050355239557 69.0056747941813,15.125305722969287 69.050515776751,15.250610323836177 69.05037840069726,15.250099595534158 69.00553773848752,15.125050355239557 69.0056747941813)))"
25200007655000,42,19,23,52.6,"MULTIPOLYGON(((15.50019027187369 69.00498952632111,15.501211671222165 69.049828907156,15.626506174090025 69.04941679820682,15.625229478576381 69.00457837833493,15.50019027187369 69.00498952632111)))"
25250007655000,15,9,6,33.7,"MULTIPOLYGON(((15.625229478576381 69.00457837833493,15.626506174090025 69.04941679820682,15.751795067675962 69.04891312253514,15.750263111771263 69.00407587709425,15.625229478576381 69.00457837833493)))"
25300007655000,273,149,124,46.1,"MULTIPOLYGON(((15.750263111771263 69.00407587709425,15.751795067675962 69.04891312253514,15.877077230800003 69.04831788796601,15.875290057426 69.0034820303766,15.750263111771263 69.00407587709425)))"
25550007655000,30,14,16,59.5,"MULTIPOLYGON(((16.375308698041707 69.00019339372204,16.378116169273444 69.04502156695487,16.503347877441957 69.04396870500327,16.500285510404368 68.99914298570843,16.375308698041707 69.00019339372204)))"
25600007655000,26,18,8,66.9,"MULTIPOLYGON(((16.500285510404368 68.99914298570843,16.503347877441957 69.04396870500327,16.62856613795814 69.04282436093123,16.62524896081726 68.99800130852827,16.500285510404368 68.99914298570843)))"
25800007655000,7,4,3,26.7,"MULTIPOLYGON(((17.000048042297998 68.99402884553558,17.004129064510376 69.03884262066121,17.129282369561 69.03733253984706,17.12494695103373 68.99252228226446,17.000048042297998 68.99402884553558)))"
25850007655000,26,13,13,52.5,"MULTIPOLYGON(((17.12494695103373 68.99252228226446,17.129282369561 69.03733253984706,17.25441664896947 69.03573107984845,17.24982695527188 68.99092455213784,17.12494695103373 68.99252228226446)))"
25900007655000,3,1,2,0,"MULTIPOLYGON(((17.24982695527188 68.99092455213784,17.25441664896947 69.03573107984845,17.37953079001265 69.03403826548723,17.37468694934723 68.989235679827,17.24982695527188 68.99092455213784)))"
25950007655000,54,34,20,55.4,"MULTIPOLYGON(((17.37468694934723 68.989235679827,17.37953079001265 69.03403826548723,17.504623681066537 69.03225412299321,17.499525828682057 68.98745569140263,17.37468694934723 68.989235679827)))"
26000007655000,10,6,4,50.6,"MULTIPOLYGON(((17.499525828682057 68.98745569140263,17.504623681066537 69.03225412299321,17.62969421166635 69.03037868000236,17.6243424898456 68.98558461433318,17.499525828682057 68.98745569140263)))"
26050007655000,3,1,2,0,"MULTIPOLYGON(((17.6243424898456 68.98558461433318,17.62969421166635 69.03037868000236,17.754741272566466 69.02841196555511,17.749135830613323 68.98362247748302,17.6243424898456 68.98558461433318)))"
26150007655000,7,4,3,43.1,"MULTIPOLYGON(((17.873904750026067 68.98156931111055,17.87976375580015 69.02635401009428,18.004760554739164 69.02420484546315,17.998648148449004 68.97942514686616,17.873904750026067 68.98156931111055)))"
26350007655000,178,98,80,44.2,"MULTIPOLYGON(((18.372714242528772 68.97244700424164,18.379585800829307 69.01721043594273,18.504468825152156 69.01469678099672,18.497344589184202 68.96993919277949,18.372714242528772 68.97244700424164)))"
26400007655000,139,70,69,51.6,"MULTIPOLYGON(((18.497344589184202 68.96993919277949,18.504468825152156 69.01469678099672,18.629320654188806 69.0120920970268,18.621943938591304 68.96734056250197,18.497344589184202 68.96993919277949)))"
26500007655000,4,3,1,0,"MULTIPOLYGON(((18.746511200288815 68.96465115336484,18.75414019058252 69.00939642423167,18.878926338726597 69.0066098041938,18.87104528554709 68.96187100669944,18.746511200288815 68.96465115336484)))"
26550007655000,24,11,13,44.8,"MULTIPOLYGON(((18.87104528554709 68.96187100669944,18.878926338726597 69.0066098041938,19.003678004822323 69.00373227987687,18.995545107425404 68.95900016521003,18.87104528554709 68.96187100669944)))"
26600007655000,26,15,11,49.2,"MULTIPOLYGON(((18.995545107425404 68.95900016521003,19.003678004822323 69.00373227987687,19.128394096936603 69.00076389562277,19.120009580829002 68.956038672971,18.995545107425404 68.95900016521003)))"
26650007655000,28,12,16,49.7,"MULTIPOLYGON(((19.120009580829002 68.956038672971,19.128394096936603 69.00076389562277,19.2530735250594 68.99770469714885,19.24443762256595 68.95298657542395,19.120009580829002 68.956038672971)))"
26700007655000,6,5,1,47,"MULTIPOLYGON(((19.24443762256595 68.95298657542395,19.2530735250594 68.99770469714885,19.377715201160875 68.99455473154478,19.36882815140368 68.94984391937474,19.24443762256595 68.95298657542395)))"
26750007655000,44,24,20,49.5,"MULTIPOLYGON(((19.36882815140368 68.94984391937474,19.377715201160875 68.99455473154478,19.502318039248305 68.99131404726964,19.49318008812532 68.94661075299047,19.36882815140368 68.94984391937474)))"
26800007655000,6,2,4,26.7,"MULTIPOLYGON(((19.49318008812532 68.94661075299047,19.502318039248305 68.99131404726964,19.626880955422678 68.98798269414861,19.617492355585718 68.94328712579632,19.49318008812532 68.94661075299047)))"
26850007655000,20,13,7,42.4,"MULTIPOLYGON(((19.617492355585718 68.94328712579632,19.626880955422678 68.98798269414861,19.751402867935045 68.98456072336982,19.741763878767205 68.93987308867236,19.617492355585718 68.94328712579632)))"
26900007655000,8,5,3,23.3,"MULTIPOLYGON(((19.741763878767205 68.93987308867236,19.751402867935045 68.98456072336982,19.875882697242574 68.98104818748094,19.865993584835074 68.93636869385023,19.741763878767205 68.93987308867236)))"
25200007660000,36,20,16,53.8,"MULTIPOLYGON(((15.501211671222165 69.049828907156,15.502237558406176 69.09466804427764,15.627788478936825 69.09425497043098,15.626506174090025 69.04941679820682,15.501211671222165 69.049828907156)))"
25250007660000,3,1,2,0,"MULTIPOLYGON(((15.626506174090025 69.04941679820682,15.627788478936825 69.09425497043098,15.75333375410402 69.09375011552012,15.751795067675962 69.04891312253514,15.626506174090025 69.04941679820682)))"
25300007660000,23,14,9,50.3,"MULTIPOLYGON(((15.751795067675962 69.04891312253514,15.75333375410402 69.09375011552012,15.878872255518766 69.09315348741814,15.877077230800003 69.04831788796601,15.751795067675962 69.04891312253514)))"
25350007660000,50,28,22,51.8,"MULTIPOLYGON(((15.877077230800003 69.04831788796601,15.878872255518766 69.09315348741814,16.004402855164827 69.0924650954282,16.002351542650977 69.04763110374597,15.877077230800003 69.04831788796601)))"
25550007660000,8,5,3,69.5,"MULTIPOLYGON(((16.378116169273444 69.04502156695487,16.380935970221586 69.08984945060267,16.506423692254515 69.08879412467392,16.503347877441957 69.04396870500327,16.378116169273444 69.04502156695487)))"
25600007660000,3,2,1,0,"MULTIPOLYGON(((16.503347877441957 69.04396870500327,16.506423692254515 69.08879412467392,16.631897880196746 69.08764710280157,16.62856613795814 69.04282436093123,16.503347877441957 69.04396870500327)))"
25700007660000,107,58,49,50.3,"MULTIPOLYGON(((16.75376983350936 69.04158855249815,16.757357409568215 69.08640840285375,16.88280115669404 69.08507804412251,16.87895784757964 69.04026129887863,16.75376983350936 69.04158855249815)))"
25750007660000,55,29,26,50.6,"MULTIPOLYGON(((16.87895784757964 69.04026129887863,16.88280115669404 69.08507804412251,17.00822799876596 69.0836560473224,17.004129064510376 69.03884262066121,16.87895784757964 69.04026129887863)))"
25800007660000,50,25,25,61.4,"MULTIPOLYGON(((17.004129064510376 69.03884262066121,17.00822799876596 69.0836560473224,17.133636813903586 69.08214243458931,17.129282369561 69.03733253984706,17.004129064510376 69.03884262066121)))"
25850007660000,56,27,29,53.6,"MULTIPOLYGON(((17.129282369561 69.03733253984706,17.133636813903586 69.08214243458931,17.259026481215557 69.08053722947872,17.25441664896947 69.03573107984845,17.129282369561 69.03733253984706)))"
25950007660000,17,9,8,43.8,"MULTIPOLYGON(((17.37953079001265 69.03403826548723,17.38439588086058 69.07884045696441,17.509743894108286 69.07705214343655,17.504623681066537 69.03225412299321,17.37953079001265 69.03403826548723)))"
26000007660000,126,63,63,50,"MULTIPOLYGON(((17.504623681066537 69.03225412299321,17.509743894108286 69.07705214343655,17.635069403399967 69.07517231670012,17.62969421166635 69.03037868000236,17.504623681066537 69.03225412299321)))"
26050007660000,140,62,78,48.6,"MULTIPOLYGON(((17.62969421166635 69.03037868000236,17.635069403399967 69.07517231670012,17.76037129240913 69.07320100597302,17.754741272566466 69.02841196555511,17.62969421166635 69.03037868000236)))"
26100007660000,15,9,6,46.3,"MULTIPOLYGON(((17.754741272566466 69.02841196555511,17.76037129240913 69.07320100597302,17.88564844610189 69.07113824188409,17.87976375580015 69.02635401009428,17.754741272566466 69.02841196555511)))"
26150007660000,20,9,11,58.6,"MULTIPOLYGON(((17.87976375580015 69.02635401009428,17.88564844610189 69.07113824188409,18.01089975079719 69.06898405647111,18.004760554739164 69.02420484546315,17.87976375580015 69.02635401009428)))"
26200007660000,1,0,1,0,"MULTIPOLYGON(((18.004760554739164 69.02420484546315,18.01089975079719 69.06898405647111,18.13612409422685 69.06673848317868,18.129730564153164 69.02196450490335,18.004760554739164 69.02420484546315)))"
26250007660000,9,5,4,47.1,"MULTIPOLYGON(((18.129730564153164 69.02196450490335,18.13612409422685 69.06673848317868,18.261320365595388 69.064401556856,18.254672680268918 69.01963302305265,18.129730564153164 69.02196450490335)))"
26350007660000,729,390,339,35.9,"MULTIPOLYGON(((18.379585800829307 69.01721043594273,18.386487455639653 69.06197331375454,18.511624256688293 69.05945379152567,18.504468825152156 69.01469678099672,18.379585800829307 69.01721043594273)))"
26400007660000,362,196,166,36.5,"MULTIPOLYGON(((18.504468825152156 69.01469678099672,18.511624256688293 69.05945379152567,18.63672966272093 69.05684302921819,18.629320654188806 69.0120920970268,18.504468825152156 69.01469678099672)))"
26450007660000,159,83,76,37.3,"MULTIPOLYGON(((18.629320654188806 69.0120920970268,18.63672966272093 69.05684302921819,18.76180256942719 69.05414106727571,18.75414019058252 69.00939642423167,18.629320654188806 69.0120920970268)))"
26500007660000,236,131,105,46.2,"MULTIPOLYGON(((18.75414019058252 69.00939642423167,18.76180256942719 69.05414106727571,18.886841874265404 69.05134794753398,18.878926338726597 69.0066098041938,18.75414019058252 69.00939642423167)))"
26550007660000,214,106,108,41.2,"MULTIPOLYGON(((18.878926338726597 69.0066098041938,18.886841874265404 69.05134794753398,19.011846476521207 69.04846371321818,19.003678004822323 69.00373227987687,18.878926338726597 69.0066098041938)))"
26600007660000,18,10,8,41.5,"MULTIPOLYGON(((19.003678004822323 69.00373227987687,19.011846476521207 69.04846371321818,19.13681527736573 69.04548840894005,19.128394096936603 69.00076389562277,19.003678004822323 69.00373227987687)))"
26700007660000,342,193,149,35.2,"MULTIPOLYGON(((19.2530735250594 68.99770469714885,19.261747179913687 69.0424220806949,19.38664108928108 69.0392647758587,19.377715201160875 68.99455473154478,19.2530735250594 68.99770469714885)))"
26750007660000,209,106,103,48,"MULTIPOLYGON(((19.377715201160875 68.99455473154478,19.38664108928108 69.0392647758587,19.511495912642694 69.03601654318484,19.502318039248305 68.99131404726964,19.377715201160875 68.99455473154478)))"
26800007660000,33,20,13,51.6,"MULTIPOLYGON(((19.502318039248305 68.99131404726964,19.511495912642694 69.03601654318484,19.636310559289342 69.03267743280108,19.626880955422678 68.98798269414861,19.502318039248305 68.99131404726964)))"
26850007660000,1,1,0,0,"MULTIPOLYGON(((19.626880955422678 68.98798269414861,19.636310559289342 69.03267743280108,19.761083940684728 69.02924749620611,19.751402867935045 68.98456072336982,19.626880955422678 68.98798269414861)))"
28250007660000,7,3,4,69.9,"MULTIPOLYGON(((23.094110622379883 68.85813780182991,23.11045839497246 68.90253201483685,23.23364495178139 68.89658529892182,23.217055680197618 68.85220473347046,23.094110622379883 68.85813780182991)))"
25250007665000,107,53,54,48.8,"MULTIPOLYGON(((15.627788478936825 69.09425497043098,15.629076429198866 69.13909289535171,15.754879214346662 69.1385868563625,15.75333375410402 69.09375011552012,15.627788478936825 69.09425497043098)))"
25300007665000,1,0,1,0,"MULTIPOLYGON(((15.75333375410402 69.09375011552012,15.754879214346662 69.1385868563625,15.880675182078676 69.1379888290095,15.878872255518766 69.09315348741814,15.75333375410402 69.09375011552012)))"
25350007665000,238,117,121,54.5,"MULTIPOLYGON(((15.878872255518766 69.09315348741814,15.880675182078676 69.1379888290095,16.00646319711161 69.13729882265316,16.004402855164827 69.0924650954282,15.878872255518766 69.09315348741814)))"
25400007665000,15,6,9,43.7,"MULTIPOLYGON(((16.004402855164827 69.0924650954282,16.00646319711161 69.13729882265316,16.132242124601625 69.13651684809224,16.12992442546073 69.09168495028315,16.004402855164827 69.0924650954282)))"
25800007665000,15,6,9,56.6,"MULTIPOLYGON(((17.00822799876596 69.0836560473224,17.012344960120686 69.12846912521321,17.138010406246828 69.12695196609262,17.133636813903586 69.08214243458931,17.00822799876596 69.0836560473224)))"
25850007665000,162,86,76,46.5,"MULTIPOLYGON(((17.133636813903586 69.08214243458931,17.138010406246828 69.12695196609262,17.263656581313743 69.125343000532,17.259026481215557 69.08053722947872,17.133636813903586 69.08214243458931)))"
25900007665000,7,3,4,56.3,"MULTIPOLYGON(((17.259026481215557 69.08053722947872,17.263656581313743 69.125343000532,17.3892823583011 69.12364225365815,17.38439588086058 69.07884045696441,17.259026481215557 69.08053722947872)))"
25950007665000,5,3,2,66.6,"MULTIPOLYGON(((17.38439588086058 69.07884045696441,17.3892823583011 69.12364225365815,17.514886611311432 69.1218497520231,17.509743894108286 69.07705214343655,17.38439588086058 69.07884045696441)))"
26000007665000,25,11,14,54.1,"MULTIPOLYGON(((17.509743894108286 69.07705214343655,17.514886611311432 69.1218497520231,17.64046821563154 69.11996552360222,17.635069403399967 69.07517231670012,17.509743894108286 69.07705214343655)))"
26050007665000,474,240,234,45.4,"MULTIPOLYGON(((17.635069403399967 69.07517231670012,17.64046821563154 69.11996552360222,17.76602604779367 69.11798959779237,17.76037129240913 69.07320100597302,17.635069403399967 69.07517231670012)))"
26100007665000,91,44,47,48.3,"MULTIPOLYGON(((17.76037129240913 69.07320100597302,17.76602604779367 69.11798959779237,17.891558985636564 69.11592200541001,17.88564844610189 69.07113824188409,17.76037129240913 69.07320100597302)))"
26150007665000,28,15,13,41.7,"MULTIPOLYGON(((17.88564844610189 69.07113824188409,17.891558985636564 69.11592200541001,18.01706590836632 69.11376277868902,18.01089975079719 69.06898405647111,17.88564844610189 69.07113824188409)))"
26200007665000,27,16,11,47.3,"MULTIPOLYGON(((18.01089975079719 69.06898405647111,18.01706590836632 69.11376277868902,18.14254569661706 69.11151195127871,18.13612409422685 69.06673848317868,18.01089975079719 69.06898405647111)))"
26250007665000,98,46,52,41.4,"MULTIPOLYGON(((18.13612409422685 69.06673848317868,18.14254569661706 69.11151195127871,18.26799723251142 69.10916955824145,18.261320365595388 69.064401556856,18.13612409422685 69.06673848317868)))"
26300007665000,53,33,20,46.9,"MULTIPOLYGON(((18.261320365595388 69.064401556856,18.26799723251142 69.10916955824145,18.3934193997208 69.1067356360504,18.386487455639653 69.06197331375454,18.261320365595388 69.064401556856)))"
26350007665000,36,16,20,55.8,"MULTIPOLYGON(((18.386487455639653 69.06197331375454,18.3934193997208 69.1067356360504,18.51881108352543 69.10421022258711,18.511624256688293 69.05945379152567,18.386487455639653 69.06197331375454)))"
26400007665000,1862,969,893,40.4,"MULTIPOLYGON(((18.511624256688293 69.05945379152567,18.51881108352543 69.10421022258711,18.644171170874248 69.10159335713891,18.63672966272093 69.05684302921819,18.511624256688293 69.05945379152567)))"
26450007665000,53,32,21,49,"MULTIPOLYGON(((18.63672966272093 69.05684302921819,18.644171170874248 69.10159335713891,18.76949855044444 69.09888508039641,18.76180256942719 69.05414106727571,18.63672966272093 69.05684302921819)))"
26650007665000,12,7,5,47.9,"MULTIPOLYGON(((19.13681527736573 69.04548840894005,19.14527335642499 69.09021221030063,19.270458828291684 69.08713872325559,19.261747179913687 69.0424220806949,19.13681527736573 69.04548840894005)))"
26700007665000,31,17,14,50.4,"MULTIPOLYGON(((19.261747179913687 69.0424220806949,19.270458828291684 69.08713872325559,19.395606063759725 69.08397404932035,19.38664108928108 69.0392647758587,19.261747179913687 69.0424220806949)))"
26750007665000,22,10,12,40.9,"MULTIPOLYGON(((19.38664108928108 69.0392647758587,19.395606063759725 69.08397404932035,19.520713963114222 69.08071823754518,19.511495912642694 69.03601654318484,19.38664108928108 69.0392647758587)))"
26800007665000,5,2,3,42.2,"MULTIPOLYGON(((19.511495912642694 69.03601654318484,19.520713963114222 69.08071823754518,19.645781428778857 69.07737133836291,19.636310559289342 69.03267743280108,19.511495912642694 69.03601654318484)))"
28150007665000,57,27,30,38.9,"MULTIPOLYGON(((22.863874363435862 68.91415882775162,22.879806449942603 68.95857780949,23.003376666285938 68.9527955625074,22.987201196872967 68.90838988718673,22.863874363435862 68.91415882775162)))"
28200007665000,1,1,0,0,"MULTIPOLYGON(((22.987201196872967 68.90838988718673,23.003376666285938 68.9527955625074,23.12687680946728 68.94692418575069,23.11045839497246 68.90253201483685,22.987201196872967 68.90838988718673)))"
25250007670000,2,1,1,0,"MULTIPOLYGON(((15.629076429198866 69.13909289535171,15.630370061268959 69.18393057331336,15.75643149206789 69.18342334537525,15.754879214346662 69.1385868563625,15.629076429198866 69.13909289535171)))"
25300007670000,6,3,3,55.3,"MULTIPOLYGON(((15.754879214346662 69.1385868563625,15.75643149206789 69.18342334537525,15.882486061410907 69.1828239130162,15.880675182078676 69.1379888290095,15.754879214346662 69.1385868563625)))"
25400007670000,71,38,33,54.8,"MULTIPOLYGON(((16.00646319711161 69.13729882265316,16.008532626684993 69.18213228565426,16.13457004572133 69.18134847415472,16.132242124601625 69.13651684809224,16.00646319711161 69.13729882265316)))"
25800007670000,52,25,27,49.4,"MULTIPOLYGON(((17.012344960120686 69.12846912521321,17.01648006461957 69.17328185402211,17.142403269826197 69.17176113395212,17.138010406246828 69.12695196609262,17.012344960120686 69.12846912521321)))"
25900007670000,4,2,2,0,"MULTIPOLYGON(((17.263656581313743 69.125343000532,17.268307079678642 69.17014839250433,17.394190359916017 69.16844365496002,17.3892823583011 69.12364225365815,17.263656581313743 69.125343000532)))"
25950007670000,2,0,2,0,"MULTIPOLYGON(((17.3892823583011 69.12364225365815,17.394190359916017 69.16844365496002,17.52005197741239 69.16664694803433,17.514886611311432 69.1218497520231,17.3892823583011 69.12364225365815)))"
26000007670000,19,10,9,60.2,"MULTIPOLYGON(((17.514886611311432 69.1218497520231,17.52005197741239 69.16664694803433,17.645890800238853 69.16475829987446,17.64046821563154 69.11996552360222,17.514886611311432 69.1218497520231)))"
26100007670000,42,23,19,51.7,"MULTIPOLYGON(((17.76602604779367 69.11798959779237,17.77170569772535 69.1627777400578,17.897495540522385 69.16070529958998,17.891558985636564 69.11592200541001,17.76602604779367 69.11798959779237)))"
26150007670000,19,11,8,46.6,"MULTIPOLYGON(((17.891558985636564 69.11592200541001,17.897495540522385 69.16070529958998,18.023259200662544 69.15854101090267,18.01706590836632 69.11376277868902,17.891558985636564 69.11592200541001)))"
26200007670000,874,458,416,40.3,"MULTIPOLYGON(((18.01706590836632 69.11376277868902,18.023259200662544 69.15854101090267,18.14899555162179 69.15628490785157,18.14254569661706 69.11151195127871,18.01706590836632 69.11376277868902)))"
26250007670000,1491,754,737,42.3,"MULTIPOLYGON(((18.14254569661706 69.11151195127871,18.14899555162179 69.15628490785157,18.27470346838058 69.15393702571407,18.26799723251142 69.10916955824145,18.14254569661706 69.11151195127871)))"
26400007670000,806,429,377,42,"MULTIPOLYGON(((18.51881108352543 69.10421022258711,18.526029507106454 69.14896607238359,18.65164538710413 69.1463430788322,18.644171170874248 69.10159335713891,18.51881108352543 69.10421022258711)))"
26450007670000,45,22,23,47,"MULTIPOLYGON(((18.644171170874248 69.10159335713891,18.65164538710413 69.1463430788322,18.777228349083245 69.14362846147236,18.76949855044444 69.09888508039641,18.644171170874248 69.10159335713891)))"
26500007670000,62,34,28,47.4,"MULTIPOLYGON(((18.76949855044444 69.09888508039641,18.777228349083245 69.14362846147236,18.902777276456064 69.14082226265276,18.894792112700895 69.0960854344508,18.76949855044444 69.09888508039641)))"
26550007670000,30,16,14,41.7,"MULTIPOLYGON(((18.894792112700895 69.0960854344508,18.902777276456064 69.14082226265276,19.028291054501455 69.13792452612829,19.02005074995529 69.09319446279095,18.894792112700895 69.0960854344508)))"
26600007670000,18,11,7,46.2,"MULTIPOLYGON(((19.02005074995529 69.09319446279095,19.028291054501455 69.13792452612829,19.153768570424376 69.13493529705701,19.14527335642499 69.09021221030063,19.02005074995529 69.09319446279095)))"
26650007670000,10,6,4,60.2,"MULTIPOLYGON(((19.14527335642499 69.09021221030063,19.153768570424376 69.13493529705701,19.279208713415134 69.13185462199742,19.270458828291684 69.08713872325559,19.14527335642499 69.09021221030063)))"
26700007670000,3,3,0,0,"MULTIPOLYGON(((19.270458828291684 69.08713872325559,19.279208713415134 69.13185462199742,19.40461037470835 69.12868254890508,19.395606063759725 69.08397404932035,19.270458828291684 69.08713872325559)))"
26800007670000,30,15,15,49.4,"MULTIPOLYGON(((19.520713963114222 69.08071823754518,19.529972447641644 69.12541912712962,19.65529382771405 69.12206440741139,19.645781428778857 69.07737133836291,19.520713963114222 69.08071823754518)))"
26850007670000,17,9,8,47.9,"MULTIPOLYGON(((19.645781428778857 69.07737133836291,19.65529382771405 69.12206440741139,19.780573412644145 69.1186184418782,19.770807365373376 69.07393340358537,19.645781428778857 69.07737133836291)))"
28200007670000,216,117,99,41.7,"MULTIPOLYGON(((23.003376666285938 68.9527955625074,23.019622209471216 68.99719923860273,23.143366309670732 68.9913143035228,23.12687680946728 68.94692418575069,23.003376666285938 68.9527955625074)))"
28250007670000,1,1,0,0,"MULTIPOLYGON(((23.12687680946728 68.94692418575069,23.143366309670732 68.9913143035228,23.26703887727151 68.98534012921142,23.250305867557994 68.94096376796429,23.12687680946728 68.94692418575069)))"
25300007675000,37,17,20,54.5,"MULTIPOLYGON(((15.75643149206789 69.18342334537525,15.757990631308505 69.22825958287103,15.884304944886102 69.22765873971352,15.882486061410907 69.1828239130162,15.75643149206789 69.18342334537525)))"
25350007675000,2,1,1,0,"MULTIPOLYGON(((15.882486061410907 69.1828239130162,15.884304944886102 69.22765873971352,16.010611202580712 69.2269654846638,16.008532626684993 69.18213228565426,15.882486061410907 69.1828239130162)))"
25400007675000,44,24,20,46.3,"MULTIPOLYGON(((16.008532626684993 69.18213228565426,16.010611202580712 69.2269654846638,16.13690825483524 69.22617982865415,16.13457004572133 69.18134847415472,16.008532626684993 69.18213228565426)))"
25800007675000,38,18,20,44.4,"MULTIPOLYGON(((17.01648006461957 69.17328185402211,17.02063342930736 69.21809423343187,17.146815528938543 69.21656993775633,17.142403269826197 69.17176113395212,17.01648006461957 69.17328185402211)))"
25950007675000,27,13,14,48.7,"MULTIPOLYGON(((17.394190359916017 69.16844365496002,17.399120024471436 69.21324466025325,17.525240138393084 69.2114437307424,17.52005197741239 69.16664694803433,17.394190359916017 69.16844365496002)))"
26000007675000,16,9,7,54.6,"MULTIPOLYGON(((17.52005197741239 69.16664694803433,17.525240138393084 69.2114437307424,17.651337310406223 69.20955064467239,17.645890800238853 69.16475829987446,17.52005197741239 69.16664694803433)))"
26050007675000,446,220,226,41.3,"MULTIPOLYGON(((17.645890800238853 69.16475829987446,17.651337310406223 69.20955064467239,17.777410402576827 69.20756543180265,17.77170569772535 69.1627777400578,17.645890800238853 69.16475829987446)))"
26100007675000,226,126,100,44.9,"MULTIPOLYGON(((17.77170569772535 69.1627777400578,17.777410402576827 69.20756543180265,17.90345827830566 69.20548812332957,17.897495540522385 69.16070529958998,17.77170569772535 69.1627777400578)))"
26150007675000,103,51,52,49.7,"MULTIPOLYGON(((17.897495540522385 69.16070529958998,17.90345827830566 69.20548812332957,18.029479802390448 69.20331875188432,18.023259200662544 69.15854101090267,17.897495540522385 69.16070529958998)))"
26200007675000,598,292,306,44.8,"MULTIPOLYGON(((18.023259200662544 69.15854101090267,18.029479802390448 69.20331875188432,18.155473841087876 69.20105735153072,18.14899555162179 69.15628490785157,18.023259200662544 69.15854101090267)))"
26250007675000,49,26,23,46.7,"MULTIPOLYGON(((18.14899555162179 69.15628490785157,18.155473841087876 69.20105735153072,18.281439262175333 69.198703957763,18.27470346838058 69.15393702571407,18.14899555162179 69.15628490785157)))"
26300007675000,4,3,1,0,"MULTIPOLYGON(((18.27470346838058 69.15393702571407,18.281439262175333 69.198703957763,18.40737493501248 69.1962586075033,18.400381827484804 69.15149740118689,18.27470346838058 69.15393702571407)))"
26350007675000,241,123,118,40.4,"MULTIPOLYGON(((18.400381827484804 69.15149740118689,18.40737493501248 69.1962586075033,18.5332797306026 69.19372133909924,18.526029507106454 69.14896607238359,18.400381827484804 69.15149740118689)))"
26400007675000,344,166,178,43.8,"MULTIPOLYGON(((18.526029507106454 69.14896607238359,18.5332797306026 69.19372133909924,18.659152521653713 69.19109219232146,18.65164538710413 69.1463430788322,18.526029507106454 69.14896607238359)))"
26550007675000,14,7,7,40.4,"MULTIPOLYGON(((18.902777276456064 69.14082226265276,18.91079758985969 69.18555842982569,19.03656762150099 69.18265390073913,19.028291054501455 69.13792452612829,18.902777276456064 69.14082226265276)))"
26600007675000,53,28,25,42.2,"MULTIPOLYGON(((19.028291054501455 69.13792452612829,19.03656762150099 69.18265390073913,19.162301157696653 69.17965766653593,19.153768570424376 69.13493529705701,19.028291054501455 69.13792452612829)))"
26650007675000,16,10,6,42.9,"MULTIPOLYGON(((19.153768570424376 69.13493529705701,19.162301157696653 69.17965766653593,19.287997080586642 69.17656977405964,19.279208713415134 69.13185462199742,19.153768570424376 69.13493529705701)))"
26850007675000,3,2,1,0,"MULTIPOLYGON(((19.65529382771405 69.12206440741139,19.66484802217113 69.1667566364916,19.790382355450475 69.16330260742103,19.780573412644145 69.1186184418782,19.65529382771405 69.12206440741139)))"
27000007675000,14,6,8,66.2,"MULTIPOLYGON(((20.03100279939583 69.11145298879416,20.041320406138244 69.15612039539529,20.166721916806345 69.15239232427938,20.15615040827096 69.10773361240446,20.03100279939583 69.11145298879416)))"
27250007675000,6,3,3,50.3,"MULTIPOLYGON(((20.656268144195078 69.09194646878238,20.667852232365068 69.13656830834157,20.793010413376063 69.13238467862605,20.781173971131032 69.0877725786411,20.656268144195078 69.09194646878238)))"
28150007675000,67,37,30,40.7,"MULTIPOLYGON(((22.89580759462352 69.00299484517788,22.911878232911036 69.04740992433935,23.035938267921306 69.04160090466465,23.019622209471216 68.99719923860273,22.89580759462352 69.00299484517788)))"
28200007675000,1811,924,887,39.6,"MULTIPOLYGON(((23.019622209471216 68.99719923860273,23.035938267921306 69.04160090466465,23.15992734309736 69.0357023570087,23.143366309670732 68.9913143035228,23.019622209471216 68.99719923860273)))"
28250007675000,66,35,31,40.8,"MULTIPOLYGON(((23.143366309670732 68.9913143035228,23.15992734309736 69.0357023570087,23.283844434419958 69.02971437117806,23.26703887727151 68.98534012921142,23.143366309670732 68.9913143035228)))"
25350007680000,235,121,114,47.4,"MULTIPOLYGON(((15.884304944886102 69.22765873971352,15.886131884319132 69.27249330937622,16.012698984002 69.27179841991303,16.010611202580712 69.2269654846638,15.884304944886102 69.22765873971352)))"
25400007680000,88,45,43,54,"MULTIPOLYGON(((16.010611202580712 69.2269654846638,16.012698984002 69.27179841991303,16.139256818529486 69.27101091177269,16.13690825483524 69.22617982865415,16.010611202580712 69.2269654846638)))"
25450007680000,34,17,17,54.4,"MULTIPOLYGON(((16.13690825483524 69.22617982865415,16.139256818529486 69.27101091177269,16.265804231410815 69.27013079741957,16.263194952605584 69.22530178407244,16.13690825483524 69.22617982865415)))"
25950007680000,8,4,4,54.3,"MULTIPOLYGON(((17.399120024471436 69.21324466025325,17.40407149193053 69.25804526891281,17.53045124149435 69.25624009941026,17.525240138393084 69.2114437307424,17.399120024471436 69.21324466025325)))"
26000007680000,50,26,24,54.3,"MULTIPOLYGON(((17.525240138393084 69.2114437307424,17.53045124149435 69.25624009941026,17.656807900638608 69.25434255714129,17.651337310406223 69.20955064467239,17.525240138393084 69.2114437307424)))"
26050007680000,111,62,49,44.1,"MULTIPOLYGON(((17.651337310406223 69.20955064467239,17.656807900638608 69.25434255714129,17.783140324102916 69.25235267204893,17.777410402576827 69.20756543180265,17.651337310406223 69.20955064467239)))"
26100007680000,530,258,272,40.4,"MULTIPOLYGON(((17.777410402576827 69.20756543180265,17.783140324102916 69.25235267204893,17.90944736797613 69.25027047552193,17.90345827830566 69.20548812332957,17.777410402576827 69.20756543180265)))"
26150007680000,4564,2235,2329,41.3,"MULTIPOLYGON(((17.90345827830566 69.20548812332957,17.90944736797613 69.25027047552193,18.035727889759173 69.24809600039266,18.029479802390448 69.20331875188432,17.90345827830566 69.20548812332957)))"
26200007680000,1454,772,682,39.1,"MULTIPOLYGON(((18.029479802390448 69.20331875188432,18.035727889759173 69.24809600039266,18.16198074842766 69.24582928093486,18.155473841087876 69.20105735153072,18.029479802390448 69.20331875188432)))"
26250007680000,257,134,123,44.1,"MULTIPOLYGON(((18.155473841087876 69.20105735153072,18.16198074842766 69.24582928093486,18.288204804494345 69.24347035286137,18.281439262175333 69.198703957763,18.155473841087876 69.20105735153072)))"
26300007680000,125,65,60,45.4,"MULTIPOLYGON(((18.281439262175333 69.198703957763,18.288204804494345 69.24347035286137,18.41439892007132 69.24101925332168,18.40737493501248 69.1962586075033,18.281439262175333 69.198703957763)))"
26350007680000,284,147,137,45.5,"MULTIPOLYGON(((18.40737493501248 69.1962586075033,18.41439892007132 69.24101925332168,18.540561958932038 69.23847602089951,18.5332797306026 69.19372133909924,18.40737493501248 69.1962586075033)))"
26400007680000,48,26,22,48.3,"MULTIPOLYGON(((18.5332797306026 69.19372133909924,18.540561958932038 69.23847602089951,18.666692786573055 69.23584069561011,18.659152521653713 69.19109219232146,18.5332797306026 69.19372133909924)))"
26450007680000,53,34,19,44.4,"MULTIPOLYGON(((18.659152521653713 69.19109219232146,18.666692786573055 69.23584069561011,18.79279027027558 69.23311331889768,18.784992182639446 69.18837120836082,18.659152521653713 69.19109219232146)))"
26600007680000,203,115,88,40.8,"MULTIPOLYGON(((19.03656762150099 69.18265390073913,19.044880684280606 69.22738258410807,19.17087135861899 69.22437931603822,19.162301157696653 69.17965766653593,19.03656762150099 69.18265390073913)))"
26650007680000,319,172,147,40.7,"MULTIPOLYGON(((19.162301157696653 69.17965766653593,19.17087135861899 69.22437931603822,19.2968241772119 69.22128417655394,19.287997080586642 69.17656977405964,19.162301157696653 69.17965766653593)))"
26700007680000,39,18,21,44.7,"MULTIPOLYGON(((19.287997080586642 69.17656977405964,19.2968241772119 69.22128417655394,19.422738017177792 69.2180972142003,19.413654274377137 69.17339027155931,19.287997080586642 69.17656977405964)))"
26750007680000,11,7,4,63.6,"MULTIPOLYGON(((19.413654274377137 69.17339027155931,19.422738017177792 69.2180972142003,19.548611757783473 69.21481847893317,19.539271625399877 69.17011920868646,19.413654274377137 69.17339027155931)))"
26800007680000,73,34,39,40.4,"MULTIPOLYGON(((19.539271625399877 69.17011920868646,19.548611757783473 69.21481847893317,19.674444280503753 69.21144802211595,19.66484802217113 69.1667566364916,19.539271625399877 69.17011920868646)))"
26850007680000,71,38,33,52,"MULTIPOLYGON(((19.66484802217113 69.1667566364916,19.674444280503753 69.21144802211595,19.800234469080777 69.20798589651604,19.790382355450475 69.16330260742103,19.66484802217113 69.1667566364916)))"
26950007680000,25,17,8,54,"MULTIPOLYGON(((19.915873518299165 69.15975717531322,19.92598120958305 69.20443215630141,20.051683390464145 69.20078685703703,20.041320406138244 69.15612039539529,19.915873518299165 69.15975717531322)))"
27000007680000,2,1,1,0,"MULTIPOLYGON(((20.041320406138244 69.15612039539529,20.051683390464145 69.20078685703703,20.177339902621075 69.19705005568103,20.166721916806345 69.15239232427938,20.041320406138244 69.15612039539529)))"
28100007680000,12,7,5,60.4,"MULTIPOLYGON(((22.787748265824135 69.05312932749337,22.803641946105706 69.09755570574563,22.928018803890307 69.09182303640708,22.911878232911036 69.04740992433935,22.787748265824135 69.05312932749337)))"
28150007680000,1,1,0,0,"MULTIPOLYGON(((22.911878232911036 69.04740992433935,22.928018803890307 69.09182303640708,23.052325286828687 69.08600054979087,23.035938267921306 69.04160090466465,22.911878232911036 69.04740992433935)))"
28200007680000,76,35,41,42.7,"MULTIPOLYGON(((23.035938267921306 69.04160090466465,23.052325286828687 69.08600054979087,23.176560361008374 69.08008833496689,23.15992734309736 69.0357023570087,23.035938267921306 69.04160090466465)))"
25350007685000,221,104,117,42,"MULTIPOLYGON(((15.886131884319132 69.27249330937622,15.88796693197388 69.31732762227828,16.014796030665103 69.31663109163223,16.012698984002 69.27179841991303,15.886131884319132 69.27249330937622)))"
25400007685000,1612,844,768,43.4,"MULTIPOLYGON(((16.012698984002 69.27179841991303,16.014796030665103 69.31663109163223,16.141615803967078 69.31584172369092,16.139256818529486 69.27101091177269,16.012698984002 69.27179841991303)))"
25750007685000,88,49,39,52.4,"MULTIPOLYGON(((16.89834453837628 69.26434167110943,16.90227347140266 69.30915673820307,17.028995412492034 69.30771794275613,17.02480517223929 69.26290626311949,16.89834453837628 69.26434167110943)))"
25800007685000,192,102,90,49.2,"MULTIPOLYGON(((17.02480517223929 69.26290626311949,17.028995412492034 69.30771794275613,17.155698736325387 69.30618645152023,17.151247308953565 69.26137837708725,17.02480517223929 69.26290626311949)))"
25850007685000,5,3,2,61.8,"MULTIPOLYGON(((17.151247308953565 69.26137837708725,17.155698736325387 69.30618645152023,17.282382285436316 69.30456228878575,17.27766979849373 69.25975803715369,17.151247308953565 69.26137837708725)))"
26000007685000,63,34,29,43.7,"MULTIPOLYGON(((17.53045124149435 69.25624009941026,17.535685435229563 69.30103605329138,17.662302726775813 69.29913403641598,17.656807900638608 69.25434255714129,17.53045124149435 69.25624009941026)))"
26050007685000,134,57,77,42.6,"MULTIPOLYGON(((17.656807900638608 69.25434255714129,17.662302726775813 69.29913403641598,17.788895625455442 69.29713945980714,17.783140324102916 69.25235267204893,17.656807900638608 69.25434255714129)))"
26100007685000,221,119,102,40.4,"MULTIPOLYGON(((17.783140324102916 69.25235267204893,17.788895625455442 69.29713945980714,17.915462979982568 69.29505235504762,17.90944736797613 69.25027047552193,17.783140324102916 69.25235267204893)))"
26150007685000,1081,540,541,38.8,"MULTIPOLYGON(((17.90944736797613 69.25027047552193,17.915462979982568 69.29505235504762,18.042003640498645 69.29287275517264,18.035727889759173 69.24809600039266,17.90944736797613 69.25027047552193)))"
26200007685000,67,34,33,38.5,"MULTIPOLYGON(((18.035727889759173 69.24809600039266,18.042003640498645 69.29287275517264,18.16851645863581 69.29060069466767,18.16198074842766 69.24582928093486,18.035727889759173 69.24809600039266)))"
26250007685000,303,162,141,44.2,"MULTIPOLYGON(((18.16198074842766 69.24582928093486,18.16851645863581 69.29060069466767,18.29500028757995 69.28823620946606,18.288204804494345 69.24347035286137,18.16198074842766 69.24582928093486)))"
26300007685000,18,10,8,38.8,"MULTIPOLYGON(((18.288204804494345 69.24347035286137,18.29500028757995 69.28823620946606,18.421453982133603 69.28577933694659,18.41439892007132 69.24101925332168,18.288204804494345 69.24347035286137)))"
26350007685000,90,40,50,48.2,"MULTIPOLYGON(((18.41439892007132 69.24101925332168,18.421453982133603 69.28577933694659,18.547876398778616 69.283230115931,18.540561958932038 69.23847602089951,18.41439892007132 69.24101925332168)))"
26400007685000,2,1,1,0,"MULTIPOLYGON(((18.540561958932038 69.23847602089951,18.547876398778616 69.283230115931,18.67426639573856 69.28058858668133,18.666692786573055 69.23584069561011,18.540561958932038 69.23847602089951)))"
26450007685000,101,58,43,48,"MULTIPOLYGON(((18.666692786573055 69.23584069561011,18.67426639573856 69.28058858668133,18.80062283304092 69.27785479089717,18.79279027027558 69.23311331889768,18.666692786573055 69.23584069561011)))"
26500007685000,19,12,7,44.7,"MULTIPOLYGON(((18.79279027027558 69.23311331889768,18.80062283304092 69.27785479089717,18.92694457257903 69.27502877171295,18.918853279166736 69.2302939336325,18.79279027027558 69.23311331889768)))"
26550007685000,18,8,10,48.1,"MULTIPOLYGON(((18.918853279166736 69.2302939336325,18.92694457257903 69.27502877171295,19.053230478173752 69.27211057369499,19.044880684280606 69.22738258410807,18.918853279166736 69.2302939336325)))"
26600007685000,79,36,43,44.3,"MULTIPOLYGON(((19.044880684280606 69.22738258410807,19.053230478173752 69.27211057369499,19.17947941563487 69.26910024283839,19.17087135861899 69.22437931603822,19.044880684280606 69.22738258410807)))"
26650007685000,1327,658,669,44.4,"MULTIPOLYGON(((19.17087135861899 69.22437931603822,19.17947941563487 69.26910024283839,19.30569025282225 69.26599782656409,19.2968241772119 69.22128417655394,19.17087135861899 69.22437931603822)))"
26700007685000,109,56,53,50.4,"MULTIPOLYGON(((19.2968241772119 69.22128417655394,19.30569025282225 69.26599782656409,19.431861859706657 69.26280337371568,19.422738017177792 69.2180972142003,19.2968241772119 69.22128417655394)))"
26750007685000,170,92,78,44.8,"MULTIPOLYGON(((19.422738017177792 69.2180972142003,19.431861859706657 69.26280337371568,19.557993108430363 69.25951693455599,19.548611757783473 69.21481847893317,19.422738017177792 69.2180972142003)))"
26800007685000,605,307,298,43,"MULTIPOLYGON(((19.548611757783473 69.21481847893317,19.557993108430363 69.25951693455599,19.68408287336736 69.25613856076382,19.674444280503753 69.21144802211595,19.548611757783473 69.21481847893317)))"
26850007685000,10,7,3,51.3,"MULTIPOLYGON(((19.674444280503753 69.21144802211595,19.68408287336736 69.25613856076382,19.81013003118335 69.2526683054305,19.800234469080777 69.20798589651604,19.674444280503753 69.21144802211595)))"
26900007685000,44,23,21,53,"MULTIPOLYGON(((19.800234469080777 69.20798589651604,19.81013003118335 69.2526683054305,19.93613346089537 69.2491062230563,19.92598120958305 69.20443215630141,19.800234469080777 69.20798589651604)))"
26950007685000,43,24,19,46.9,"MULTIPOLYGON(((19.92598120958305 69.20443215630141,19.93613346089537 69.2491062230563,20.06209204393113 69.24545236954674,20.051683390464145 69.20078685703703,19.92598120958305 69.20443215630141)))"
27000007685000,40,23,17,47.2,"MULTIPOLYGON(((20.051683390464145 69.20078685703703,20.06209204393113 69.24545236954674,20.188004664187982 69.24170680220897,20.177339902621075 69.19705005568103,20.051683390464145 69.20078685703703)))"
28250007685000,51,27,24,45.6,"MULTIPOLYGON(((23.176560361008374 69.08008833496689,23.193265818450644 69.12447222605797,23.31767502401784 69.11845645082953,23.30072299629431 69.07408648227931,23.176560361008374 69.08008833496689)))"
25400007690000,927,448,479,43.1,"MULTIPOLYGON(((16.014796030665103 69.31663109163223,16.01690240280481 69.36146350005068,16.143985278894185 69.36067226458808,16.141615803967078 69.31584172369092,16.014796030665103 69.31663109163223)))"
25750007690000,1,0,1,0,"MULTIPOLYGON(((16.90227347140266 69.30915673820307,16.906219863338205 69.35397146895546,17.033204270174735 69.35252927200708,17.028995412492034 69.30771794275613,16.90227347140266 69.30915673820307)))"
25800007690000,158,91,67,43,"MULTIPOLYGON(((17.028995412492034 69.30771794275613,17.033204270174735 69.35252927200708,17.1601699386043 69.35099416062386,17.155698736325387 69.30618645152023,17.028995412492034 69.30771794275613)))"
26050007690000,7,3,4,59.9,"MULTIPOLYGON(((17.662302726775813 69.29913403641598,17.667821946006953 69.34392508162084,17.794676471198386 69.34192579407625,17.788895625455442 69.29713945980714,17.662302726775813 69.29913403641598)))"
26100007690000,138,71,67,40.6,"MULTIPOLYGON(((17.788895625455442 69.29713945980714,17.794676471198386 69.34192579407625,17.921505286248497 69.33983376077447,17.915462979982568 69.29505235504762,17.788895625455442 69.29713945980714)))"
26150007690000,183,97,86,44.8,"MULTIPOLYGON(((17.915462979982568 69.29505235504762,17.921505286248497 69.33983376077447,18.048307233876 69.33764901495535,18.042003640498645 69.29287275517264,17.915462979982568 69.29505235504762)))"
26200007690000,105,43,62,37.1,"MULTIPOLYGON(((18.042003640498645 69.29287275517264,18.048307233876 69.33764901495535,18.17508115830643 69.33537159131785,18.16851645863581 69.29060069466767,18.042003640498645 69.29287275517264)))"
26250007690000,265,139,126,41.2,"MULTIPOLYGON(((18.16851645863581 69.29060069466767,18.17508115830643 69.33537159131785,18.301825905335935 69.33300152601772,18.29500028757995 69.28823620946606,18.16851645863581 69.29060069466767)))"
26350007690000,36,16,20,51.3,"MULTIPOLYGON(((18.421453982133603 69.28577933694659,18.42854032239483 69.33053885666496,18.555223258610926 69.32798362232136,18.547876398778616 69.283230115931,18.421453982133603 69.28577933694659)))"
26400007690000,32,21,11,54.4,"MULTIPOLYGON(((18.547876398778616 69.283230115931,18.555223258610926 69.32798362232136,18.681873564872628 69.32533586349783,18.67426639573856 69.28058858668133,18.547876398778616 69.283230115931)))"
26450007690000,41,20,21,53.2,"MULTIPOLYGON(((18.67426639573856 69.28058858668133,18.681873564872628 69.32533586349783,18.808490093891766 69.32259562215161,18.80062283304092 69.27785479089717,18.67426639573856 69.28058858668133)))"
26500007690000,36,22,14,47,"MULTIPOLYGON(((18.80062283304092 69.27785479089717,18.808490093891766 69.32259562215161,18.93507170026621 69.31976294168349,18.92694457257903 69.27502877171295,18.80062283304092 69.27785479089717)))"
26550007690000,124,62,62,49.9,"MULTIPOLYGON(((18.92694457257903 69.27502877171295,18.93507170026621 69.31976294168349,19.06161724054218 69.3168378669348,19.053230478173752 69.27211057369499,18.92694457257903 69.27502877171295)))"
26600007690000,86,49,37,43.5,"MULTIPOLYGON(((19.053230478173752 69.27211057369499,19.06161724054218 69.3168378669348,19.188125573276324 69.31382044418447,19.17947941563487 69.26910024283839,19.053230478173752 69.27211057369499)))"
26650007690000,127,66,61,45.1,"MULTIPOLYGON(((19.17947941563487 69.26910024283839,19.188125573276324 69.31382044418447,19.314595559097484 69.31071072114581,19.30569025282225 69.26599782656409,19.17947941563487 69.26910024283839)))"
26700007690000,163,87,76,47.5,"MULTIPOLYGON(((19.30569025282225 69.26599782656409,19.314595559097484 69.31071072114581,19.441026060768202 69.30750874696335,19.431861859706657 69.26280337371568,19.30569025282225 69.26599782656409)))"
26750007690000,4,3,1,0,"MULTIPOLYGON(((19.431861859706657 69.26280337371568,19.441026060768202 69.30750874696335,19.567415943245923 69.30421457220959,19.557993108430363 69.25951693455599,19.431861859706657 69.26280337371568)))"
26900007690000,223,113,110,45.8,"MULTIPOLYGON(((19.81013003118335 69.2526683054305,19.820069321791674 69.29734983039667,19.946330559295575 69.29377937159084,19.93613346089537 69.2491062230563,19.81013003118335 69.2526683054305)))"
26950007690000,467,237,230,39.8,"MULTIPOLYGON(((19.93613346089537 69.2491062230563,19.946330559295575 69.29377937159084,20.072546660598423 69.29011692871292,20.06209204393113 69.24545236954674,19.93613346089537 69.2491062230563)))"
28250007690000,16,8,8,38.3,"MULTIPOLYGON(((23.193265818450644 69.12447222605797,23.210044174296225 69.16885401884353,23.334700982586156 69.16282426504122,23.31767502401784 69.11845645082953,23.193265818450644 69.12447222605797)))"
28300007690000,30,18,12,41.9,"MULTIPOLYGON(((23.31767502401784 69.11845645082953,23.334700982586156 69.16282426504122,23.459283391781966 69.15670456445838,23.44201029939237 69.11235092946006,23.31767502401784 69.11845645082953)))"
25800007695000,325,173,152,46.9,"MULTIPOLYGON(((17.033204270174735 69.35252927200708,17.037431866440244 69.39734025053168,17.16466104444867 69.39580150395993,17.1601699386043 69.35099416062386,17.033204270174735 69.35252927200708)))"
25900007695000,25,13,12,53.8,"MULTIPOLYGON(((17.287115703655097 69.34936615924683,17.291870189301896 69.39416964799538,17.419058129589907 69.3924447087114,17.414040401475376 69.34764529378822,17.287115703655097 69.34936615924683)))"
26100007695000,9,6,3,67.3,"MULTIPOLYGON(((17.794676471198386 69.34192579407625,17.800483027323118 69.38671167384341,17.927574460188186 69.38461469155742,17.921505286248497 69.33983376077447,17.794676471198386 69.34192579407625)))"
26150007695000,103,52,51,47.3,"MULTIPOLYGON(((17.921505286248497 69.33983376077447,17.927574460188186 69.38461469155742,18.0546388507122 69.38242477845776,18.048307233876 69.33764901495535,17.921505286248497 69.33983376077447)))"
26200007695000,477,260,217,44.5,"MULTIPOLYGON(((18.048307233876 69.33764901495535,18.0546388507122 69.38242477845776,18.181675035650343 69.3801419694587,18.17508115830643 69.33537159131785,18.048307233876 69.33764901495535)))"
26250007695000,167,85,82,44.1,"MULTIPOLYGON(((18.17508115830643 69.33537159131785,18.181675035650343 69.3801419694587,18.30868185334545 69.37776630094027,18.301825905335935 69.33300152601772,18.17508115830643 69.33537159131785)))"
26300007695000,247,123,124,47.2,"MULTIPOLYGON(((18.301825905335935 69.33300152601772,18.30868185334545 69.37776630094027,18.435658143792292 69.37529781074569,18.42854032239483 69.33053885666496,18.301825905335935 69.33300152601772)))"
26350007695000,29,18,11,59.6,"MULTIPOLYGON(((18.42854032239483 69.33053885666496,18.435658143792292 69.37529781074569,18.562602748701547 69.37273653817884,18.555223258610926 69.32798362232136,18.42854032239483 69.33053885666496)))"
26400007695000,11,6,5,70.3,"MULTIPOLYGON(((18.555223258610926 69.32798362232136,18.562602748701547 69.37273653817884,18.6895145115636 69.37008252400166,18.681873564872628 69.32533586349783,18.555223258610926 69.32798362232136)))"
26450007695000,90,42,48,45.4,"MULTIPOLYGON(((18.681873564872628 69.32533586349783,18.6895145115636 69.37008252400166,18.816392277712048 69.36733581043116,18.808490093891766 69.32259562215161,18.681873564872628 69.32533586349783)))"
26500007695000,308,139,169,44.4,"MULTIPOLYGON(((18.808490093891766 69.32259562215161,18.816392277712048 69.36733581043116,18.943234894386944 69.36449644113675,18.93507170026621 69.31976294168349,18.808490093891766 69.32259562215161)))"
26550007695000,12,6,6,51.5,"MULTIPOLYGON(((18.93507170026621 69.31976294168349,18.943234894386944 69.36449644113675,19.070041210797818 69.36156446123724,19.06161724054218 69.3168378669348,18.93507170026621 69.31976294168349)))"
26600007695000,33,14,19,50.2,"MULTIPOLYGON(((19.06161724054218 69.3168378669348,19.070041210797818 69.36156446123724,19.196810078186385 69.35853991729765,19.188125573276324 69.31382044418447,19.06161724054218 69.3168378669348)))"
26650007695000,40,23,17,46.9,"MULTIPOLYGON(((19.188125573276324 69.31382044418447,19.196810078186385 69.35853991729765,19.323540349888983 69.35542285732622,19.314595559097484 69.31071072114581,19.188125573276324 69.31382044418447)))"
26700007695000,131,63,68,45.9,"MULTIPOLYGON(((19.314595559097484 69.31071072114581,19.323540349888983 69.35542285732622,19.45023088139872 69.352213330771,19.441026060768202 69.30750874696335,19.314595559097484 69.31071072114581)))"
26750007695000,28,17,11,50.9,"MULTIPOLYGON(((19.441026060768202 69.30750874696335,19.45023088139872 69.352213330771,19.57688053042732 69.34891138851665,19.567415943245923 69.30421457220959,19.441026060768202 69.30750874696335)))"
26800007695000,5,3,2,55.8,"MULTIPOLYGON(((19.567415943245923 69.30421457220959,19.57688053042732 69.34891138851665,19.70348815696666 69.34551708288096,19.693764073743875 69.30082824888136,19.567415943245923 69.30421457220959)))"
26900007695000,34,19,15,37.6,"MULTIPOLYGON(((19.820069321791674 69.29734983039667,19.83005262335 69.3420304676112,19.956572794312873 69.33845159788062,19.946330559295575 69.29377937159084,19.820069321791674 69.29734983039667)))"
26950007695000,85,41,44,53,"MULTIPOLYGON(((19.946330559295575 69.29377937159084,19.956572794312873 69.33845159788062,20.08304753705365 69.33478053028473,20.072546660598423 69.29011692871292,19.946330559295575 69.29377937159084)))"
27100007695000,4,4,0,0,"MULTIPOLYGON(((20.324838964512566 69.28251632278308,20.335856219337703 69.32716203496717,20.462187906132264 69.32321472751289,20.45091292852721 69.27857827926358,20.324838964512566 69.28251632278308)))"
28300007695000,11,7,4,35.5,"MULTIPOLYGON(((23.334700982586156 69.16282426504122,23.3518013409075 69.20718991302395,23.47663191858363 69.20105597608877,23.459283391781966 69.15670456445838,23.334700982586156 69.16282426504122)))"
28350007695000,60,30,30,42.8,"MULTIPOLYGON(((23.459283391781966 69.15670456445838,23.47663191858363 69.20105597608877,23.601386583481958 69.19483198553621,23.583790367232545 69.1504950110865,23.459283391781966 69.15670456445838)))"
28850007695000,1,1,0,0,"MULTIPOLYGON(((24.700789927501564 69.09058178786056,24.72059279407832 69.13477988708075,24.844531998084797 69.12766083893392,24.824486562731384 69.08347915258263,24.700789927501564 69.09058178786056)))"
25800007700000,9,6,3,32.1,"MULTIPOLYGON(((17.037431866440244 69.39734025053168,17.041678323496434 69.44215087798312,17.169172183636956 69.44060848108337,17.16466104444867 69.39580150395993,17.037431866440244 69.39734025053168)))"
25850007700000,26,13,13,54.8,"MULTIPOLYGON(((17.16466104444867 69.39580150395993,17.169172183636956 69.44060848108337,17.29664587971355 69.43897275448207,17.291870189301896 69.39416964799538,17.16466104444867 69.39580150395993)))"
25900007700000,6,3,3,62.8,"MULTIPOLYGON(((17.291870189301896 69.39416964799538,17.29664587971355 69.43897275448207,17.424098232692344 69.4372437244152,17.419058129589907 69.3924447087114,17.291870189301896 69.39416964799538)))"
26100007700000,2,1,1,0,"MULTIPOLYGON(((17.800483027323118 69.38671167384341,17.80631546126395 69.4314970980839,17.933670676722794 69.4293951462384,17.927574460188186 69.38461469155742,17.800483027323118 69.38671167384341)))"
26150007700000,52,24,28,55,"MULTIPOLYGON(((17.927574460188186 69.38461469155742,17.933670676722794 69.4293951462384,18.060998673398903 69.42720004438262,18.0546388507122 69.38242477845776,17.927574460188186 69.38461469155742)))"
26200007700000,142,75,67,41.5,"MULTIPOLYGON(((18.0546388507122 69.38242477845776,18.060998673398903 69.42720004438262,18.188298280512612 69.42491182764807,18.181675035650343 69.3801419694587,18.0546388507122 69.38242477845776)))"
26250007700000,41,24,17,33.2,"MULTIPOLYGON(((18.181675035650343 69.3801419694587,18.188298280512612 69.42491182764807,18.315568328889228 69.42253053264093,18.30868185334545 69.37776630094027,18.181675035650343 69.3801419694587)))"
26300007700000,123,70,53,44.3,"MULTIPOLYGON(((18.30868185334545 69.37776630094027,18.315568328889228 69.42253053264093,18.44280765102395 69.42005619743965,18.435658143792292 69.37529781074569,18.30868185334545 69.37776630094027)))"
26350007700000,10,7,3,43.7,"MULTIPOLYGON(((18.435658143792292 69.37529781074569,18.44280765102395 69.42005619743965,18.570015081146572 69.41748886159232,18.562602748701547 69.37273653817884,18.435658143792292 69.37529781074569)))"
26400007700000,176,83,93,45.4,"MULTIPOLYGON(((18.562602748701547 69.37273653817884,18.570015081146572 69.41748886159232,18.697189455285937 69.41482856611391,18.6895145115636 69.37008252400166,18.562602748701547 69.37273653817884)))"
26450007700000,69,36,33,51.9,"MULTIPOLYGON(((18.6895145115636 69.37008252400166,18.697189455285937 69.41482856611391,18.824329611334125 69.41207535348354,18.816392277712048 69.36733581043116,18.6895145115636 69.37008252400166)))"
26500007700000,4,1,3,0,"MULTIPOLYGON(((18.816392277712048 69.36733581043116,18.824329611334125 69.41207535348354,18.9514343891104 69.40922926764156,18.943234894386944 69.36449644113675,18.816392277712048 69.36733581043116)))"
26550007700000,115,65,50,49.5,"MULTIPOLYGON(((18.943234894386944 69.36449644113675,18.9514343891104 69.40922926764156,19.078502630424868 69.40629035398646,19.070041210797818 69.36156446123724,18.943234894386944 69.36449644113675)))"
26600007700000,36,17,19,46.7,"MULTIPOLYGON(((19.070041210797818 69.36156446123724,19.078502630424868 69.40629035398646,19.205533179141884 69.40325865937197,19.196810078186385 69.35853991729765,19.070041210797818 69.36156446123724)))"
26650007700000,91,52,39,49,"MULTIPOLYGON(((19.196810078186385 69.35853991729765,19.205533179141884 69.40325865937197,19.33252488124312 69.40013423210364,19.323540349888983 69.35542285732622,19.196810078186385 69.35853991729765)))"
26700007700000,180,103,77,41.5,"MULTIPOLYGON(((19.323540349888983 69.35542285732622,19.33252488124312 69.40013423210364,19.45947658489041 69.39691712193572,19.45023088139872 69.352213330771,19.323540349888983 69.35542285732622)))"
26750007700000,25,15,10,47.1,"MULTIPOLYGON(((19.45023088139872 69.352213330771,19.45947658489041 69.39691712193572,19.586387140488213 69.3936073800677,19.57688053042732 69.34891138851665,19.45023088139872 69.352213330771)))"
26800007700000,42,27,15,41.7,"MULTIPOLYGON(((19.57688053042732 69.34891138851665,19.586387140488213 69.3936073800677,19.713255400745833 69.3902050591409,19.70348815696666 69.34551708288096,19.57688053042732 69.34891138851665)))"
26950007700000,78,39,39,52.6,"MULTIPOLYGON(((19.956572794312873 69.33845159788062,19.966860457972775 69.38312289786336,20.093594972440016 69.37944316997157,20.08304753705365 69.33478053028473,19.956572794312873 69.33845159788062)))"
27000007700000,4,2,2,0,"MULTIPOLYGON(((20.08304753705365 69.33478053028473,20.093594972440016 69.37944316997157,20.22028262668498 69.37567108793114,20.209475721293792 69.33101732283744,20.08304753705365 69.33478053028473)))"
27050007700000,92,54,38,53.3,"MULTIPOLYGON(((20.209475721293792 69.33101732283744,20.22028262668498 69.37567108793114,20.34692228586247 69.37180671153686,20.335856219337703 69.32716203496717,20.209475721293792 69.33101732283744)))"
28400007700000,1,1,0,0,"MULTIPOLYGON(((23.601386583481958 69.19483198553621,23.6190597499768 69.23916666601265,23.743985702294378 69.23283802123943,23.72606429881658 69.1885180372005,23.601386583481958 69.19483198553621)))"
28450007700000,31,21,10,66.1,"MULTIPOLYGON(((23.72606429881658 69.1885180372005,23.743985702294378 69.23283802123943,23.868833176953665 69.22641931536742,23.850664031891807 69.18211422818713,23.72606429881658 69.1885180372005)))"
25850007705000,137,74,63,42,"MULTIPOLYGON(((17.169172183636956 69.44060848108337,17.173703487079937 69.48541509154208,17.301442913424854 69.48377547814974,17.29664587971355 69.43897275448207,17.169172183636956 69.44060848108337)))"
25900007705000,113,61,52,47.7,"MULTIPOLYGON(((17.29664587971355 69.43897275448207,17.301442913424854 69.48377547814974,17.42916085692839 69.48204234023139,17.424098232692344 69.4372437244152,17.29664587971355 69.43897275448207)))"
25950007705000,39,21,18,55.2,"MULTIPOLYGON(((17.424098232692344 69.4372437244152,17.42916085692839 69.48204234023139,17.556856132090648 69.48021570568383,17.55152806475039 69.43542141860631,17.424098232692344 69.4372437244152)))"
26050007705000,1,1,0,0,"MULTIPOLYGON(((17.678934199341843 69.43350586626481,17.6845275547028 69.47829560389879,17.812173941913784 69.47628206576103,17.80631546126395 69.4314970980839,17.678934199341843 69.43350586626481)))"
26100007705000,53,31,22,52,"MULTIPOLYGON(((17.80631546126395 69.4314970980839,17.812173941913784 69.47628206576103,17.93979411229678 69.47417512364618,17.933670676722794 69.4293951462384,17.80631546126395 69.4314970980839)))"
26150007705000,90,42,48,48.6,"MULTIPOLYGON(((17.933670676722794 69.4293951462384,17.93979411229678 69.47417512364618,18.0673868859155 69.4719748114184,18.060998673398903 69.42720004438262,17.933670676722794 69.4293951462384)))"
26200007705000,19,12,7,51.3,"MULTIPOLYGON(((18.060998673398903 69.42720004438262,18.0673868859155 69.4719748114184,18.1949510843903 69.46968116442822,18.188298280512612 69.42491182764807,18.060998673398903 69.42720004438262)))"
26250007705000,16,10,6,55.7,"MULTIPOLYGON(((18.188298280512612 69.42491182764807,18.1949510843903 69.46968116442822,18.322485530964006 69.46729421951004,18.315568328889228 69.42253053264093,18.188298280512612 69.42491182764807)))"
26300007705000,24,11,13,61.6,"MULTIPOLYGON(((18.315568328889228 69.42253053264093,18.322485530964006 69.46729421951004,18.44998905056756 69.46481401497948,18.44280765102395 69.42005619743965,18.315568328889228 69.42253053264093)))"
26350007705000,59,30,29,48.5,"MULTIPOLYGON(((18.44280765102395 69.42005619743965,18.44998905056756 69.46481401497948,18.57746046988541 69.4622405906309,18.570015081146572 69.41748886159232,18.44280765102395 69.42005619743965)))"
26500007705000,78,39,39,46.5,"MULTIPOLYGON(((18.824329611334125 69.41207535348354,18.832302323559936 69.4568142490339,18.95967042063804 69.45396141874247,18.9514343891104 69.40922926764156,18.824329611334125 69.41207535348354)))"
26550007705000,64,37,27,51.5,"MULTIPOLYGON(((18.9514343891104 69.40922926764156,18.95967042063804 69.45396141874247,19.08700174300228 69.45101554254093,19.078502630424868 69.40629035398646,18.9514343891104 69.40922926764156)))"
26750007705000,23,15,8,57.6,"MULTIPOLYGON(((19.45947658489041 69.39691712193572,19.46876343681573 69.44162011722388,19.595936046283754 69.43830254342056,19.586387140488213 69.3936073800677,19.45947658489041 69.39691712193572)))"
26800007705000,141,77,64,50.2,"MULTIPOLYGON(((19.586387140488213 69.3936073800677,19.595936046283754 69.43830254342056,19.723066085193913 69.43489217400504,19.713255400745833 69.3902050591409,19.586387140488213 69.3936073800677)))"
26950007705000,7,3,4,51.1,"MULTIPOLYGON(((19.966860457972775 69.38312289786336,19.977193844824004 69.42779326743862,20.1041892684838 69.42410484344262,20.093594972440016 69.37944316997157,19.966860457972775 69.38312289786336)))"
27000007705000,43,26,17,58.1,"MULTIPOLYGON(((20.093594972440016 69.37944316997157,20.1041892684838 69.42410484344262,20.231137527588825 69.42032385013654,20.22028262668498 69.37567108793114,20.093594972440016 69.37944316997157)))"
27050007705000,634,324,310,45.9,"MULTIPOLYGON(((20.22028262668498 69.37567108793114,20.231137527588825 69.42032385013654,20.3580374800841 69.41645034768466,20.34692228586247 69.37180671153686,20.22028262668498 69.37567108793114)))"
28800007705000,1,1,0,0,"MULTIPOLYGON(((24.616212351846436 69.18602142715125,24.635942835312107 69.23023015544757,24.76045734560496 69.22316751513561,24.740481752467293 69.17897513494255,24.616212351846436 69.18602142715125)))"
25900007710000,30,17,13,51,"MULTIPOLYGON(((17.301442913424854 69.48377547814974,17.306261430181575 69.52857781843315,17.43424614972089 69.5268405554828,17.42916085692839 69.48204234023139,17.301442913424854 69.48377547814974)))"
25950007710000,453,231,222,44.6,"MULTIPOLYGON(((17.42916085692839 69.48204234023139,17.43424614972089 69.5268405554828,17.562208052207307 69.5250095740973,17.556856132090648 69.48021570568383,17.42916085692839 69.48204234023139)))"
26000007710000,162,87,75,45.4,"MULTIPOLYGON(((17.556856132090648 69.48021570568383,17.562208052207307 69.5250095740973,17.690145945702312 69.52308490385235,17.6845275547028 69.47829560389879,17.556856132090648 69.48021570568383)))"
26050007710000,2,2,0,0,"MULTIPOLYGON(((17.6845275547028 69.47829560389879,17.690145945702312 69.52308490385235,17.818058639640046 69.52106657582594,17.812173941913784 69.47628206576103,17.6845275547028 69.47829560389879)))"
26100007710000,265,135,130,43.7,"MULTIPOLYGON(((17.812173941913784 69.47628206576103,17.818058639640046 69.52106657582594,17.945944944894478 69.51895462259614,17.93979411229678 69.47417512364618,17.812173941913784 69.47628206576103)))"
26150007710000,23,9,14,41.4,"MULTIPOLYGON(((17.93979411229678 69.47417512364618,17.945944944894478 69.51895462259614,18.073803673846445 69.51674907823887,18.0673868859155 69.4719748114184,17.93979411229678 69.47417512364618)))"
26250007710000,26,13,13,44.7,"MULTIPOLYGON(((18.1949510843903 69.46968116442822,18.201633640450442 69.51444997832557,18.329433660301195 69.51205735992073,18.322485530964006 69.46729421951004,18.1949510843903 69.46968116442822)))"
26300007710000,15,7,8,41.4,"MULTIPOLYGON(((18.322485530964006 69.46729421951004,18.329433660301195 69.51205735992073,18.45720255069999 69.50957126157924,18.44998905056756 69.46481401497948,18.322485530964006 69.46729421951004)))"
26350007710000,23,12,11,49.2,"MULTIPOLYGON(((18.44998905056756 69.46481401497948,18.45720255069999 69.50957126157924,18.58493913072078 69.5069917233438,18.57746046988541 69.4622405906309,18.44998905056756 69.46481401497948)))"
26500007710000,37,19,18,46.5,"MULTIPOLYGON(((18.832302323559936 69.4568142490339,18.840310645182342 69.50155249478442,18.967943227225657 69.49869289195958,18.95967042063804 69.45396141874247,18.832302323559936 69.4568142490339)))"
26550007710000,66,36,30,41.1,"MULTIPOLYGON(((18.95967042063804 69.45396141874247,18.967943227225657 69.49869289195958,19.095538794226414 69.49574002423293,19.08700174300228 69.45101554254093,18.95967042063804 69.45396141874247)))"
26650007710000,1,1,0,0,"MULTIPOLYGON(((19.214295127076525 69.44797666757407,19.223096175104253 69.49269393904282,19.350614200942438 69.48955468529722,19.341549411424992 69.44484484244738,19.214295127076525 69.44797666757407)))"
26750007710000,8,6,2,64.4,"MULTIPOLYGON(((19.46876343681573 69.44162011722388,19.47809170505208 69.48632231337054,19.60552752303589 69.48299687510003,19.595936046283754 69.43830254342056,19.46876343681573 69.44162011722388)))"
26800007710000,53,32,21,53,"MULTIPOLYGON(((19.595936046283754 69.43830254342056,19.60552752303589 69.48299687510003,19.73292049285175 69.47957842378241,19.723066085193913 69.43489217400504,19.595936046283754 69.43830254342056)))"
27000007710000,265,127,138,47.7,"MULTIPOLYGON(((20.1041892684838 69.42410484344262,20.114830729522208 69.46876554632647,20.242040735552383 69.46497560484454,20.231137527588825 69.42032385013654,20.1041892684838 69.42410484344262)))"
27150007710000,4,3,1,0,"MULTIPOLYGON(((20.484887986614474 69.41248439767871,20.496313738460657 69.45711760944067,20.623374444935823 69.45304968089651,20.611687910584955 69.40842606313382,20.484887986614474 69.41248439767871)))"
28450007710000,4,3,1,0,"MULTIPOLYGON(((23.761985584127213 69.27715563910563,23.780064443901747 69.32147087748486,23.90541051186324 69.3150221971588,23.887081835033964 69.27072197625536,23.761985584127213 69.27715563910563)))"
29200007710000,3,1,2,0,"MULTIPOLYGON(((25.629561863350364 69.17123119774314,25.6513316959169 69.21530032088798,25.77536240967084 69.2075074010743,25.753351034200907 69.16345624838448,25.629561863350364 69.17123119774314)))"
26000007715000,302,171,131,39.7,"MULTIPOLYGON(((17.562208052207307 69.5250095740973,17.56758398154415 69.56980302304149,17.695789536499085 69.56787376519529,17.690145945702312 69.52308490385235,17.562208052207307 69.5250095740973)))"
26050007715000,8,3,5,63.3,"MULTIPOLYGON(((17.690145945702312 69.52308490385235,17.695789536499085 69.56787376519529,17.823969726300753 69.56585062721743,17.818058639640046 69.52106657582594,17.690145945702312 69.52308490385235)))"
26100007715000,17,9,8,50.8,"MULTIPOLYGON(((17.818058639640046 69.52106657582594,17.823969726300753 69.56585062721743,17.952123354056923 69.56373364189027,17.945944944894478 69.51895462259614,17.818058639640046 69.52106657582594)))"
26200007715000,27,16,11,53,"MULTIPOLYGON(((18.073803673846445 69.51674907823887,18.080249224398738 69.5615228435032,18.20834614354827 69.55921826785054,18.201633640450442 69.51444997832557,18.073803673846445 69.51674907823887)))"
26250007715000,84,41,43,54.6,"MULTIPOLYGON(((18.201633640450442 69.51444997832557,18.20834614354827 69.55921826785054,18.33641291938579 69.55681995222882,18.329433660301195 69.51205735992073,18.201633640450442 69.51444997832557)))"
26300007715000,89,45,44,43.2,"MULTIPOLYGON(((18.329433660301195 69.51205735992073,18.33641291938579 69.55681995222882,18.464448361516844 69.55432793543424,18.45720255069999 69.50957126157924,18.329433660301195 69.51205735992073)))"
26350007715000,58,29,29,46.9,"MULTIPOLYGON(((18.45720255069999 69.50957126157924,18.464448361516844 69.55432793543424,18.592451281339038 69.55174225776007,18.58493913072078 69.5069917233438,18.45720255069999 69.50957126157924)))"
26400007715000,52,28,24,48.9,"MULTIPOLYGON(((18.58493913072078 69.5069917233438,18.592451281339038 69.55174225776007,18.720420492108637 69.54906296099381,18.712642221276045 69.50431878674223,18.58493913072078 69.5069917233438)))"
26450007715000,96,52,44,41.2,"MULTIPOLYGON(((18.712642221276045 69.50431878674223,18.720420492108637 69.54906296099381,18.848354809006818 69.54629008841415,18.840310645182342 69.50155249478442,18.712642221276045 69.50431878674223)))"
26500007715000,207,112,95,40.4,"MULTIPOLYGON(((18.840310645182342 69.50155249478442,18.848354809006818 69.54629008841415,18.976253049205702 69.54342368478827,18.967943227225657 69.49869289195958,18.840310645182342 69.50155249478442)))"
26550007715000,207,125,82,43.2,"MULTIPOLYGON(((18.967943227225657 69.49869289195958,18.976253049205702 69.54342368478827,19.104114031934095 69.54046379636846,19.095538794226414 69.49574002423293,18.967943227225657 69.49869289195958)))"
26600007715000,68,38,30,41.1,"MULTIPOLYGON(((19.095538794226414 69.49574002423293,19.104114031934095 69.54046379636846,19.231936578542925 69.53741047088906,19.223096175104253 69.49269393904282,19.095538794226414 69.49574002423293)))"
26650007715000,147,77,70,42.2,"MULTIPOLYGON(((19.223096175104253 69.49269393904282,19.231936578542925 69.53741047088906,19.35971951257039 69.5342637575632,19.350614200942438 69.48955468529722,19.223096175104253 69.49269393904282)))"
26800007715000,65,29,36,55,"MULTIPOLYGON(((19.60552752303589 69.48299687510003,19.615161848359037 69.52769037159764,19.74281890871486 69.52426380474681,19.73292049285175 69.47957842378241,19.60552752303589 69.48299687510003)))"
27000007715000,245,119,126,44.7,"MULTIPOLYGON(((20.114830729522208 69.46876554632647,20.125519662531584 69.51342527421058,20.252992564822645 69.50962634740281,20.242040735552383 69.46497560484454,20.114830729522208 69.46876554632647)))"
27100007715000,24,13,11,45.3,"MULTIPOLYGON(((20.369202120730694 69.46109293855828,20.38041652929065 69.50573447926028,20.507790402036765 69.50174973214037,20.496313738460657 69.45711760944067,20.369202120730694 69.46109293855828)))"
27150007715000,39,22,17,51.1,"MULTIPOLYGON(((20.496313738460657 69.45711760944067,20.507790402036765 69.50174973214037,20.635113031982428 69.49767216984094,20.623374444935823 69.45304968089651,20.496313738460657 69.45711760944067)))"
27250007715000,143,71,72,45.9,"MULTIPOLYGON(((20.750383099200416 69.44888921775822,20.7623832709306 69.49350185759604,20.889599973626687 69.48923886207129,20.877338563209605 69.44463628628131,20.750383099200416 69.44888921775822)))"
27300007715000,201,112,89,51.6,"MULTIPOLYGON(((20.877338563209605 69.44463628628131,20.889599973626687 69.48923886207129,21.01676199781896 69.48488325135956,21.00423970188932 69.44029095414004,20.877338563209605 69.44463628628131)))"
27550007715000,1,1,0,0,"MULTIPOLYGON(((21.51127840912591 69.4219870218118,21.52484057296726 69.46653606818916,21.651712180145072 69.46171845255738,21.637891003161332 69.41718075079154,21.51127840912591 69.4219870218118)))"
28500007715000,10,6,4,44,"MULTIPOLYGON(((23.90541051186324 69.3150221971588,23.92381971744361 69.35931996426585,24.049335607115545 69.35276563947947,24.03067605179302 69.3084831528001,23.90541051186324 69.3150221971588)))"
29200007715000,5,3,2,51,"MULTIPOLYGON(((25.6513316959169 69.21530032088798,25.67319624136062 69.25936606133766,25.797469475590333 69.25155509945992,25.77536240967084 69.2075074010743,25.6513316959169 69.21530032088798)))"
26150007720000,132,73,59,48.5,"MULTIPOLYGON(((17.952123354056923 69.56373364189027,17.95832952089887 69.60851218031684,18.086723726419688 69.60629610585565,18.080249224398738 69.5615228435032,17.952123354056923 69.56373364189027)))"
26250007720000,141,74,67,42.4,"MULTIPOLYGON(((18.20834614354827 69.55921826785054,18.215088790245655 69.60398603149736,18.343423512475542 69.60158199477257,18.33641291938579 69.55681995222882,18.20834614354827 69.55921826785054)))"
26350007720000,9,4,5,42.6,"MULTIPOLYGON(((18.464448361516844 69.55432793543424,18.471726694952327 69.59908403472093,18.599997141330725 69.5964921918884,18.592451281339038 69.55174225776007,18.464448361516844 69.55432793543424)))"
26400007720000,209,115,94,45.9,"MULTIPOLYGON(((18.592451281339038 69.55174225776007,18.599997141330725 69.5964921918884,18.728233657144482 69.59380650832433,18.720420492108637 69.54906296099381,18.592451281339038 69.55174225776007)))"
26450007720000,247,127,120,41,"MULTIPOLYGON(((18.720420492108637 69.54906296099381,18.728233657144482 69.59380650832433,18.856435049873376 69.59102702757869,18.848354809006818 69.54629008841415,18.720420492108637 69.54906296099381)))"
26500007720000,420,211,209,38.2,"MULTIPOLYGON(((18.848354809006818 69.54629008841415,18.856435049873376 69.59102702757869,18.98460012900993 69.58815379469888,18.976253049205702 69.54342368478827,18.848354809006818 69.54629008841415)))"
26550007720000,200,96,104,35.6,"MULTIPOLYGON(((18.976253049205702 69.54342368478827,18.98460012900993 69.58815379469888,19.112727706125884 69.58518685622674,19.104114031934095 69.54046379636846,18.976253049205702 69.54342368478827)))"
26600007720000,724,380,344,38.5,"MULTIPOLYGON(((19.104114031934095 69.54046379636846,19.112727706125884 69.58518685622674,19.240816594938323 69.58212626019525,19.231936578542925 69.53741047088906,19.104114031934095 69.54046379636846)))"
26650007720000,10,5,5,42.4,"MULTIPOLYGON(((19.231936578542925 69.53741047088906,19.240816594938323 69.58212626019525,19.368865611375515 69.57897205612522,19.35971951257039 69.5342637575632,19.231936578542925 69.53741047088906)))"
26750007720000,12,7,5,53.9,"MULTIPOLYGON(((19.48746165980679 69.53102370707929,19.496873573642457 69.5757242950218,19.624839302286066 69.57238302937111,19.615161848359037 69.52769037159764,19.48746165980679 69.53102370707929)))"
26800007720000,117,61,56,58.9,"MULTIPOLYGON(((19.615161848359037 69.52769037159764,19.624839302286066 69.57238302937111,19.752761620260046 69.56894831313639,19.74281890871486 69.52426380474681,19.615161848359037 69.52769037159764)))"
27000007720000,311,163,148,43.9,"MULTIPOLYGON(((20.125519662531584 69.51342527421058,20.136256377156005 69.5580840226409,20.263993332375733 69.55427607311552,20.252992564822645 69.50962634740281,20.125519662531584 69.51342527421058)))"
27050007720000,13,6,7,47.4,"MULTIPOLYGON(((20.252992564822645 69.50962634740281,20.263993332375733 69.55427607311552,20.391681030042548 69.55037496484748,20.38041652929065 69.50573447926028,20.252992564822645 69.50962634740281)))"
27100007720000,52,26,26,40.7,"MULTIPOLYGON(((20.38041652929065 69.50573447926028,20.391681030042548 69.55037496484748,20.519318308893602 69.54638076058185,20.507790402036765 69.50174973214037,20.38041652929065 69.50573447926028)))"
27150007720000,561,291,270,45.2,"MULTIPOLYGON(((20.507790402036765 69.50174973214037,20.519318308893602 69.54638076058185,20.64690401051692 69.54229352451298,20.635113031982428 69.49767216984094,20.507790402036765 69.50174973214037)))"
27200007720000,72,35,37,53.7,"MULTIPOLYGON(((20.635113031982428 69.49767216984094,20.64690401051692 69.54229352451298,20.774436979413355 69.53811332227986,20.7623832709306 69.49350185759604,20.635113031982428 69.49767216984094)))"
27250007720000,232,126,106,45.7,"MULTIPOLYGON(((20.7623832709306 69.49350185759604,20.774436979413355 69.53811332227986,20.901916063058074 69.53384022096182,20.889599973626687 69.48923886207129,20.7623832709306 69.49350185759604)))"
27450007720000,2,1,1,0,"MULTIPOLYGON(((21.270917457059486 69.47589446385456,21.284018523128246 69.52046421479855,21.411270602133317 69.51582021657721,21.397908623157015 69.47126143034075,21.270917457059486 69.47589446385456)))"
27500007720000,5,5,0,65.8,"MULTIPOLYGON(((21.397908623157015 69.47126143034075,21.411270602133317 69.51582021657721,21.538463080000504 69.51108367610823,21.52484057296726 69.46653606818916,21.397908623157015 69.47126143034075)))"
28550007720000,1,1,0,0,"MULTIPOLYGON(((24.049335607115545 69.35276563947947,24.06807725438313 69.3970455964108,24.193761926549076 69.39038526291027,24.174769405577287 69.34612085063719,24.049335607115545 69.35276563947947)))"
28600007720000,17,8,9,53.2,"MULTIPOLYGON(((24.174769405577287 69.34612085063719,24.193761926549076 69.39038526291027,24.319362931938485 69.38363436709683,24.300120068370347 69.33938570106906,24.174769405577287 69.34612085063719)))"
28650007720000,1,0,1,0,"MULTIPOLYGON(((24.300120068370347 69.33938570106906,24.319362931938485 69.38363436709683,24.44487922440118 69.37679301420548,24.42538655549226 69.33256029537868,24.300120068370347 69.33938570106906)))"
29200007720000,3,2,1,0,"MULTIPOLYGON(((25.67319624136062 69.25936606133766,25.69515609639522 69.30342839936182,25.819672834190023 69.29559932336915,25.797469475590333 69.25155509945992,25.67319624136062 69.25936606133766)))"
26150007725000,386,199,187,44.3,"MULTIPOLYGON(((17.95832952089887 69.60851218031684,17.964563628126086 69.65329023665045,18.093227370414894 69.65106886392543,18.086723726419688 69.60629610585565,17.95832952089887 69.60851218031684)))"
26200007725000,52,28,24,48.6,"MULTIPOLYGON(((18.086723726419688 69.60629610585565,18.093227370414894 69.65106886392543,18.22186177882983 69.6487532677439,18.215088790245655 69.60398603149736,18.086723726419688 69.60629610585565)))"
26250007725000,33,17,16,49.5,"MULTIPOLYGON(((18.215088790245655 69.60398603149736,18.22186177882983 69.6487532677439,18.350465645620368 69.6463434858726,18.343423512475542 69.60158199477257,18.215088790245655 69.60398603149736)))"
26300007725000,25,15,10,48.5,"MULTIPOLYGON(((18.343423512475542 69.60158199477257,18.350465645620368 69.6463434858726,18.479037764799372 69.64383955759666,18.471726694952327 69.59908403472093,18.343423512475542 69.60158199477257)))"
26400007725000,79,44,35,36.4,"MULTIPOLYGON(((18.599997141330725 69.5964921918884,18.607576932211398 69.64124152371689,18.736081945600667 69.63854942654686,18.728233657144482 69.59380650832433,18.599997141330725 69.5964921918884)))"
26450007725000,208,112,96,41.3,"MULTIPOLYGON(((18.728233657144482 69.59380650832433,18.736081945600667 69.63854942654686,18.864551604678816 69.63576330990998,18.856435049873376 69.59102702757869,18.728233657144482 69.59380650832433)))"
26500007725000,5052,2495,2557,39.5,"MULTIPOLYGON(((18.856435049873376 69.59102702757869,18.864551604678816 69.63576330990998,18.99298471119233 69.6328832191365,18.98460012900993 69.58815379469888,18.856435049873376 69.59102702757869)))"
26650007725000,49,32,17,44.5,"MULTIPOLYGON(((19.240816594938323 69.58212626019525,19.24973648408843 69.62684130401524,19.378052764741224 69.6236795778328,19.368865611375515 69.57897205612522,19.240816594938323 69.58212626019525)))"
26700007725000,7,4,3,38.3,"MULTIPOLYGON(((19.368865611375515 69.57897205612522,19.378052764741224 69.6236795778328,19.506327721502608 69.62042407383755,19.496873573642457 69.5757242950218,19.368865611375515 69.57897205612522)))"
26800007725000,45,23,22,60.4,"MULTIPOLYGON(((19.624839302286066 69.57238302937111,19.634560167294616 69.6170748448441,19.762748917472422 69.61363194515337,19.752761620260046 69.56894831313639,19.624839302286066 69.57238302937111)))"
26850007725000,36,21,15,64.8,"MULTIPOLYGON(((19.752761620260046 69.56894831313639,19.762748917472422 69.61363194515337,19.890892789889527 69.61009543054885,19.880639352989444 69.56542020175448,19.752761620260046 69.56894831313639)))"
26900007725000,3,2,1,0,"MULTIPOLYGON(((19.880639352989444 69.56542020175448,19.890892789889527 69.61009543054885,20.018990604962653 69.60646535829258,20.0084713284348 69.56179875213189,19.880639352989444 69.56542020175448)))"
26950007725000,22,11,11,60.3,"MULTIPOLYGON(((20.0084713284348 69.56179875213189,20.018990604962653 69.60646535829258,20.147041185736224 69.60274178712137,20.136256377156005 69.5580840226409,20.0084713284348 69.56179875213189)))"
27000007725000,824,410,414,45.8,"MULTIPOLYGON(((20.136256377156005 69.5580840226409,20.147041185736224 69.60274178712137,20.275043357946515 69.59892477724269,20.263993332375733 69.55427607311552,20.136256377156005 69.5580840226409)))"
27050007725000,76,40,36,50.2,"MULTIPOLYGON(((20.263993332375733 69.55427607311552,20.275043357946515 69.59892477724269,20.402995950085383 69.59501439033043,20.391681030042548 69.55037496484748,20.263993332375733 69.55427607311552)))"
27100007725000,16,8,8,39.4,"MULTIPOLYGON(((20.391681030042548 69.55037496484748,20.402995950085383 69.59501439033043,20.530897793463645 69.59101068952083,20.519318308893602 69.54638076058185,20.391681030042548 69.55037496484748)))"
27150007725000,94,52,42,53.3,"MULTIPOLYGON(((20.519318308893602 69.54638076058185,20.530897793463645 69.59101068952083,20.65874772227403 69.58691373940792,20.64690401051692 69.54229352451298,20.519318308893602 69.54638076058185)))"
27400007725000,16,8,8,37.4,"MULTIPOLYGON(((21.156707979730715 69.52501559656201,21.169605080050367 69.56959478857996,21.29717805413539 69.56503261157215,21.284018523128246 69.52046421479855,21.156707979730715 69.52501559656201)))"
27450007725000,45,26,19,46,"MULTIPOLYGON(((21.284018523128246 69.52046421479855,21.29717805413539 69.56503261157215,21.424692182803266 69.56037760318624,21.411270602133317 69.51582021657721,21.284018523128246 69.52046421479855)))"
27500007725000,3,2,1,0,"MULTIPOLYGON(((21.411270602133317 69.51582021657721,21.424692182803266 69.56037760318624,21.552146322148182 69.55562983809216,21.538463080000504 69.51108367610823,21.411270602133317 69.51582021657721)))"
28350007725000,193,100,93,45.9,"MULTIPOLYGON(((23.5645229775557 69.42277924753617,23.58233431365987 69.46711705570797,23.70859710601128 69.46080520585306,23.690531765984566 69.41648218992995,23.5645229775557 69.42277924753617)))"
28750007725000,17,9,8,47.4,"MULTIPOLYGON(((24.570309762336585 69.3698613107449,24.59013848553596 69.4140750807171,24.71573197688605 69.4070367211383,24.69565350873987 69.36283936449036,24.570309762336585 69.3698613107449)))"
26250007730000,7,4,3,56.3,"MULTIPOLYGON(((18.22186177882983 69.6487532677439,18.228665309332314 69.69351997505153,18.357539526682 69.69110442383153,18.350465645620368 69.6463434858726,18.22186177882983 69.6487532677439)))"
26400007730000,486,251,235,37.9,"MULTIPOLYGON(((18.607576932211398 69.64124152371689,18.615190877442735 69.68599025121271,18.743965588707123 69.68329171345187,18.736081945600667 69.63854942654686,18.607576932211398 69.64124152371689)))"
26450007730000,2114,1094,1020,34,"MULTIPOLYGON(((18.736081945600667 69.63854942654686,18.743965588707123 69.68329171345187,18.872704712399223 69.680498933016,18.864551604678816 69.63576330990998,18.736081945600667 69.63854942654686)))"
26500007730000,31619,15825,15794,38.9,"MULTIPOLYGON(((18.864551604678816 69.63576330990998,18.872704712399223 69.680498933016,19.001407042452332 69.67761195552053,18.99298471119233 69.6328832191365,18.864551604678816 69.63576330990998)))"
26550007730000,8205,4109,4096,39.7,"MULTIPOLYGON(((18.99298471119233 69.6328832191365,19.001407042452332 69.67761195552053,19.130071374924885 69.6746308280938,19.12138006898974 69.62990920106019,18.99298471119233 69.6328832191365)))"
26700007730000,10,6,4,54.5,"MULTIPOLYGON(((19.378052764741224 69.6236795778328,19.387281242392945 69.66838631950463,19.515824380737655 69.6651230401333,19.506327721502608 69.62042407383755,19.378052764741224 69.6236795778328)))"
26750007730000,70,37,33,47.8,"MULTIPOLYGON(((19.506327721502608 69.62042407383755,19.515824380737655 69.6651230401333,19.644324728333775 69.66176581440578,19.634560167294616 69.6170748448441,19.506327721502608 69.62042407383755)))"
26850007730000,100,50,50,45.2,"MULTIPOLYGON(((19.762748917472422 69.61363194515337,19.7727810928727 69.65831469696354,19.90119228457155 69.65476974393961,19.890892789889527 69.61009543054885,19.762748917472422 69.61363194515337)))"
26900007730000,19,10,9,46.2,"MULTIPOLYGON(((19.890892789889527 69.61009543054885,19.90119228457155 69.65476974393961,20.0295571162387 69.65113101295476,20.018990604962653 69.60646535829258,19.890892789889527 69.61009543054885)))"
27050007730000,41,21,20,52.1,"MULTIPOLYGON(((20.275043357946515 69.59892477724269,20.28614296405855 69.64357245499973,20.41436161936915 69.63965275067305,20.402995950085383 69.59501439033043,20.275043357946515 69.59892477724269)))"
27100007730000,241,115,126,49.5,"MULTIPOLYGON(((20.402995950085383 69.59501439033043,20.41436161936915 69.63965275067305,20.54252919309232 69.635639513664,20.530897793463645 69.59101068952083,20.402995950085383 69.59501439033043)))"
27150007730000,118,59,59,42.1,"MULTIPOLYGON(((20.530897793463645 69.59101068952083,20.54252919309232 69.635639513664,20.67064451196292 69.63153280896985,20.65874772227403 69.58691373940792,20.530897793463645 69.59101068952083)))"
27400007730000,26,18,8,42.8,"MULTIPOLYGON(((21.169605080050367 69.56959478857996,21.18255987911228 69.6141726643695,21.310396431111506 69.60959964722515,21.29717805413539 69.56503261157215,21.169605080050367 69.56959478857996)))"
28350007730000,8,4,4,29.6,"MULTIPOLYGON(((23.58233431365987 69.46711705570797,23.600224523858298 69.51145255172514,23.72674239475211 69.50512584912504,23.70859710601128 69.46080520585306,23.58233431365987 69.46711705570797)))"
28550007730000,1,1,0,0,"MULTIPOLYGON(((24.086901518516907 69.44132300914731,24.105808928893605 69.48559786311533,24.231998506692403 69.47890625040233,24.21283811504791 69.43464706782294,24.086901518516907 69.44132300914731)))"
28750007730000,1,1,0,0,"MULTIPOLYGON(((24.59013848553596 69.4140750807171,24.61005455509949 69.45828603315788,24.735898829817284 69.45123119370514,24.71573197688605 69.4070367211383,24.59013848553596 69.4140750807171)))"
28900007730000,2,1,1,0,"MULTIPOLYGON(((24.966652773920902 69.39268911240927,24.98731949303476 69.43685002445251,25.112893806917477 69.42952391915416,25.091978017029962 69.38538008641497,24.966652773920902 69.39268911240927)))"
28950007730000,18,10,8,61.2,"MULTIPOLYGON(((25.091978017029962 69.38538008641497,25.112893806917477 69.42952391915416,25.238376067333085 69.42210761849991,25.217211789494122 69.37798106351809,25.091978017029962 69.38538008641497)))"
26250007735000,2,1,1,0,"MULTIPOLYGON(((18.228665309332314 69.69351997505153,18.235499583548116 69.73828615186483,18.364645365353955 69.73586480693388,18.357539526682 69.69110442383153,18.228665309332314 69.69351997505153)))"
26350007735000,147,77,70,38.1,"MULTIPOLYGON(((18.486381786730018 69.6885945021993,18.493758978316077 69.73334886664726,18.62283920245393 69.73073837232212,18.615190877442735 69.68599025121271,18.486381786730018 69.6885945021993)))"
26400007735000,901,469,432,38.1,"MULTIPOLYGON(((18.615190877442735 69.68599025121271,18.62283920245393 69.73073837232212,18.751884819728755 69.72803336680737,18.743965588707123 69.68329171345187,18.615190877442735 69.68599025121271)))"
26450007735000,4547,2321,2226,35.1,"MULTIPOLYGON(((18.743965588707123 69.68329171345187,18.751884819728755 69.72803336680737,18.880894614112822 69.72523389448051,18.872704712399223 69.680498933016,18.743965588707123 69.68329171345187)))"
26500007735000,12396,6133,6263,38.2,"MULTIPOLYGON(((18.872704712399223 69.680498933016,18.880894614112822 69.72523389448051,19.009867371658345 69.72234000124462,19.001407042452332 69.67761195552053,18.872704712399223 69.680498933016)))"
26550007735000,5277,2680,2597,39,"MULTIPOLYGON(((19.001407042452332 69.67761195552053,19.009867371658345 69.72234000124462,19.138801880566103 69.71935173452512,19.130071374924885 69.6746308280938,19.001407042452332 69.67761195552053)))"
26750007735000,6,4,2,61.7,"MULTIPOLYGON(((19.515824380737655 69.6651230401333,19.525363831131276 69.70982119048296,19.65413327285109 69.70645593441049,19.644324728333775 69.66176581440578,19.515824380737655 69.6651230401333)))"
26800007735000,1,0,1,0,"MULTIPOLYGON(((19.644324728333775 69.66176581440578,19.65413327285109 69.70645593441049,19.782858441544953 69.70299656469585,19.7727810928727 69.65831469696354,19.644324728333775 69.66176581440578)))"
26850007735000,31,17,14,51.2,"MULTIPOLYGON(((19.7727810928727 69.65831469696354,19.782858441544953 69.70299656469585,19.911538139728027 69.6994431378247,19.90119228457155 69.65476974393961,19.7727810928727 69.65831469696354)))"
27000007735000,33,20,13,56.1,"MULTIPOLYGON(((20.157874403339 69.64739856311346,20.168756347786818 69.69205434603572,20.297292476054505 69.68821910155707,20.28614296405855 69.64357245499973,20.157874403339 69.64739856311346)))"
27050007735000,28,15,13,54.8,"MULTIPOLYGON(((20.28614296405855 69.64357245499973,20.297292476054505 69.68821910155707,20.425778370725922 69.68429004079192,20.41436161936915 69.63965275067305,20.28614296405855 69.64357245499973)))"
27100007735000,30,13,17,50.3,"MULTIPOLYGON(((20.41436161936915 69.63965275067305,20.425778370725922 69.68429004079192,20.55421284806967 69.68026722766862,20.54252919309232 69.635639513664,20.41436161936915 69.63965275067305)))"
27400007735000,34,16,18,46.2,"MULTIPOLYGON(((21.18255987911228 69.6141726643695,21.195572754002256 69.65874921720872,21.323674038398256 69.65416531474365,21.310396431111506 69.60959964722515,21.18255987911228 69.6141726643695)))"
27450007735000,3,2,1,0,"MULTIPOLYGON(((21.310396431111506 69.60959964722515,21.323674038398256 69.65416531474365,21.451715705358914 69.64948814847556,21.438173753357912 69.60493358292277,21.310396431111506 69.60959964722515)))"
28950007735000,2,1,1,0,"MULTIPOLYGON(((25.112893806917477 69.42952391915416,25.133901651091914 69.47366464575231,25.259633424566143 69.46623099745804,25.238376067333085 69.42210761849991,25.112893806917477 69.42952391915416)))"
29000007735000,59,35,24,41.3,"MULTIPOLYGON(((25.238376067333085 69.42210761849991,25.259633424566143 69.46623099745804,25.38527152579452 69.45870707070566,25.363765249181608 69.41460123786611,25.238376067333085 69.42210761849991)))"
29050007735000,209,120,89,40,"MULTIPOLYGON(((25.363765249181608 69.41460123786611,25.38527152579452 69.45870707070566,25.510814928753078 69.45109298281002,25.48906033232509 69.40700489386617,25.363765249181608 69.41460123786611)))"
29150007735000,23,11,12,36,"MULTIPOLYGON(((25.614260301630217 69.39931870434299,25.63626261247463 69.44338885232189,25.761613561091192 69.43559479902042,25.739364147010388 69.39154278836148,25.614260301630217 69.39931870434299)))"
29200007735000,72,34,38,39.9,"MULTIPOLYGON(((25.739364147010388 69.39154278836148,25.761613561091192 69.43559479902042,25.886866763875695 69.42771094390555,25.864370863467123 69.38367726620108,25.739364147010388 69.39154278836148)))"
26300007740000,62,29,33,56.3,"MULTIPOLYGON(((18.364645365353955 69.73586480693388,18.371783373181678 69.78062463344583,18.50116955905006 69.77810264903907,18.493758978316077 69.73334886664726,18.364645365353955 69.73586480693388)))"
26350007740000,10,5,5,68.1,"MULTIPOLYGON(((18.493758978316077 69.73334886664726,18.50116955905006 69.77810264903907,18.630522134663334 69.77548588496995,18.62283920245393 69.73073837232212,18.493758978316077 69.73334886664726)))"
26400007740000,1,1,0,0,"MULTIPOLYGON(((18.62283920245393 69.73073837232212,18.630522134663334 69.77548588496995,18.75983987398781 69.77277438435844,18.751884819728755 69.72803336680737,18.62283920245393 69.73073837232212)))"
26500007740000,71,37,34,47.7,"MULTIPOLYGON(((18.880894614112822 69.72523389448051,18.889121553023067 69.76996819186276,19.018365949871615 69.76706735367617,19.009867371658345 69.72234000124462,18.880894614112822 69.72523389448051)))"
26550007740000,407,211,196,39.3,"MULTIPOLYGON(((19.009867371658345 69.72234000124462,19.018365949871615 69.76706735367617,19.14757184480826 69.76407191752374,19.138801880566103 69.71935173452512,19.009867371658345 69.72234000124462)))"
26600007740000,464,234,230,37.2,"MULTIPOLYGON(((19.138801880566103 69.71935173452512,19.14757184480826 69.76407191752374,19.27673802034915 69.7609819326589,19.267696931253745 69.71626914326639,19.138801880566103 69.71935173452512)))"
26800007740000,5,2,3,15.2,"MULTIPOLYGON(((19.65413327285109 69.70645593441049,19.663986090819947 69.75114520117724,19.792981261164627 69.74767754444201,19.782858441544953 69.70299656469585,19.65413327285109 69.70645593441049)))"
26850007740000,49,26,23,55.1,"MULTIPOLYGON(((19.782858441544953 69.70299656469585,19.792981261164627 69.74767754444201,19.921930660708043 69.7441156080627,19.911538139728027 69.6994431378247,19.782858441544953 69.70299656469585)))"
27100007740000,48,19,29,43.1,"MULTIPOLYGON(((20.425778370725922 69.68429004079192,20.437246539901253 69.7289262555559,20.565949101662447 69.72489382614197,20.55421284806967 69.68026722766862,20.425778370725922 69.68429004079192)))"
27350007740000,17,6,11,43.8,"MULTIPOLYGON(((21.06741301395973 69.66323978171165,21.080218067165934 69.70782571763786,21.20864408509242 69.70332444031376,21.195572754002256 69.65874921720872,21.06741301395973 69.66323978171165)))"
27400007740000,109,57,52,50.9,"MULTIPOLYGON(((21.195572754002256 69.65874921720872,21.20864408509242 69.70332444031376,21.337011263684218 69.6987296070492,21.323674038398256 69.65416531474365,21.195572754002256 69.65874921720872)))"
28300007740000,4,0,4,0,"MULTIPOLYGON(((23.49134019165555 69.56203565094297,23.509131914888027 69.60638125025847,23.63624360388775 69.6001165546385,23.618194116400637 69.55578572245253,23.49134019165555 69.56203565094297)))"
28650007740000,6,3,3,47,"MULTIPOLYGON(((24.37760197660311 69.51636427588441,24.397186964228943 69.56060216401058,24.523712955838597 69.55369637162026,24.503873959371482 69.5094746917947,24.37760197660311 69.51636427588441)))"
29050007740000,1438,712,726,42.4,"MULTIPOLYGON(((25.38527152579452 69.45870707070566,25.406872501520084 69.50280963785175,25.532665245267957 69.49517773430892,25.510814928753078 69.45109298281002,25.38527152579452 69.45870707070566)))"
29100007740000,608,301,307,45.3,"MULTIPOLYGON(((25.510814928753078 69.45109298281002,25.532665245267957 69.49517773430892,25.658361659280885 69.4874555903976,25.63626261247463 69.44338885232189,25.510814928753078 69.45109298281002)))"
29150007740000,13,7,6,55.6,"MULTIPOLYGON(((25.63626261247463 69.44338885232189,25.658361659280885 69.4874555903976,25.783960721867746 69.47964332661702,25.761613561091192 69.43559479902042,25.63626261247463 69.44338885232189)))"
29200007740000,9,4,5,62.8,"MULTIPOLYGON(((25.761613561091192 69.43559479902042,25.783960721867746 69.47964332661702,25.9094614165318 69.47174106469345,25.886866763875695 69.42771094390555,25.761613561091192 69.43559479902042)))"
30550007740000,16,10,6,58.4,"MULTIPOLYGON(((29.105957672826662 69.1916345343276,29.134751171449196 69.23511968494063,29.257231716388237 69.22483774864573,29.228209500000286 69.18137601023835,29.105957672826662 69.1916345343276)))"
26300007745000,29,17,12,58.3,"MULTIPOLYGON(((18.371783373181678 69.78062463344583,18.378953763583034 69.82538390161494,18.508613750366365 69.82285584745324,18.50116955905006 69.77810264903907,18.371783373181678 69.78062463344583)))"
26350007745000,15,8,7,56.4,"MULTIPOLYGON(((18.50116955905006 69.77810264903907,18.508613750366365 69.82285584745324,18.63823990350041 69.82023278705942,18.630522134663334 69.77548588496995,18.50116955905006 69.77810264903907)))"
26400007745000,69,31,38,44.4,"MULTIPOLYGON(((18.630522134663334 69.77548588496995,18.63823990350041 69.82023278705942,18.767830988886576 69.81751476382699,18.75983987398781 69.77277438435844,18.630522134663334 69.77548588496995)))"
26450007745000,80,40,40,39,"MULTIPOLYGON(((18.75983987398781 69.77277438435844,18.767830988886576 69.81751476382699,18.897385774482082 69.81470182269723,18.889121553023067 69.76996819186276,18.75983987398781 69.77277438435844)))"
26500007745000,63,30,33,41.1,"MULTIPOLYGON(((18.889121553023067 69.76996819186276,18.897385774482082 69.81470182269723,19.026903030370356 69.81179401015613,19.018365949871615 69.76706735367617,18.889121553023067 69.76996819186276)))"
26550007745000,159,85,74,42.7,"MULTIPOLYGON(((19.018365949871615 69.76706735367617,19.026903030370356 69.81179401015613,19.156381528831183 69.808791374231,19.14757184480826 69.76407191752374,19.018365949871615 69.76706735367617)))"
26600007745000,82,42,40,48,"MULTIPOLYGON(((19.14757184480826 69.76407191752374,19.156381528831183 69.808791374231,19.285820044410492 69.8056939644871,19.27673802034915 69.7609819326589,19.14757184480826 69.76407191752374)))"
26650007745000,279,133,146,36.8,"MULTIPOLYGON(((19.27673802034915 69.7609819326589,19.285820044410492 69.8056939644871,19.41521735398983 69.80250183202403,19.405863261320516 69.75779744986006,19.27673802034915 69.7609819326589)))"
26700007745000,107,58,49,43,"MULTIPOLYGON(((19.405863261320516 69.75779744986006,19.41521735398983 69.80250183202403,19.544572236855487 69.79921502947228,19.534946354927047 69.75451852142703,19.405863261320516 69.75779744986006)))"
26750007745000,23,12,11,54,"MULTIPOLYGON(((19.534946354927047 69.75451852142703,19.544572236855487 69.79921502947228,19.673883474767283 69.79583361098936,19.663986090819947 69.75114520117724,19.534946354927047 69.75451852142703)))"
26800007745000,74,45,29,42.8,"MULTIPOLYGON(((19.663986090819947 69.75114520117724,19.673883474767283 69.79583361098936,19.803149852026987 69.79235763225607,19.792981261164627 69.74767754444201,19.663986090819947 69.75114520117724)))"
26850007745000,31,17,14,48.3,"MULTIPOLYGON(((19.792981261164627 69.74767754444201,19.803149852026987 69.79235763225607,19.932370155546383 69.78878715047253,19.921930660708043 69.7441156080627,19.792981261164627 69.74767754444201)))"
26900007745000,13,7,6,41,"MULTIPOLYGON(((19.921930660708043 69.7441156080627,19.932370155546383 69.78878715047253,20.061543174914938 69.78512222435408,20.050833086845646 69.7404594503867,19.921930660708043 69.7441156080627)))"
27100007745000,136,74,62,51,"MULTIPOLYGON(((20.437246539901253 69.7289262555559,20.448766465585987 69.77356138978547,20.577738300146585 69.76951930364062,20.565949101662447 69.72489382614197,20.437246539901253 69.7289262555559)))"
27200007745000,1,1,0,0,"MULTIPOLYGON(((20.694598719039288 69.72076748961187,20.706656841010297 69.7653830893191,20.835520895231774 69.76115281453774,20.823194206702578 69.71654731325975,20.694598719039288 69.72076748961187)))"
27300007745000,218,119,99,41,"MULTIPOLYGON(((20.951734382429223 69.71223336585508,20.964329273005795 69.75682854849768,21.093080787731648 69.75241036187943,21.080218067165934 69.70782571763786,20.951734382429223 69.71223336585508)))"
27350007745000,156,87,69,46.2,"MULTIPOLYGON(((21.080218067165934 69.70782571763786,21.093080787731648 69.75241036187943,21.221774256076976 69.74789832683808,21.20864408509242 69.70332444031376,21.080218067165934 69.70782571763786)))"
27400007745000,95,50,45,40,"MULTIPOLYGON(((21.20864408509242 69.70332444031376,21.221774256076976 69.74789832683808,21.350408498041258 69.74329251699818,21.337011263684218 69.6987296070492,21.20864408509242 69.70332444031376)))"
28250007745000,3,2,1,0,"MULTIPOLYGON(((23.381940913324986 69.61255395051674,23.399552572193386 69.65691187761335,23.52700295141583 69.65072455853148,23.509131914888027 69.60638125025847,23.381940913324986 69.61255395051674)))"
29200007745000,8,3,5,43.5,"MULTIPOLYGON(((25.783960721867746 69.47964332661702,25.806406251439757 69.52368835055411,25.932155449251063 69.51576760750758,25.9094614165318 69.47174106469345,25.783960721867746 69.47964332661702)))"
30550007745000,5,3,2,65.6,"MULTIPOLYGON(((29.134751171449196 69.23511968494063,29.163668385545535 69.27859910045294,29.286378504954143 69.26829366114035,29.257231716388237 69.22483774864573,29.134751171449196 69.23511968494063)))"
26300007750000,3,1,2,0,"MULTIPOLYGON(((18.378953763583034 69.82538390161494,18.38615675186903 69.87014260967013,18.516091775662805 69.86760845994807,18.508613750366365 69.82285584745324,18.378953763583034 69.82538390161494)))"
26350007750000,73,38,35,51.1,"MULTIPOLYGON(((18.508613750366365 69.82285584745324,18.516091775662805 69.86760845994807,18.645992740428 69.86497907647208,18.63823990350041 69.82023278705942,18.508613750366365 69.82285584745324)))"
26400007750000,1,1,0,0,"MULTIPOLYGON(((18.63823990350041 69.82023278705942,18.645992740428 69.86497907647208,18.775858403930393 69.86225450291153,18.767830988886576 69.81751476382699,18.63823990350041 69.82023278705942)))"
26450007750000,217,112,105,37.5,"MULTIPOLYGON(((18.767830988886576 69.81751476382699,18.775858403930393 69.86225450291153,18.905687526014393 69.85943478449335,18.897385774482082 69.81470182269723,18.767830988886576 69.81751476382699)))"
26500007750000,58,30,28,50.1,"MULTIPOLYGON(((18.897385774482082 69.81470182269723,18.905687526014393 69.85943478449335,19.035478868674247 69.85651996799875,19.026903030370356 69.81179401015613,18.897385774482082 69.81470182269723)))"
26550007750000,1,1,0,0,"MULTIPOLYGON(((19.026903030370356 69.81179401015613,19.035478868674247 69.85651996799875,19.165231196124903 69.8535101017599,19.156381528831183 69.808791374231,19.026903030370356 69.81179401015613)))"
26650007750000,1,1,0,0,"MULTIPOLYGON(((19.285820044410492 69.8056939644871,19.29494327487261 69.85040523565655,19.424613873785095 69.8472054211124,19.41521735398983 69.80250183202403,19.285820044410492 69.8056939644871)))"
26700007750000,22,13,9,54.3,"MULTIPOLYGON(((19.41521735398983 69.80250183202403,19.424613873785095 69.8472054211124,19.55424176416146 69.84391071109145,19.544572236855487 69.79921502947228,19.41521735398983 69.80250183202403)))"
26900007750000,202,103,99,50.2,"MULTIPOLYGON(((19.932370155546383 69.78878715047253,19.942856934993078 69.83345776083303,20.072301755269283 69.82978402921755,20.061543174914938 69.78512222435408,19.932370155546383 69.78878715047253)))"
27100007750000,40,20,20,52.3,"MULTIPOLYGON(((20.448766465585987 69.77356138978547,20.460338489448603 69.81819543825233,20.589580792840177 69.81414365467012,20.577738300146585 69.76951930364062,20.448766465585987 69.77356138978547)))"
27150007750000,162,83,79,43.9,"MULTIPOLYGON(((20.577738300146585 69.76951930364062,20.589580792840177 69.81414365467012,20.71876945014692 69.8099975209465,20.706656841010297 69.7653830893191,20.577738300146585 69.76951930364062)))"
27200007750000,93,50,43,40.9,"MULTIPOLYGON(((20.706656841010297 69.7653830893191,20.71876945014692 69.8099975209465,20.84790326074252 69.80575710522467,20.835520895231774 69.76115281453774,20.706656841010297 69.7653830893191)))"
27250007750000,806,401,405,42.1,"MULTIPOLYGON(((20.835520895231774 69.76115281453774,20.84790326074252 69.80575710522467,20.976981027175295 69.80142247714113,20.964329273005795 69.75682854849768,20.835520895231774 69.76115281453774)))"
27300007750000,2076,1010,1066,41.4,"MULTIPOLYGON(((20.964329273005795 69.75682854849768,20.976981027175295 69.80142247714113,21.106001555233192 69.79699370782076,21.093080787731648 69.75241036187943,20.964329273005795 69.75682854849768)))"
27350007750000,3,1,2,0,"MULTIPOLYGON(((21.093080787731648 69.75241036187943,21.106001555233192 69.79699370782076,21.23496365400839 69.79247086987188,21.221774256076976 69.74789832683808,21.093080787731648 69.75241036187943)))"
27650007750000,14,6,8,42.9,"MULTIPOLYGON(((21.864329722202463 69.72393305328833,21.878856266198394 69.76844829518384,22.00744297326233 69.76336265265977,21.992650253246566 69.71885952489387,21.864329722202463 69.72393305328833)))"
27700007750000,32,14,18,53.6,"MULTIPOLYGON(((21.992650253246566 69.71885952489387,22.00744297326233 69.76336265265977,22.135963012528507 69.75818349086364,22.12090455136589 69.71369269401517,21.992650253246566 69.71885952489387)))"
27750007750000,10,5,5,45.6,"MULTIPOLYGON(((22.12090455136589 69.71369269401517,22.135963012528507 69.75818349086364,22.264415221788695 69.75291089408084,22.24909146161793 69.70843264441501,22.12090455136589 69.71369269401517)))"
28600007750000,2,2,0,0,"MULTIPOLYGON(((24.28999032523013 69.61166791243221,24.309492977373953 69.65591645329926,24.436618226128633 69.64906972355261,24.416858860572045 69.60483731854139,24.28999032523013 69.61166791243221)))"
29000007750000,1,0,1,0,"MULTIPOLYGON(((25.302429756978118 69.55446815261732,25.323969934626174 69.59858189106775,25.45036097394078 69.59100489794086,25.428568780988734 69.54690892006563,25.302429756978118 69.55446815261732)))"
29200007750000,8,4,4,30.3,"MULTIPOLYGON(((25.806406251439757 69.52368835055411,25.828950777142996 69.56772985005577,25.954949495125938 69.55979055110832,25.932155449251063 69.51576760750758,25.806406251439757 69.52368835055411)))"
30550007750000,2,1,1,0,"MULTIPOLYGON(((29.163668385545535 69.27859910045294,29.192710077876416 69.32207274651239,29.31565063265106 69.31174371283309,29.286378504954143 69.26829366114035,29.163668385545535 69.27859910045294)))"
26350007755000,6,4,2,34,"MULTIPOLYGON(((18.516091775662805 69.86760845994807,18.523603860322357 69.91236048456133,18.65378087896484 69.90972475106736,18.645992740428 69.86497907647208,18.516091775662805 69.86760845994807)))"
26450007755000,15,9,6,57.2,"MULTIPOLYGON(((18.775858403930393 69.86225450291153,18.783922360750914 69.90699359928698,18.914027057340977 69.9041670747352,18.905687526014393 69.85943478449335,18.775858403930393 69.86225450291153)))"
26500007755000,26,12,14,40.2,"MULTIPOLYGON(((18.905687526014393 69.85943478449335,18.914027057340977 69.9041670747352,19.044093722569208 69.9012452244911,19.035478868674247 69.85651996799875,18.905687526014393 69.85943478449335)))"
26650007755000,6,3,3,47.8,"MULTIPOLYGON(((19.29494327487261 69.85040523565655,19.304107985575193 69.89511574304208,19.4340531025333 69.8919082137847,19.424613873785095 69.8472054211124,19.29494327487261 69.85040523565655)))"
26700007755000,11,7,4,57.7,"MULTIPOLYGON(((19.424613873785095 69.8472054211124,19.4340531025333 69.8919082137847,19.563955226631897 69.88860556272274,19.55424176416146 69.84391071109145,19.424613873785095 69.8472054211124)))"
26750007755000,15,8,7,59.9,"MULTIPOLYGON(((19.55424176416146 69.84391071109145,19.563955226631897 69.88860556272274,19.693813123642013 69.8852078447028,19.683825719801725 69.84052116009427,19.55424176416146 69.84391071109145)))"
26900007755000,48,26,22,57.4,"MULTIPOLYGON(((19.942856934993078 69.83345776083303,19.953391312543246 69.87812743488243,20.08310914924691 69.87444486047006,20.072301755269283 69.82978402921755,19.942856934993078 69.83345776083303)))"
27100007755000,7,4,3,63.9,"MULTIPOLYGON(((20.460338489448603 69.81819543825233,20.471962956167804 69.86282839567878,20.6014769321368 69.8587668736842,20.589580792840177 69.81414365467012,20.460338489448603 69.81819543825233)))"
27200007755000,85,47,38,46.7,"MULTIPOLYGON(((20.71876945014692 69.8099975209465,20.730936906523798 69.85461077867357,20.860341670956043 69.85036017922015,20.84790326074252 69.80575710522467,20.71876945014692 69.8099975209465)))"
27250007755000,18,8,10,50.4,"MULTIPOLYGON(((20.84790326074252 69.80575710522467,20.860341670956043 69.85036017922015,20.989690020270366 69.84601514539952,20.976981027175295 69.80142247714113,20.84790326074252 69.80575710522467)))"
27300007755000,77,42,35,40.8,"MULTIPOLYGON(((20.976981027175295 69.80142247714113,20.989690020270366 69.84601514539952,21.11898075257884 69.84157574878473,21.106001555233192 69.79699370782076,20.976981027175295 69.80142247714113)))"
27350007755000,42,26,16,43.5,"MULTIPOLYGON(((21.106001555233192 69.79699370782076,21.11898075257884 69.84157574878473,21.24821266933405 69.83704206244127,21.23496365400839 69.79247086987188,21.106001555233192 69.79699370782076)))"
27450007755000,10,6,4,39.2,"MULTIPOLYGON(((21.363866135961338 69.78785403738112,21.377384575393823 69.83241416092189,21.50649527908553 69.8276921202614,21.492707816984392 69.78314328590841,21.363866135961338 69.78785403738112)))"
27650007755000,7,4,3,43.9,"MULTIPOLYGON(((21.878856266198394 69.76844829518384,21.893448312604537 69.81296194590057,22.02230236170971 69.80786413847748,22.00744297326233 69.76336265265977,21.878856266198394 69.76844829518384)))"
27700007755000,35,16,19,56.1,"MULTIPOLYGON(((22.00744297326233 69.76336265265977,22.02230236170971 69.80786413847748,22.15108930434098 69.80267259412922,22.135963012528507 69.75818349086364,22.00744297326233 69.76336265265977)))"
28550007755000,1,1,0,0,"MULTIPOLYGON(((24.18228077895606 69.66267139531327,24.20161202046387 69.7069332322982,24.329082579980366 69.70016229496787,24.309492977373953 69.65591645329926,24.18228077895606 69.66267139531327)))"
30550007755000,1,1,0,0,"MULTIPOLYGON(((29.192710077876416 69.32207274651239,29.221877017361095 69.3655405884792,29.34504887261298 69.35518786854308,29.31565063265106 69.31174371283309,29.192710077876416 69.32207274651239)))"
30600007755000,2,1,1,0,"MULTIPOLYGON(((29.31565063265106 69.31174371283309,29.34504887261298 69.35518786854308,29.468093837274548 69.34474849962857,29.438465076200977 69.30132820548765,29.31565063265106 69.31174371283309)))"
26700007760000,213,114,99,44.3,"MULTIPOLYGON(((19.4340531025333 69.8919082137847,19.443535324562475 69.93661020666761,19.57371291662391 69.93329958076953,19.563955226631897 69.88860556272274,19.4340531025333 69.8919082137847)))"
26800007760000,21,10,11,63,"MULTIPOLYGON(((19.693813123642013 69.8852078447028,19.703845986645888 69.92989366098898,19.833933294927974 69.92639250407339,19.82362556193324 69.88171511611371,19.693813123642013 69.8852078447028)))"
26900007760000,13,8,5,53,"MULTIPOLYGON(((19.953391312543246 69.87812743488243,19.963973604467427 69.92279616831797,20.09396568102909 69.91910471356154,20.08310914924691 69.87444486047006,19.953391312543246 69.87812743488243)))"
26950007760000,269,144,125,48.6,"MULTIPOLYGON(((20.08310914924691 69.87444486047006,20.09396568102909 69.91910471356154,20.22390829321487 69.91531820118213,20.212777848625088 69.87066745386753,20.08310914924691 69.87444486047006)))"
27150007760000,11,5,6,53.9,"MULTIPOLYGON(((20.6014769321368 69.8587668736842,20.61342707353935 69.90338895508442,20.743159573390365 69.89922285662527,20.730936906523798 69.85461077867357,20.6014769321368 69.8587668736842)))"
27200007760000,47,19,28,44,"MULTIPOLYGON(((20.730936906523798 69.85461077867357,20.743159573390365 69.89922285662527,20.872836496833397 69.89496203036673,20.860341670956043 69.85036017922015,20.730936906523798 69.85461077867357)))"
27250007760000,19,10,9,61.7,"MULTIPOLYGON(((20.860341670956043 69.85036017922015,20.872836496833397 69.89496203036673,21.00245663092805 69.89060654682727,20.989690020270366 69.84601514539952,20.860341670956043 69.85036017922015)))"
27300007760000,57,29,28,37.4,"MULTIPOLYGON(((20.989690020270366 69.84601514539952,21.00245663092805 69.89060654682727,21.132018766045313 69.88615647803208,21.11898075257884 69.84157574878473,20.989690020270366 69.84601514539952)))"
27350007760000,146,78,68,43.4,"MULTIPOLYGON(((21.11898075257884 69.84157574878473,21.132018766045313 69.88615647803208,21.26152169593341 69.88161189750767,21.24821266933405 69.83704206244127,21.11898075257884 69.84157574878473)))"
27450007760000,21,14,7,62,"MULTIPOLYGON(((21.377384575393823 69.83241416092189,21.390964217783285 69.87697288027695,21.520345132293524 69.87223950285383,21.50649527908553 69.8276921202614,21.377384575393823 69.83241416092189)))"
27600007760000,63,34,29,56,"MULTIPOLYGON(((21.76452833040397 69.81796593303488,21.778917360013804 69.86248998090863,21.90810629273665 69.85747399682066,21.893448312604537 69.81296194590057,21.76452833040397 69.81796593303488)))"
27650007760000,111,58,53,44.7,"MULTIPOLYGON(((21.893448312604537 69.81296194590057,21.90810629273665 69.85747399682066,22.037228857271757 69.85236397339715,22.02230236170971 69.80786413847748,21.893448312604537 69.81296194590057)))"
27700007760000,15,7,8,42.5,"MULTIPOLYGON(((22.02230236170971 69.80786413847748,22.037228857271757 69.85236397339715,22.166283872812233 69.8471599945246,22.15108930434098 69.80267259412922,22.02230236170971 69.80786413847748)))"
28500007760000,2,2,0,0,"MULTIPOLYGON(((24.074055043005295 69.7136120664959,24.093212684877205 69.75788710750294,24.221029680713222 69.75119242033148,24.20161202046387 69.7069332322982,24.074055043005295 69.7136120664959)))"
29200007760000,2,1,1,0,"MULTIPOLYGON(((25.85159493160374 69.61176780416518,25.874339352793942 69.65580219174285,26.000840185425776 69.64782555478567,25.97784419258045 69.60380987407127,25.85159493160374 69.61176780416518)))"
30650007760000,11,4,7,43,"MULTIPOLYGON(((29.468093837274548 69.34474849962857,29.497850353034185 69.3881627693506,29.620998158354308 69.3776127783848,29.591011048304242 69.33422263812791,29.468093837274548 69.34474849962857)))"
30700007760000,32,15,17,47.3,"MULTIPOLYGON(((29.591011048304242 69.33422263812791,29.620998158354308 69.3776127783848,29.7440165593243 69.36697627818106,29.71379964898551 69.32361044141878,29.591011048304242 69.33422263812791)))"
26400007765000,6,4,2,66.7,"MULTIPOLYGON(((18.66160455470841 69.95446980868236,18.66946400535805 69.99921424713169,18.800160877022325 69.99646985448994,18.79202310312974 69.95173205060422,18.66160455470841 69.95446980868236)))"
26550007765000,45,19,26,51.2,"MULTIPOLYGON(((19.052747852132565 69.945969776893,19.061441519758475 69.9906936224365,19.19202276772265 69.98766187997035,19.183051546189354 69.94294535758944,19.052747852132565 69.945969776893)))"
26600007765000,5,4,1,63.4,"MULTIPOLYGON(((19.183051546189354 69.94294535758944,19.19202276772265 69.98766187997035,19.322562955244972 69.98453445380535,19.313314452789427 69.93982548348754,19.183051546189354 69.94294535758944)))"
26650007765000,4,2,2,0,"MULTIPOLYGON(((19.313314452789427 69.93982548348754,19.322562955244972 69.98453445380535,19.45306082672939 69.98131139635444,19.443535324562475 69.93661020666761,19.313314452789427 69.93982548348754)))"
26700007765000,98,52,46,44.6,"MULTIPOLYGON(((19.443535324562475 69.93661020666761,19.45306082672939 69.98131139635444,19.583515129093293 69.97799276159988,19.57371291662391 69.93329958076953,19.443535324562475 69.93661020666761)))"
26750007765000,611,309,302,44.8,"MULTIPOLYGON(((19.57371291662391 69.93329958076953,19.583515129093293 69.97799276159988,19.71392461183928 69.97457860508946,19.703845986645888 69.92989366098898,19.57371291662391 69.93329958076953)))"
26800007765000,13,6,7,64.8,"MULTIPOLYGON(((19.703845986645888 69.92989366098898,19.71392461183928 69.97457860508946,19.84428802712661 69.97106898393241,19.833933294927974 69.92639250407339,19.703845986645888 69.92989366098898)))"
26850007765000,2,1,1,0,"MULTIPOLYGON(((19.833933294927974 69.92639250407339,19.84428802712661 69.97106898393241,19.97460412984225 69.96746395679534,19.963973604467427 69.92279616831797,19.833933294927974 69.92639250407339)))"
26950007765000,89,46,43,54.1,"MULTIPOLYGON(((20.09396568102909 69.91910471356154,20.104871677671518 69.96376358389809,20.235089431168305 69.95996792700927,20.22390829321487 69.91531820118213,20.09396568102909 69.91910471356154)))"
27150007765000,2,1,1,0,"MULTIPOLYGON(((20.61342707353935 69.90338895508442,20.62543157569424 69.94800989321936,20.755437817205753 69.9438337488711,20.743159573390365 69.89922285662527,20.61342707353935 69.90338895508442)))"
27200007765000,8,3,5,68.4,"MULTIPOLYGON(((20.743159573390365 69.89922285662527,20.755437817205753 69.9438337488711,20.88538811261101 69.93956265244904,20.872836496833397 69.89496203036673,20.743159573390365 69.89922285662527)))"
27250007765000,60,31,29,50.6,"MULTIPOLYGON(((20.872836496833397 69.89496203036673,20.88538811261101 69.93956265244904,21.01528124112603 69.93519667491853,21.00245663092805 69.89060654682727,20.872836496833397 69.89496203036673)))"
27350007765000,38,21,17,51.9,"MULTIPOLYGON(((21.132018766045313 69.88615647803208,21.145115985314742 69.9307358887606,21.27489113115561 69.92618036796698,21.26152169593341 69.88161189750767,21.132018766045313 69.88615647803208)))"
27400007765000,185,100,85,45.4,"MULTIPOLYGON(((21.26152169593341 69.88161189750767,21.27489113115561 69.92618036796698,21.40460546810774 69.92153018803472,21.390964217783285 69.87697288027695,21.26152169593341 69.88161189750767)))"
27450007765000,28,16,12,51.3,"MULTIPOLYGON(((21.390964217783285 69.87697288027695,21.40460546810774 69.92153018803472,21.534257789176497 69.9167854259609,21.520345132293524 69.87223950285383,21.390964217783285 69.87697288027695)))"
27500007765000,1,1,0,0,"MULTIPOLYGON(((21.520345132293524 69.87223950285383,21.534257789176497 69.9167854259609,21.663846890978633 69.91194616023724,21.649663243734803 69.86741184323783,21.520345132293524 69.87223950285383)))"
27550007765000,1,1,0,0,"MULTIPOLYGON(((21.649663243734803 69.86741184323783,21.663846890978633 69.91194616023724,21.793371573806862 69.90701247084452,21.778917360013804 69.86248998090863,21.649663243734803 69.86741184323783)))"
27600007765000,20,8,12,41.1,"MULTIPOLYGON(((21.778917360013804 69.86248998090863,21.793371573806862 69.90701247084452,21.922830641693945 69.90198443924702,21.90810629273665 69.85747399682066,21.778917360013804 69.86248998090863)))"
27650007765000,68,29,39,52.7,"MULTIPOLYGON(((21.90810629273665 69.85747399682066,21.922830641693945 69.90198443924702,22.052222902476196 69.8968621483867,22.037228857271757 69.85236397339715,21.90810629273665 69.85747399682066)))"
28200007765000,3,2,1,0,"MULTIPOLYGON(((23.32454644658927 69.79611074736256,23.342211687513355 69.84047427225482,23.470791537094787 69.83432102031394,23.452861912708784 69.78997214537479,23.32454644658927 69.79611074736256)))"
28250007765000,58,30,28,31.2,"MULTIPOLYGON(((23.452861912708784 69.78997214537479,23.470791537094787 69.83432102031394,23.59929059265064 69.82807461747316,23.581097110663045 69.78374060552797,23.452861912708784 69.78997214537479)))"
29200007765000,11,4,7,57.5,"MULTIPOLYGON(((25.874339352793942 69.65580219174285,25.897184684087048 69.69983299146462,26.0239381229163 69.6918375714521,26.000840185425776 69.64782555478567,25.874339352793942 69.65580219174285)))"
30700007765000,69,34,35,48.5,"MULTIPOLYGON(((29.620998158354308 69.3776127783848,29.65111467382259 69.42099676386655,29.774363729527995 69.4103358656232,29.7440165593243 69.36697627818106,29.620998158354308 69.3776127783848)))"
30750007765000,6,2,4,46.2,"MULTIPOLYGON(((29.7440165593243 69.36697627818106,29.774363729527995 69.4103358656232,29.89748172193623 69.39958844377979,29.86690470150091 69.35625342800306,29.7440165593243 69.36697627818106)))"
26350007770000,9,6,3,54.2,"MULTIPOLYGON(((18.538731119321195 70.00186276219044,18.54634675455232 70.04661301117729,18.67735947073845 70.04395806420708,18.66946400535805 69.99921424713169,18.538731119321195 70.00186276219044)))"
26400007770000,23,12,11,43.3,"MULTIPOLYGON(((18.66946400535805 69.99921424713169,18.67735947073845 70.04395806420708,18.80833593058223 70.04120700854641,18.800160877022325 69.99646985448994,18.66946400535805 69.99921424713169)))"
26500007770000,6,5,1,65,"MULTIPOLYGON(((18.93082046938972 69.99362963036403,18.93927486075706 70.03835989058983,19.07017499018377 70.03541675832571,19.061441519758475 69.9906936224365,18.93082046938972 69.99362963036403)))"
26550007770000,11,6,5,63.3,"MULTIPOLYGON(((19.061441519758475 69.9906936224365,19.07017499018377 70.03541675832571,19.201035050104686 70.0323776613327,19.19202276772265 69.98766187997035,19.061441519758475 69.9906936224365)))"
26600007770000,19,10,9,47.5,"MULTIPOLYGON(((19.19202276772265 69.98766187997035,19.201035050104686 70.0323776613327,19.331853774157327 70.02924265077628,19.322562955244972 69.98453445380535,19.19202276772265 69.98766187997035)))"
26650007770000,94,48,46,47.3,"MULTIPOLYGON(((19.322562955244972 69.98453445380535,19.331853774157327 70.02924265077628,19.462629898447716 70.02601177940491,19.45306082672939 69.98131139635444,19.322562955244972 69.98453445380535)))"
26700007770000,65,36,29,49.9,"MULTIPOLYGON(((19.45306082672939 69.98131139635444,19.462629898447716 70.02601177940491,19.593362161623382 70.02268510154624,19.583515129093293 69.97799276159988,19.45306082672939 69.98131139635444)))"
26750007770000,34,18,16,48.4,"MULTIPOLYGON(((19.583515129093293 69.97799276159988,19.593362161623382 70.02268510154624,19.72404930494595 70.01926267310328,19.71392461183928 69.97457860508946,19.583515129093293 69.97799276159988)))"
26800007770000,3,2,1,0,"MULTIPOLYGON(((19.71392461183928 69.97457860508946,19.72404930494595 70.01926267310328,19.854690072363333 70.0157445515502,19.84428802712661 69.97106898393241,19.71392461183928 69.97457860508946)))"
26850007770000,49,31,18,57.2,"MULTIPOLYGON(((19.84428802712661 69.97106898393241,19.854690072363333 70.0157445515502,19.98528321058156 70.01213079592831,19.97460412984225 69.96746395679534,19.84428802712661 69.97106898393241)))"
27150007770000,7,3,4,80.3,"MULTIPOLYGON(((20.62543157569424 69.94800989321936,20.63749080042615 69.99262968238413,20.76777200767422 69.9884434494247,20.755437817205753 69.9438337488711,20.62543157569424 69.94800989321936)))"
27250007770000,11,6,5,52.8,"MULTIPOLYGON(((20.88538811261101 69.93956265244904,20.89799689583687 69.98416203919346,21.028164236219414 69.97978552310646,21.01528124112603 69.93519667491853,20.88538811261101 69.93956265244904)))"
27350007770000,8,3,5,51.5,"MULTIPOLYGON(((21.145115985314742 69.9307358887606,21.158272803512144 69.97531397410468,21.288321375857617 69.97074746664897,21.27489113115561 69.92618036796698,21.145115985314742 69.9307358887606)))"
27600007770000,12,7,5,40.8,"MULTIPOLYGON(((21.793371573806862 69.90701247084452,21.807891403175017 69.95153339439783,21.93762179840051 69.94649326440255,21.922830641693945 69.90198443924702,21.793371573806862 69.90701247084452)))"
27650007770000,378,184,194,44.5,"MULTIPOLYGON(((21.922830641693945 69.90198443924702,21.93762179840051 69.94649326440255,22.067284943737434 69.94135865433128,22.052222902476196 69.8968621483867,21.922830641693945 69.90198443924702)))"
27700007770000,54,25,29,38.2,"MULTIPOLYGON(((22.052222902476196 69.8968621483867,22.067284943737434 69.94135865433128,22.196879643336004 69.93612964912991,22.181547167856515 69.89164568267756,22.052222902476196 69.8968621483867)))"
28000007770000,7,2,5,37.6,"MULTIPOLYGON(((22.82710725181019 69.86415378817136,22.843784882042723 69.90857177217072,22.972944021146837 69.90277826221079,22.955998814864063 69.85837412773527,22.82710725181019 69.86415378817136)))"
28050007770000,35,17,18,42.2,"MULTIPOLYGON(((22.955998814864063 69.85837412773527,22.972944021146837 69.90277826221079,23.10202645824307 69.89689099269002,23.08481417787411 69.85250092405494,22.955998814864063 69.85837412773527)))"
28100007770000,194,111,83,39.8,"MULTIPOLYGON(((23.08481417787411 69.85250092405494,23.10202645824307 69.89689099269002,23.231031030976254 69.89091006017779,23.21355218567602 69.84653427309979,23.08481417787411 69.85250092405494)))"
28150007770000,71,41,30,41.8,"MULTIPOLYGON(((23.21355218567602 69.84653427309979,23.231031030976254 69.89091006017779,23.359956581446966 69.88483556266723,23.342211687513355 69.84047427225482,23.21355218567602 69.84653427309979)))"
28200007770000,6,3,3,72,"MULTIPOLYGON(((23.342211687513355 69.84047427225482,23.359956581446966 69.88483556266723,23.488801956269327 69.87866759956856,23.470791537094787 69.83432102031394,23.342211687513355 69.84047427225482)))"
28350007770000,2,2,0,0,"MULTIPOLYGON(((23.72770771698882 69.82173516532387,23.746247588335073 69.86605168129172,23.874845561885124 69.85960393195711,23.85604177755013 69.81530276684569,23.72770771698882 69.82173516532387)))"
28850007770000,3,1,2,0,"MULTIPOLYGON(((25.007125942915074 69.75324626546707,25.028279326383984 69.7973998155379,25.155979614444647 69.79002647806703,25.134568132446557 69.74589036790701,25.007125942915074 69.75324626546707)))"
29200007770000,1,1,0,0,"MULTIPOLYGON(((25.897184684087048 69.69983299146462,25.92013157431452 69.74386018181964,26.047138659806556 69.73584590208071,26.0239381229163 69.6918375714521,25.897184684087048 69.69983299146462)))"
30750007770000,52,26,26,49.5,"MULTIPOLYGON(((29.774363729527995 69.4103358656232,29.804841964110935 69.45368916599999,29.928190658798584 69.44291707687961,29.89748172193623 69.39958844377979,29.774363729527995 69.4103358656232)))"
30800007770000,25,13,12,39.6,"MULTIPOLYGON(((29.89748172193623 69.39958844377979,29.928190658798584 69.44291707687961,30.05140662309836 69.43205845210824,30.0204677990028 69.38875465949137,29.89748172193623 69.39958844377979)))"
26450007775000,20,13,7,64.9,"MULTIPOLYGON(((18.80833593058223 70.04120700854641,18.81654851418568 70.08594351035102,18.947768053259445 70.08308946893847,18.93927486075706 70.03835989058983,18.80833593058223 70.04120700854641)))"
26500007775000,25,15,10,51.9,"MULTIPOLYGON(((18.93927486075706 70.03835989058983,18.947768053259445 70.08308946893847,19.078948530514058 70.08013918173634,19.07017499018377 70.03541675832571,18.93927486075706 70.03835989058983)))"
26600007775000,20,12,8,50.1,"MULTIPOLYGON(((19.201035050104686 70.0323776613327,19.210088668766435 70.07709269864185,19.34118719325552 70.07395007114896,19.331853774157327 70.02924265077628,19.201035050104686 70.0323776613327)))"
26800007775000,5,3,2,59.6,"MULTIPOLYGON(((19.72404930494595 70.01926267310328,19.734220374417507 70.0639458610913,19.86513974727081 70.06041920274595,19.854690072363333 70.0157445515502,19.72404930494595 70.01926267310328)))"
26850007775000,53,31,22,50,"MULTIPOLYGON(((19.854690072363333 70.0157445515502,19.86513974727081 70.06041920274595,19.996011171467902 70.05679668128819,19.98528321058156 70.01213079592831,19.854690072363333 70.0157445515502)))"
27100007775000,7,4,3,67.7,"MULTIPOLYGON(((20.50715450610448 69.9967206681859,20.518992252410627 70.04134920766622,20.649605112773138 70.03724831681983,20.63749080042615 69.99262968238413,20.50715450610448 69.9967206681859)))"
27250007775000,539,276,263,37.7,"MULTIPOLYGON(((20.89799689583687 69.98416203919346,20.910663227407 70.02876018426717,21.041106004978012 70.02437308476259,21.028164236219414 69.97978552310646,20.89799689583687 69.98416203919346)))"
27450007775000,1,1,0,0,"MULTIPOLYGON(((21.418308734917474 69.96608607671466,21.43207443037432 70.01064053876667,21.562273182460803 70.00587286246122,21.548233665938763 69.96132988178628,21.418308734917474 69.96608607671466)))"
27500007775000,17,9,8,59.3,"MULTIPOLYGON(((21.548233665938763 69.96132988178628,21.562273182460803 70.00587286246122,21.69240787181668 70.00101023688894,21.678094957819717 69.95647896085194,21.548233665938763 69.96132988178628)))"
27550007775000,3,2,1,0,"MULTIPOLYGON(((21.678094957819717 69.95647896085194,21.69240787181668 70.00101023688894,21.822477283313884 69.99605274304581,21.807891403175017 69.95153339439783,21.678094957819717 69.95647896085194)))"
27600007775000,4,1,3,0,"MULTIPOLYGON(((21.807891403175017 69.95153339439783,21.822477283313884 69.99605274304581,21.952480205647177 69.99100046342919,21.93762179840051 69.94649326440255,21.807891403175017 69.95153339439783)))"
27650007775000,118,64,54,47.8,"MULTIPOLYGON(((21.93762179840051 69.94649326440255,21.952480205647177 69.99100046342919,22.08241543139904 69.98585348203196,22.067284943737434 69.94135865433128,21.93762179840051 69.94649326440255)))"
28050007775000,192,94,98,42.7,"MULTIPOLYGON(((22.972944021146837 69.90277826221079,22.989965930170396 69.94718032907292,23.11931660371774 69.94127893463667,23.10202645824307 69.89689099269002,22.972944021146837 69.90277826221079)))"
28100007775000,234,121,113,36,"MULTIPOLYGON(((23.10202645824307 69.89689099269002,23.11931660371774 69.94127893463667,23.248588899291228 69.93528366064469,23.231031030976254 69.89091006017779,23.10202645824307 69.89689099269002)))"
28150007775000,480,237,243,36,"MULTIPOLYGON(((23.231031030976254 69.89091006017779,23.248588899291228 69.93528366064469,23.377781651790723 69.9291946057035,23.359956581446966 69.88483556266723,23.231031030976254 69.89091006017779)))"
28200007775000,278,138,140,34.9,"MULTIPOLYGON(((23.359956581446966 69.88483556266723,23.377781651790723 69.9291946057035,23.506893700678678 69.92301186984484,23.488801956269327 69.87866759956856,23.359956581446966 69.88483556266723)))"
28250007775000,182,91,91,27.5,"MULTIPOLYGON(((23.488801956269327 69.87866759956856,23.506893700678678 69.92301186984484,23.635923890037777 69.91673555451878,23.617566006628078 69.87240627170218,23.488801956269327 69.87866759956856)))"
28300007775000,1,1,0,0,"MULTIPOLYGON(((23.617566006628078 69.87240627170218,23.635923890037777 69.91673555451878,23.76487106862799 69.91036576258665,23.746247588335073 69.86605168129172,23.617566006628078 69.87240627170218)))"
28850007775000,39,17,22,56,"MULTIPOLYGON(((25.028279326383984 69.7973998155379,25.049527444558798 69.84155025409964,25.17748691565228 69.83415940473763,25.155979614444647 69.79002647806703,25.028279326383984 69.7973998155379)))"
28900007775000,2,1,1,0,"MULTIPOLYGON(((25.155979614444647 69.79002647806703,25.17748691565228 69.83415940473763,25.305349945777817 69.82667642053174,25.283584084179314 69.7825612115623,25.155979614444647 69.79002647806703)))"
29250007775000,12,7,5,44.5,"MULTIPOLYGON(((26.047138659806556 69.73584590208071,26.07044245640873 69.779850524489,26.197600310300132 69.77172604390037,26.174042486522634 69.72774055889285,26.047138659806556 69.73584590208071)))"
30800007775000,179,92,87,43.6,"MULTIPOLYGON(((29.928190658798584 69.44291707687961,29.959032327144822 69.48623928867606,30.082479028199693 69.47535572674329,30.05140662309836 69.43205845210824,29.928190658798584 69.44291707687961)))"
30850007775000,7,4,3,59,"MULTIPOLYGON(((30.05140662309836 69.43205845210824,30.082479028199693 69.47535572674329,30.205791323720355 69.46438561944127,30.17448900749155 69.42111345473735,30.05140662309836 69.43205845210824)))"
26750007780000,17,10,7,65.6,"MULTIPOLYGON(((19.603254314454308 70.06737659690498,19.613191890512613 70.11206724393593,19.74443813146379 70.10862816507576,19.734220374417507 70.0639458610913,19.603254314454308 70.06737659690498)))"
26850007780000,212,103,109,44.3,"MULTIPOLYGON(((19.86513974727081 70.06041920274595,19.875637371311356 70.10509293329804,20.00678834018448 70.10146160840335,19.996011171467902 70.05679668128819,19.86513974727081 70.06041920274595)))"
26900007780000,41,23,18,50.9,"MULTIPOLYGON(((19.996011171467902 70.05679668128819,20.00678834018448 70.10146160840335,20.13788977110545 70.09773425177472,20.12683338832359 70.05307835770991,19.996011171467902 70.05679668128819)))"
27050007780000,9,6,3,66.9,"MULTIPOLYGON(((20.388325180005562 70.04535455599569,20.399938966080445 70.0899916967328,20.530884211295252 70.08597662895704,20.518992252410627 70.04134920766622,20.388325180005562 70.04535455599569)))"
27100007780000,78,43,35,55,"MULTIPOLYGON(((20.518992252410627 70.04134920766622,20.530884211295252 70.08597662895704,20.661774881022307 70.08186579071281,20.649605112773138 70.03724831681983,20.518992252410627 70.04134920766622)))"
27150007780000,11,5,6,54.9,"MULTIPOLYGON(((20.649605112773138 70.03724831681983,20.661774881022307 70.08186579071281,20.792609723828576 70.0776592512263,20.780162517780983 70.03305195224313,20.649605112773138 70.03724831681983)))"
27200007780000,11,8,3,54.5,"MULTIPOLYGON(((20.780162517780983 70.03305195224313,20.792609723828576 70.0776592512263,20.923387491602565 70.07335708127766,20.910663227407 70.02876018426717,20.780162517780983 70.03305195224313)))"
27250007780000,1927,967,960,42.2,"MULTIPOLYGON(((20.910663227407 70.02876018426717,20.923387491602565 70.07335708127766,21.054106939624067 70.06895935319609,21.041106004978012 70.02437308476259,20.910663227407 70.02876018426717)))"
27650007780000,43,26,17,56.2,"MULTIPOLYGON(((21.952480205647177 69.99100046342919,21.967406310133946 70.035506027387,22.097614819776886 70.03034662220512,22.08241543139904 69.98585348203196,21.952480205647177 69.99100046342919)))"
27700007780000,2,1,1,0,"MULTIPOLYGON(((22.08241543139904 69.98585348203196,22.097614819776886 70.03034662220512,22.227753971048482 70.0250923786648,22.212281757103973 69.98061188433661,22.08241543139904 69.98585348203196)))"
27750007780000,39,24,15,41.6,"MULTIPOLYGON(((22.212281757103973 69.98061188433661,22.227753971048482 70.0250923786648,22.357822556863713 70.01974338428214,22.34207798331221 69.97527575730918,22.212281757103973 69.98061188433661)))"
28050007780000,113,59,54,42,"MULTIPOLYGON(((22.989965930170396 69.94718032907292,23.00706504830431 69.99158031648174,23.136685127916994 69.98566473766896,23.11931660371774 69.94127893463667,22.989965930170396 69.94718032907292)))"
28100007780000,6620,3286,3334,39.2,"MULTIPOLYGON(((23.11931660371774 69.94127893463667,23.136685127916994 69.98566473766896,23.266226311440636 69.97965506188353,23.248588899291228 69.93528366064469,23.11931660371774 69.94127893463667)))"
28150007780000,7585,3801,3784,38.8,"MULTIPOLYGON(((23.248588899291228 69.93528366064469,23.266226311440636 69.97965506188353,23.395687426516087 69.97355138835063,23.377781651790723 69.9291946057035,23.248588899291228 69.93528366064469)))"
28200007780000,2778,1421,1357,32,"MULTIPOLYGON(((23.377781651790723 69.9291946057035,23.395687426516087 69.97355138835063,23.525067305396444 69.96735381772883,23.506893700678678 69.92301186984484,23.377781651790723 69.9291946057035)))"
28250007780000,15,8,7,46.5,"MULTIPOLYGON(((23.506893700678678 69.92301186984484,23.525067305396444 69.96735381772883,23.65436478500533 69.96106245210322,23.635923890037777 69.91673555451878,23.506893700678678 69.92301186984484)))"
28850007780000,4,2,2,0,"MULTIPOLYGON(((25.049527444558798 69.84155025409964,25.07087091367985 69.88569756256364,25.1990906587208 69.87828912887043,25.17748691565228 69.83415940473763,25.049527444558798 69.84155025409964)))"
30750007780000,17,9,8,54.5,"MULTIPOLYGON(((29.83545207407982 69.49703614124962,29.866194876997707 69.54037675299064,29.990007548607966 69.52955504021882,29.959032327144822 69.48623928867606,29.83545207407982 69.49703614124962)))"
30800007780000,87,43,44,39.1,"MULTIPOLYGON(((29.959032327144822 69.48623928867606,29.990007548607966 69.52955504021882,30.113685839945205 69.51864644387571,30.082479028199693 69.47535572674329,29.959032327144822 69.48623928867606)))"
30850007780000,18,8,10,40,"MULTIPOLYGON(((30.082479028199693 69.47535572674329,30.113685839945205 69.51864644387571,30.237228893460795 69.50765112889697,30.205791323720355 69.46438561944127,30.082479028199693 69.47535572674329)))"
26500007785000,2,1,1,0,"MULTIPOLYGON(((18.956300307972246 70.12781836276287,18.964871888318488 70.1725465693889,19.096616901315482 70.16958187968139,19.08776241025027 70.12486088981552,18.956300307972246 70.12781836276287)))"
26750007785000,94,47,47,47.4,"MULTIPOLYGON(((19.613191890512613 70.11206724393593,19.62317519544134 70.15675703886211,19.754702890083713 70.15330958103995,19.74443813146379 70.10862816507576,19.613191890512613 70.11206724393593)))"
26850007785000,92,45,47,45.3,"MULTIPOLYGON(((19.875637371311356 70.10509293329804,19.886183266808544 70.1497657389438,20.017615047347505 70.14612557275883,20.00678834018448 70.10146160840335,19.875637371311356 70.10509293329804)))"
26900007785000,6,3,3,74,"MULTIPOLYGON(((20.00678834018448 70.10146160840335,20.017615047347505 70.14612557275883,20.148996956357827 70.14238914426265,20.13788977110545 70.09773425177472,20.00678834018448 70.10146160840335)))"
27150007785000,41,24,17,47.1,"MULTIPOLYGON(((20.661774881022307 70.08186579071281,20.67400047674586 70.12648209819416,20.805114005473676 70.12226534021626,20.792609723828576 70.0776592512263,20.661774881022307 70.08186579071281)))"
27200007785000,4,1,3,0,"MULTIPOLYGON(((20.792609723828576 70.0776592512263,20.805114005473676 70.12226534021626,20.936170076127393 70.11795272377202,20.923387491602565 70.07335708127766,20.792609723828576 70.0776592512263)))"
27550007785000,9,4,5,61.9,"MULTIPOLYGON(((21.70678606430949 70.04553998007921,21.72122997046115 70.0900681820768,21.851848955956324 70.08508668113917,21.837129653264626 70.04057050818676,21.70678606430949 70.04553998007921)))"
27600007785000,23,14,9,44.9,"MULTIPOLYGON(((21.837129653264626 70.04057050818676,21.851848955956324 70.08508668113917,21.982400562513035 70.0800099472533,21.967406310133946 70.035506027387,21.837129653264626 70.04057050818676)))"
27650007785000,39,24,15,45.2,"MULTIPOLYGON(((21.967406310133946 70.035506027387,21.982400562513035 70.0800099472533,22.11288356720275 70.07483806548132,22.097614819776886 70.03034662220512,21.967406310133946 70.035506027387)))"
27700007785000,19,10,9,56.7,"MULTIPOLYGON(((22.097614819776886 70.03034662220512,22.11288356720275 70.07483806548132,22.243296751136654 70.06957112239277,22.227753971048482 70.0250923786648,22.097614819776886 70.03034662220512)))"
27750007785000,65,35,30,43.1,"MULTIPOLYGON(((22.227753971048482 70.0250923786648,22.243296751136654 70.06957112239277,22.373638899530683 70.06420920605864,22.357822556863713 70.01974338428214,22.227753971048482 70.0250923786648)))"
27800007785000,5,3,2,49.2,"MULTIPOLYGON(((22.357822556863713 70.01974338428214,22.373638899530683 70.06420920605864,22.50390880176998 70.05875240604506,22.48781937426131 70.01429972805956,22.357822556863713 70.01974338428214)))"
28000007785000,204,105,99,39.1,"MULTIPOLYGON(((22.877367249515157 69.99740170053711,22.8942729892857 70.04181362188142,23.02424188636369 70.03597821248931,23.00706504830431 69.99158031648174,22.877367249515157 69.99740170053711)))"
28050007785000,21,13,8,55.4,"MULTIPOLYGON(((23.00706504830431 69.99158031648174,23.02424188636369 70.03597821248931,23.1541325489642 70.03004838944966,23.136685127916994 69.98566473766896,23.00706504830431 69.99158031648174)))"
28150007785000,600,311,289,37.3,"MULTIPOLYGON(((23.266226311440636 69.97965506188353,23.28394379280698 70.02402425116274,23.41367443821497 70.0179058974776,23.395687426516087 69.97355138835063,23.266226311440636 69.97965506188353)))"
28200007785000,232,119,113,38.5,"MULTIPOLYGON(((23.395687426516087 69.97355138835063,23.41367443821497 70.0179058974776,23.543323310173715 70.01169342968508,23.525067305396444 69.96735381772883,23.395687426516087 69.97355138835063)))"
28800007785000,43,32,11,24.5,"MULTIPOLYGON(((24.94255519703707 69.89301353488447,24.96373264042632 69.93717514365358,25.092310355297105 69.92984172217591,25.07087091367985 69.88569756256364,24.94255519703707 69.89301353488447)))"
30750007785000,3,1,2,0,"MULTIPOLYGON(((29.866194876997707 69.54037675299064,29.897071197048472 69.58371096251847,30.021117151461823 69.5728642922302,29.990007548607966 69.52955504021882,29.866194876997707 69.54037675299064)))"
30800007785000,41,18,23,47.1,"MULTIPOLYGON(((29.990007548607966 69.52955504021882,30.021117151461823 69.5728642922302,30.145027890633223 69.56193056365309,30.113685839945205 69.51864644387571,29.990007548607966 69.52955504021882)))"
30850007785000,3,2,1,0,"MULTIPOLYGON(((30.113685839945205 69.51864644387571,30.145027890633223 69.56193056365309,30.26880255297036 69.55090994267582,30.237228893460795 69.50765112889697,30.113685839945205 69.51864644387571)))"
26450007790000,1,1,0,0,"MULTIPOLYGON(((18.833087284291103 70.1754145473888,18.84141398288459 70.22014907765036,18.97348306009524 70.2172740861149,18.964871888318488 70.1725465693889,18.833087284291103 70.1754145473888)))"
26700007790000,66,38,28,50.8,"MULTIPOLYGON(((19.49160146400156 70.16010805382174,19.501347760204446 70.20480517523661,19.63320453763042 70.20144597786913,19.62317519544134 70.15675703886211,19.49160146400156 70.16010805382174)))"
26750007790000,91,50,41,50.3,"MULTIPOLYGON(((19.62317519544134 70.15675703886211,19.63320453763042 70.20144597786913,19.765014967096494 70.19799010492768,19.754702890083713 70.15330958103995,19.62317519544134 70.15675703886211)))"
26900007790000,1,1,0,0,"MULTIPOLYGON(((20.017615047347505 70.14612557275883,20.028491626538983 70.19078856979567,20.160155285994684 70.18704303035402,20.148996956357827 70.14238914426265,20.017615047347505 70.14612557275883)))"
27150007790000,18,10,8,63.4,"MULTIPOLYGON(((20.67400047674586 70.12648209819416,20.68628227483771 70.171097233339,20.817675745764408 70.16687021299661,20.805114005473676 70.12226534021626,20.67400047674586 70.12648209819416)))"
27500007790000,7,5,2,67,"MULTIPOLYGON(((21.590544832930146 70.09495436651775,21.60477782538613 70.13949287379248,21.735740029299972 70.13459483445803,21.72122997046115 70.0900681820768,21.590544832930146 70.09495436651775)))"
27650007790000,3,2,1,0,"MULTIPOLYGON(((21.982400562513035 70.0800099472533,21.997463417432414 70.12451221392169,22.128222136068572 70.11932780240437,22.11288356720275 70.07483806548132,21.982400562513035 70.0800099472533)))"
27800007790000,14,8,6,64.4,"MULTIPOLYGON(((22.373638899530683 70.06420920605864,22.389527489057908 70.10867321246639,22.52007168253124 70.10320321281111,22.50390880176998 70.05875240604506,22.373638899530683 70.06420920605864)))"
27850007790000,4,3,1,0,"MULTIPOLYGON(((22.50390880176998 70.05875240604506,22.52007168253124 70.10320321281111,22.650541933827053 70.0976381983756,22.634105251472757 70.05320081340689,22.50390880176998 70.05875240604506)))"
27900007790000,5,2,3,67,"MULTIPOLYGON(((22.634105251472757 70.05320081340689,22.650541933827053 70.0976381983756,22.780937033236462 70.09197826228332,22.764227046553515 70.04755452068133,22.634105251472757 70.05320081340689)))"
28000007790000,185,103,82,42.5,"MULTIPOLYGON(((22.8942729892857 70.04181362188142,22.911255775457505 70.0862234991424,23.04149695965776 70.08037400503865,23.02424188636369 70.03597821248931,22.8942729892857 70.04181362188142)))"
28150007790000,38,22,16,50.6,"MULTIPOLYGON(((23.28394379280698 70.02402425116274,23.30174187338523 70.06839121563476,23.431743224150008 70.06225811983404,23.41367443821497 70.0179058974776,23.28394379280698 70.02402425116274)))"
28200007790000,590,298,292,34.8,"MULTIPOLYGON(((23.41367443821497 70.0179058974776,23.431743224150008 70.06225811983404,23.56166225948988 70.05603069205542,23.543323310173715 70.01169342968508,23.41367443821497 70.0179058974776)))"
28250007790000,14,8,6,54.1,"MULTIPOLYGON(((23.543323310173715 70.01169342968508,23.56166225948988 70.05603069205542,23.691497801836988 70.04970903567036,23.672889238390177 70.00538695051075,23.543323310173715 70.01169342968508)))"
28750007790000,25,15,10,50.4,"MULTIPOLYGON(((24.835059436343908 69.94441577631937,24.856068636591836 69.98859160206864,24.98500557392282 69.98133365724469,24.96373264042632 69.93717514365358,24.835059436343908 69.94441577631937)))"
30550007790000,12,8,4,46.8,"MULTIPOLYGON(((29.39955269541731 69.62622377751046,29.42961842497594 69.66964999612314,29.55443396546681 69.6591288531462,29.524130759739368 69.6157269795201,29.39955269541731 69.62622377751046)))"
30750007790000,56,26,30,42.4,"MULTIPOLYGON(((29.897071197048472 69.58371096251847,29.928081865102214 69.62703873080223,30.05236197068628 69.6161670051018,30.021117151461823 69.5728642922302,29.897071197048472 69.58371096251847)))"
30800007790000,5,3,2,48.8,"MULTIPOLYGON(((30.021117151461823 69.5728642922302,30.05236197068628 69.6161670051018,30.176506019287388 69.605208045888,30.145027890633223 69.56193056365309,30.021117151461823 69.5728642922302)))"
30850007790000,1,1,0,0,"MULTIPOLYGON(((30.145027890633223 69.56193056365309,30.176506019287388 69.605208045888,30.30051314525029 69.5941620200099,30.26880255297036 69.55090994267582,30.145027890633223 69.56193056365309)))"
26650007795000,10,5,5,38.5,"MULTIPOLYGON(((19.369445927250926 70.2080676396748,19.378952635644396 70.25277192048615,19.511139112390474 70.24950147229488,19.501347760204446 70.20480517523661,19.369445927250926 70.2080676396748)))"
26700007795000,51,27,24,48.9,"MULTIPOLYGON(((19.501347760204446 70.20480517523661,19.511139112390474 70.24950147229488,19.64328022824756 70.24613405710495,19.63320453763042 70.20144597786913,19.501347760204446 70.20480517523661)))"
26750007795000,21,12,9,59.5,"MULTIPOLYGON(((19.63320453763042 70.20144597786913,19.64328022824756 70.24613405710495,19.7753746821733 70.24266973264287,19.765014967096494 70.19799010492768,19.63320453763042 70.20144597786913)))"
27050007795000,92,53,39,46,"MULTIPOLYGON(((20.423326860705846 70.17926272658195,20.435101689422744 70.22389660492256,20.566889014225318 70.21985212756559,20.554832223856078 70.17522809457307,20.423326860705846 70.17926272658195)))"
27550007795000,6,3,3,50.2,"MULTIPOLYGON(((21.735740029299972 70.13459483445803,21.750316683762346 70.17911992872054,21.881490150976333 70.17411421534786,21.86663563824883 70.1296012531408,21.735740029299972 70.13459483445803)))"
27800007795000,9,4,5,68.1,"MULTIPOLYGON(((22.389527489057908 70.10867321246639,22.405488807423442 70.15313539323914,22.536308506193983 70.14765213772202,22.52007168253124 70.10320321281111,22.389527489057908 70.10867321246639)))"
27850007795000,11,7,4,44.2,"MULTIPOLYGON(((22.52007168253124 70.10320321281111,22.536308506193983 70.14765213772202,22.66705376880225 70.1420736443749,22.650541933827053 70.0976381983756,22.52007168253124 70.10320321281111)))"
27950007795000,14,9,5,64.3,"MULTIPOLYGON(((22.780937033236462 70.09197826228332,22.79772337785272 70.13640000691265,22.92831612040538 70.13063132054359,22.911255775457505 70.0862234991424,22.780937033236462 70.09197826228332)))"
28000007795000,23,13,10,49.8,"MULTIPOLYGON(((22.911255775457505 70.0862234991424,22.92831612040538 70.13063132054359,23.058830788039003 70.12476768196244,23.04149695965776 70.08037400503865,22.911255775457505 70.0862234991424)))"
28100007795000,3,2,1,0,"MULTIPOLYGON(((23.171659389536334 70.07442987752908,23.189266176913772 70.1188091893438,23.31962108783321 70.11275594233496,23.30174187338523 70.06839121563476,23.171659389536334 70.07442987752908)))"
28150007795000,10,5,5,46.5,"MULTIPOLYGON(((23.30174187338523 70.06839121563476,23.31962108783321 70.11275594233496,23.449894326305493 70.10660804204896,23.431743224150008 70.06225811983404,23.30174187338523 70.06839121563476)))"
28750007795000,97,51,46,41.2,"MULTIPOLYGON(((24.856068636591836 69.98859160206864,24.87717283132045 70.03276438629246,25.00637462325157 70.025489057035,24.98500557392282 69.98133365724469,24.856068636591836 69.98859160206864)))"
29350007795000,6,3,3,50,"MULTIPOLYGON(((26.3967255506293 69.8953854498164,26.420964908017172 69.9393359033487,26.548932899967504 69.93095033742826,26.524436688483984 69.88701974211122,26.3967255506293 69.8953854498164)))"
30450007795000,36,18,18,49.1,"MULTIPOLYGON(((29.17959337076143 69.69042796285727,29.20931149936909 69.73389642976842,29.33462941219558 69.72352747382013,29.304671257949785 69.68008308629327,29.17959337076143 69.69042796285727)))"
30500007795000,89,49,40,53.2,"MULTIPOLYGON(((29.304671257949785 69.68008308629327,29.33462941219558 69.72352747382013,29.45981578219177 69.71307012280792,29.42961842497594 69.66964999612314,29.304671257949785 69.68008308629327)))"
30550007795000,20,13,7,53,"MULTIPOLYGON(((29.42961842497594 69.66964999612314,29.45981578219177 69.71307012280792,29.584869698497194 69.702524538475,29.55443396546681 69.6591288531462,29.42961842497594 69.66964999612314)))"
30700007795000,443,231,212,40.8,"MULTIPOLYGON(((29.803666575029297 69.63782305712382,29.83457656061003 69.68116932199555,29.959227718781317 69.67036001848136,29.928081865102214 69.62703873080223,29.803666575029297 69.63782305712382)))"
30750007795000,988,488,500,42.7,"MULTIPOLYGON(((29.928081865102214 69.62703873080223,29.959227718781317 69.67036001848136,30.083742848033534 69.65946313889127,30.05236197068628 69.6161670051018,29.928081865102214 69.62703873080223)))"
27300007800000,10,6,4,47.2,"MULTIPOLYGON(((21.09346871370288 70.20271033130282,21.10671030451957 70.24729135866609,21.23848774865396 70.24275426042635,21.224964883618135 70.19818427521892,21.09346871370288 70.20271033130282)))"
27400007800000,1,0,1,0,"MULTIPOLYGON(((21.35639902201458 70.19356212771132,21.370202742960334 70.23812084135199,21.501854020898502 70.23339118037705,21.48776987055793 70.18884396721013,21.35639902201458 70.19356212771132)))"
27450007800000,1,1,0,0,"MULTIPOLYGON(((21.48776987055793 70.18884396721013,21.501854020898502 70.23339118037705,21.63344031975959 70.22856535800092,21.61907617470287 70.18402987370126,21.48776987055793 70.18884396721013)))"
27500007800000,11,8,3,50.6,"MULTIPOLYGON(((21.61907617470287 70.18402987370126,21.63344031975959 70.22856535800092,21.76496038073608 70.22364345628245,21.750316683762346 70.17911992872054,21.61907617470287 70.18402987370126)))"
27750007800000,17,10,7,52.9,"MULTIPOLYGON(((22.274595894277777 70.15852331871137,22.290353210067185 70.20299675140564,22.421523340885283 70.19759573801562,22.405488807423442 70.15313539323914,22.274595894277777 70.15852331871137)))"
28000007800000,12,6,6,54,"MULTIPOLYGON(((22.92831612040538 70.13063132054359,22.94545454103587 70.17503707420026,23.076243895953017 70.16915923098169,23.058830788039003 70.12476768196244,22.92831612040538 70.13063132054359)))"
28050007800000,3,2,1,0,"MULTIPOLYGON(((23.058830788039003 70.12476768196244,23.076243895953017 70.16915923098169,23.206953443030656 70.16318631221534,23.189266176913772 70.1188091893438,23.058830788039003 70.12476768196244)))"
28100007800000,13,10,3,58.6,"MULTIPOLYGON(((23.189266176913772 70.1188091893438,23.206953443030656 70.16318631221534,23.337581975522564 70.15711841818016,23.31962108783321 70.11275594233496,23.189266176913772 70.1188091893438)))"
28150007800000,129,74,55,46.5,"MULTIPOLYGON(((23.31962108783321 70.11275594233496,23.337581975522564 70.15711841818016,23.46812829143889 70.15095565062933,23.449894326305493 70.10660804204896,23.31962108783321 70.11275594233496)))"
28750007800000,2466,1228,1238,42.9,"MULTIPOLYGON(((24.87717283132045 70.03276438629246,24.898372644962777 70.07693411066778,25.027840419569127 70.06964132423475,25.00637462325157 70.025489057035,24.87717283132045 70.03276438629246)))"
28800007800000,396,209,187,42.7,"MULTIPOLYGON(((25.00637462325157 70.025489057035,25.027840419569127 70.06964132423475,25.157210811464957 70.06225511784524,25.135479669108854 70.01812051899206,25.00637462325157 70.025489057035)))"
29550007800000,2,2,0,0,"MULTIPOLYGON(((26.93217362564252 69.90524415862643,26.957549115177958 69.94910966178429,27.0853264755116 69.94033749255601,27.059695961252398 69.89649273111219,26.93217362564252 69.90524415862643)))"
29600007800000,1,1,0,0,"MULTIPOLYGON(((27.059695961252398 69.89649273111219,27.0853264755116 69.94033749255601,27.212989083222716 69.93147400703698,27.187104280952045 69.88765018561288,27.059695961252398 69.89649273111219)))"
30550007800000,2,1,1,0,"MULTIPOLYGON(((29.45981578219177 69.71307012280792,29.49014559423148 69.7564841201991,29.61543879041718 69.7459139975615,29.584869698497194 69.702524538475,29.45981578219177 69.71307012280792)))"
30600007800000,10,5,5,51.2,"MULTIPOLYGON(((29.584869698497194 69.702524538475,29.61543879041718 69.7459139975615,29.740597790452938 69.73525562427778,29.70979025704998 69.69189088360172,29.584869698497194 69.702524538475)))"
30700007800000,528,264,264,34.1,"MULTIPOLYGON(((29.83457656061003 69.68116932199555,29.865621692723817 69.72450916511518,29.990509602527275 69.71367478586218,29.959227718781317 69.67036001848136,29.83457656061003 69.68116932199555)))"
30750007800000,2585,1278,1307,41.1,"MULTIPOLYGON(((29.959227718781317 69.67036001848136,29.990509602527275 69.71367478586218,30.11526063209482 69.70275265331863,30.083742848033534 69.65946313889127,29.959227718781317 69.67036001848136)))"
30800007800000,149,79,70,44.6,"MULTIPOLYGON(((30.083742848033534 69.65946313889127,30.11526063209482 69.70275265331863,30.239873900612825 69.69174293528548,30.208121071722783 69.64847885005472,30.083742848033534 69.65946313889127)))"
30850007800000,115,57,58,41.3,"MULTIPOLYGON(((30.208121071722783 69.64847885005472,30.239873900612825 69.69174293528548,30.36434853424252 69.6806458005548,30.33236152011171 69.63740731978857,30.208121071722783 69.64847885005472)))"
30900007800000,88,46,42,49.6,"MULTIPOLYGON(((30.33236152011171 69.63740731978857,30.36434853424252 69.6806458005548,30.4886836661393 69.6694614188998,30.456463330388626 69.62624871688702,30.33236152011171 69.63740731978857)))"
27400007805000,2,1,1,0,"MULTIPOLYGON(((21.370202742960334 70.23812084135199,21.384070180912882 70.2826781311065,21.5160031509664 70.27793692010805,21.501854020898502 70.23339118037705,21.370202742960334 70.23812084135199)))"
27450007805000,26,16,10,55.2,"MULTIPOLYGON(((21.501854020898502 70.23339118037705,21.5160031509664 70.27793692010805,21.647870703362724 70.27309931837091,21.63344031975959 70.22856535800092,21.501854020898502 70.23339118037705)))"
27550007805000,68,39,29,46,"MULTIPOLYGON(((21.76496038073608 70.22364345628245,21.7796715711044 70.26816540848151,21.91140449120921 70.26313527458926,21.8964129489913 70.21862555883393,21.76496038073608 70.22364345628245)))"
27650007805000,12,8,4,66.8,"MULTIPOLYGON(((22.02779677372827 70.21351175081513,22.04306820477975 70.25800900240039,22.17466145707244 70.25278667917186,22.159110608258 70.20830211892702,22.02779677372827 70.21351175081513)))"
27700007805000,10,7,3,60,"MULTIPOLYGON(((22.159110608258 70.20830211892702,22.17466145707244 70.25278667917186,22.306182997565905 70.24746839370486,22.290353210067185 70.20299675140564,22.159110608258 70.20830211892702)))"
27750007805000,320,169,151,47.4,"MULTIPOLYGON(((22.290353210067185 70.20299675140564,22.306182997565905 70.24746839370486,22.437631580028764 70.2420542363385,22.421523340885283 70.19759573801562,22.290353210067185 70.20299675140564)))"
28050007805000,7,3,4,42.1,"MULTIPOLYGON(((23.076243895953017 70.16915923098169,23.093736812488974 70.21354863970468,23.22472172452604 70.20756123334901,23.206953443030656 70.16318631221534,23.076243895953017 70.16915923098169)))"
28100007805000,3,2,1,0,"MULTIPOLYGON(((23.206953443030656 70.16318631221534,23.22472172452604 70.20756123334901,23.355625080590467 70.20147862996741,23.337581975522564 70.15711841818016,23.206953443030656 70.16318631221534)))"
28150007805000,2,1,1,0,"MULTIPOLYGON(((23.337581975522564 70.15711841818016,23.355625080590467 70.20147862996741,23.486445671133144 70.19530093195881,23.46812829143889 70.15095565062933,23.337581975522564 70.15711841818016)))"
28750007805000,5,3,2,46.4,"MULTIPOLYGON(((24.898372644962777 70.07693411066778,24.919668707390453 70.1211007567069,25.049403599522044 70.1137904398856,25.027840419569127 70.06964132423475,24.898372644962777 70.07693411066778)))"
28800007805000,48,24,24,44.4,"MULTIPOLYGON(((25.027840419569127 70.06964132423475,25.049403599522044 70.1137904398856,25.179040466757417 70.10638649114152,25.157210811464957 70.06225511784524,25.027840419569127 70.06964132423475)))"
28850007805000,22,12,10,47.5,"MULTIPOLYGON(((25.157210811464957 70.06225511784524,25.179040466757417 70.10638649114152,25.308578173037333 70.09888903283166,25.286482691357776 70.05477561309795,25.157210811464957 70.06225511784524)))"
29600007805000,2,2,0,0,"MULTIPOLYGON(((27.0853264755116 69.94033749255601,27.111071743438842 69.98417782733198,27.23898967325707 69.97529331595845,27.212989083222716 69.93147400703698,27.0853264755116 69.94033749255601)))"
29650007805000,10,6,4,69.2,"MULTIPOLYGON(((27.212989083222716 69.93147400703698,27.23898967325707 69.97529331595845,27.366791067623648 69.96631743244279,27.340535904222087 69.92251934750327,27.212989083222716 69.93147400703698)))"
30550007805000,1,1,0,0,"MULTIPOLYGON(((29.49014559423148 69.7564841201991,29.520608695060663 69.79989195061226,29.64614207963546 69.78929719213744,29.61543879041718 69.7459139975615,29.49014559423148 69.7564841201991)))"
30600007805000,2,0,2,0,"MULTIPOLYGON(((29.61543879041718 69.7459139975615,29.64614207963546 69.78929719213744,29.771540422772873 69.77861400236904,29.740597790452938 69.73525562427778,29.61543879041718 69.7459139975615)))"
30650007805000,7,3,4,50.9,"MULTIPOLYGON(((29.740597790452938 69.73525562427778,29.771540422772873 69.77861400236904,29.89680281846071 69.76784254704147,29.865621692723817 69.72450916511518,29.740597790452938 69.73525562427778)))"
30700007805000,8,4,4,52.8,"MULTIPOLYGON(((29.865621692723817 69.72450916511518,29.89680281846071 69.76784254704147,30.02192836766831 69.75698299291446,29.990509602527275 69.71367478586218,29.865621692723817 69.72450916511518)))"
30750007805000,3770,1855,1915,41.9,"MULTIPOLYGON(((29.990509602527275 69.71367478586218,30.02192836766831 69.75698299291446,30.14691617836819 69.74603550776303,30.11526063209482 69.70275265331863,29.990509602527275 69.71367478586218)))"
30800007805000,32,15,17,39.8,"MULTIPOLYGON(((30.11526063209482 69.70275265331863,30.14691617836819 69.74603550776303,30.27176536555688 69.73500026036717,30.239873900612825 69.69174293528548,30.11526063209482 69.70275265331863)))"
30900007805000,62,30,32,50.2,"MULTIPOLYGON(((30.36434853424252 69.6806458005548,30.396475051275043 69.72387742050185,30.521044364626654 69.71266715892665,30.4886836661393 69.6694614188998,30.36434853424252 69.6806458005548)))"
27450007810000,8,4,4,75.8,"MULTIPOLYGON(((21.5160031509664 70.27793692010805,21.530217699349024 70.32248117834298,21.662367772289723 70.3176317464123,21.647870703362724 70.27309931837091,21.5160031509664 70.27793692010805)))"
27650007810000,68,39,29,60,"MULTIPOLYGON(((22.04306820477975 70.25800900240039,22.058410097812796 70.3025045635063,22.190284018401115 70.29726949435207,22.17466145707244 70.25278667917186,22.04306820477975 70.25800900240039)))"
27750007810000,283,145,138,42.5,"MULTIPOLYGON(((22.306182997565905 70.24746839370486,22.32208574382145 70.29193823542819,22.453814019814423 70.28651087765327,22.437631580028764 70.2420542363385,22.306182997565905 70.24746839370486)))"
28050007810000,19,11,8,60.9,"MULTIPOLYGON(((23.093736812488974 70.21354863970468,23.11131007143075 70.25793589562556,23.24257156279557 70.25193393983247,23.22472172452604 70.20756123334901,23.093736812488974 70.21354863970468)))"
28100007810000,10,5,5,73.5,"MULTIPOLYGON(((23.22472172452604 70.20756123334901,23.24257156279557 70.25193393983247,23.3737509519919 70.24583656437261,23.355625080590467 70.20147862996741,23.22472172452604 70.20756123334901)))"
28150007810000,26,13,13,58.4,"MULTIPOLYGON(((23.355625080590467 70.20147862996741,23.3737509519919 70.24583656437261,23.504847021849567 70.23964387229628,23.486445671133144 70.19530093195881,23.355625080590467 70.20147862996741)))"
29650007810000,18,10,8,61.8,"MULTIPOLYGON(((27.23898967325707 69.97529331595845,27.26510679980602 70.01910808456455,27.39316380101243 70.01011089000833,27.366791067623648 69.96631743244279,27.23898967325707 69.97529331595845)))"
30450007810000,7,3,4,68.1,"MULTIPOLYGON(((29.269140460419788 69.82081551593109,29.299252949430745 69.8642660618241,29.42529646334972 69.85382429031941,29.394941182019753 69.81039811309459,29.269140460419788 69.82081551593109)))"
30600007810000,1,1,0,0,"MULTIPOLYGON(((29.64614207963546 69.78929719213744,29.67698041145099 69.83267408360804,29.802619003706 69.8219659786906,29.771540422772873 69.77861400236904,29.64614207963546 69.78929719213744)))"
30800007810000,11,7,4,62.5,"MULTIPOLYGON(((30.14691617836819 69.74603550776303,30.178710349326753 69.78931166125895,30.30379633314872 69.77825078373768,30.27176536555688 69.73500026036717,30.14691617836819 69.74603550776303)))"
30900007810000,16,9,7,49,"MULTIPOLYGON(((30.396475051275043 69.72387742050185,30.42874194185445 69.76710213746935,30.553546300478054 69.75586589420774,30.521044364626654 69.71266715892665,30.396475051275043 69.72387742050185)))"
27400007815000,8,7,1,68.6,"MULTIPOLYGON(((21.39800176622588 70.32723398924746,21.41199793312746 70.37178840797435,21.54449810857899 70.36702394694554,21.530217699349024 70.32248117834298,21.39800176622588 70.32723398924746)))"
27950007815000,6,4,2,54.7,"MULTIPOLYGON(((22.848545675122743 70.26965314347629,22.86564259008886 70.31406678419185,22.997343495116603 70.30824180820863,22.979967699929514 70.26384233019337,22.848545675122743 70.26965314347629)))"
28000007815000,13,8,5,45.8,"MULTIPOLYGON(((22.979967699929514 70.26384233019337,22.997343495116603 70.30824180820863,23.128964211308755 70.30232098612318,23.11131007143075 70.25793589562556,22.979967699929514 70.26384233019337)))"
28050007815000,6,3,3,53.8,"MULTIPOLYGON(((23.11131007143075 70.25793589562556,23.128964211308755 70.30232098612318,23.260503504043935 70.29630441863443,23.24257156279557 70.25193393983247,23.11131007143075 70.25793589562556)))"
28100007815000,13,9,4,63.8,"MULTIPOLYGON(((23.24257156279557 70.25193393983247,23.260503504043935 70.29630441863443,23.391960143552737 70.29019220794918,23.3737509519919 70.24583656437261,23.24257156279557 70.25193393983247)))"
28150007815000,31,21,10,62.3,"MULTIPOLYGON(((23.3737509519919 70.24583656437261,23.391960143552737 70.29019220794918,23.523332904981487 70.28398445777458,23.504847021849567 70.23964387229628,23.3737509519919 70.24583656437261)))"
28200007815000,2,1,1,0,"MULTIPOLYGON(((23.504847021849567 70.23964387229628,23.523332904981487 70.28398445777458,23.654620568455286 70.27768127331092,23.635858560122774 70.233355968138,23.504847021849567 70.23964387229628)))"
28700007815000,44,22,22,51.8,"MULTIPOLYGON(((24.81096097849504 70.17249826022295,24.832181395866655 70.21667615736662,24.96255212563424 70.20942473899129,24.941061653972394 70.1652643057556,24.81096097849504 70.17249826022295)))"
29650007815000,21,10,11,41.6,"MULTIPOLYGON(((27.26510679980602 70.01910808456455,27.291341217998244 70.06291828479783,27.41965486524366 70.05389969159499,27.39316380101243 70.01011089000833,27.26510679980602 70.01910808456455)))"
29700007815000,40,19,21,54.8,"MULTIPOLYGON(((27.39316380101243 70.01011089000833,27.41965486524366 70.05389969159499,27.54784941540035 70.04478947406919,27.521102472456864 70.00102226974151,27.39316380101243 70.01011089000833)))"
30450007815000,35,21,14,66.7,"MULTIPOLYGON(((29.299252949430745 69.8642660618241,29.329498559909993 69.90771056016077,29.45578579760005 69.89724432238808,29.42529646334972 69.85382429031941,29.299252949430745 69.8642660618241)))"
30500007815000,2,1,1,0,"MULTIPOLYGON(((29.42529646334972 69.85382429031941,29.45578579760005 69.89724432238808,29.581938133354058 69.88668895815275,29.55120592551196 69.84329357604084,29.42529646334972 69.85382429031941)))"
30750007815000,2,1,1,0,"MULTIPOLYGON(((30.05348487248776 69.80028459926787,30.085179982293297 69.84357956420858,30.210644014488043 69.83258107249299,30.178710349326753 69.78931166125895,30.05348487248776 69.80028459926787)))"
27900007820000,18,11,7,51.2,"MULTIPOLYGON(((22.733862735634407 70.31979581488893,22.750757948764164 70.364221397289,22.882818455268772 70.35847836938426,22.86564259008886 70.31406678419185,22.733862735634407 70.31979581488893)))"
27950007820000,23,12,11,51.2,"MULTIPOLYGON(((22.86564259008886 70.31406678419185,22.882818455268772 70.35847836938426,23.014799479937214 70.35263916983452,22.997343495116603 70.30824180820863,22.86564259008886 70.31406678419185)))"
28000007820000,15,6,9,32.5,"MULTIPOLYGON(((22.997343495116603 70.30824180820863,23.014799479937214 70.35263916983452,23.146699775452404 70.34670389845962,23.128964211308755 70.30232098612318,22.997343495116603 70.30824180820863)))"
28150007820000,19,10,9,44.5,"MULTIPOLYGON(((23.391960143552737 70.29019220794918,23.410253214023456 70.33454554712661,23.541903886908553 70.32832267439896,23.523332904981487 70.28398445777458,23.391960143552737 70.29019220794918)))"
28200007820000,12,7,5,48.8,"MULTIPOLYGON(((23.523332904981487 70.28398445777458,23.541903886908553 70.32832267439896,23.67346889042698 70.32200414429224,23.654620568455286 70.27768127331092,23.523332904981487 70.28398445777458)))"
28700007820000,41,24,17,46.1,"MULTIPOLYGON(((24.832181395866655 70.21667615736662,24.853498823695297 70.26085099353828,24.984140768918554 70.25358203742117,24.96255212563424 70.20942473899129,24.832181395866655 70.21667615736662)))"
28750007820000,7,4,3,37.1,"MULTIPOLYGON(((24.96255212563424 70.20942473899129,24.984140768918554 70.25358203742117,25.114683891255435 70.24621868539201,25.092824684725645 70.20207913985266,24.96255212563424 70.20942473899129)))"
29700007820000,18,9,9,53.3,"MULTIPOLYGON(((27.41965486524366 70.05389969159499,27.44626502765538 70.09768380834623,27.574716494937597 70.08855190472035,27.54784941540035 70.04478947406919,27.41965486524366 70.05389969159499)))"
29750007820000,2,2,0,0,"MULTIPOLYGON(((27.54784941540035 70.04478947406919,27.574716494937597 70.08855190472035,27.703047047112285 70.0793283257293,27.67592383006134 70.03558777957407,27.54784941540035 70.04478947406919)))"
29800007820000,12,6,6,71,"MULTIPOLYGON(((27.67592383006134 70.03558777957407,27.703047047112285 70.0793283257293,27.831255646695222 70.0700132208467,27.80387707740781 70.02629475667764,27.67592383006134 70.03558777957407)))"
28450007825000,1,1,0,0,"MULTIPOLYGON(((24.19884783920017 70.29577561964206,24.218891385780577 70.34003217028878,24.350285375187493 70.33322047254543,24.329966262943604 70.28898044274001,24.19884783920017 70.29577561964206)))"
28750007825000,67,36,31,47,"MULTIPOLYGON(((24.984140768918554 70.25358203742117,25.005828236045826 70.29773618188028,25.136643084100935 70.2903550018249,25.114683891255435 70.24621868539201,24.984140768918554 70.25358203742117)))"
29800007825000,38,23,15,53.8,"MULTIPOLYGON(((27.703047047112285 70.0793283257293,27.730292217870687 70.12306397845772,27.858757200486068 70.11372670083782,27.831255646695222 70.0700132208467,27.703047047112285 70.0793283257293)))"
29850007825000,65,34,31,48.1,"MULTIPOLYGON(((27.831255646695222 70.0700132208467,27.858757200486068 70.11372670083782,27.987098402115826 70.10429785076745,27.959341262896505 70.06060674075658,27.831255646695222 70.0700132208467)))"
29900007825000,179,89,90,49.7,"MULTIPOLYGON(((27.959341262896505 70.06060674075658,27.987098402115826 70.10429785076745,28.115314793138566 70.0947775810557,28.087302871656664 70.05110903734347,27.959341262896505 70.06060674075658)))"
29950007825000,13,6,7,46.2,"MULTIPOLYGON(((28.087302871656664 70.05110903734347,28.115314793138566 70.0947775810557,28.243405350769248 70.0851660457079,28.215139455682035 70.04152026368253,28.087302871656664 70.05110903734347)))"
30500007825000,162,92,70,53.7,"MULTIPOLYGON(((29.486410034961764 69.94065817123514,29.51717003267823 69.9840657984674,29.643810907385575 69.9734608374507,29.61280617336157 69.93007805828712,29.486410034961764 69.94065817123514)))"
30550007825000,19,7,12,58.6,"MULTIPOLYGON(((29.61280617336157 69.93007805828712,29.643810907385575 69.9734608374507,29.770314220280703 69.9627665484687,29.73906561893617 69.91940880120042,29.61280617336157 69.93007805828712)))"
27650007830000,5,3,2,68.2,"MULTIPOLYGON(((22.10486332320482 70.43598100810733,22.120491860107236 70.4804697110036,22.253501121755136 70.47518310493635,22.237586832978614 70.43070736999375,22.10486332320482 70.43598100810733)))"
28200007830000,15,6,9,73.1,"MULTIPOLYGON(((23.5605605390518 70.3726585080457,23.579303437929386 70.4169919444607,23.71142679667441 70.41064252531807,23.69240410509464 70.366324566525,23.5605605390518 70.3726585080457)))"
28450007830000,5,3,2,60.4,"MULTIPOLYGON(((24.218891385780577 70.34003217028878,24.23902727720391 70.38428598385035,24.370698035757314 70.37745769468171,24.350285375187493 70.33322047254543,24.218891385780577 70.34003217028878)))"
28500007830000,3,2,1,0,"MULTIPOLYGON(((24.350285375187493 70.33322047254543,24.370698035757314 70.37745769468171,24.502274619557937 70.37053397414614,24.48158581718832 70.326313564025,24.350285375187493 70.33322047254543)))"
28750007830000,148,80,68,47.7,"MULTIPOLYGON(((25.005828236045826 70.29773618188028,25.02761518497625 70.34188715302979,25.158702928261143 70.33448806932147,25.136643084100935 70.2903550018249,25.005828236045826 70.29773618188028)))"
28800007830000,3,2,1,0,"MULTIPOLYGON(((25.136643084100935 70.2903550018249,25.158702928261143 70.33448806932147,25.289689350362593 70.32699428177517,25.267357281817404 70.28287933394063,25.136643084100935 70.2903550018249)))"
28900007830000,30,17,13,46.9,"MULTIPOLYGON(((25.397969665548903 70.27530930368273,25.420573280605197 70.31940591663742,25.551353554287463 70.31172310155755,25.528479077558668 70.26764503790173,25.397969665548903 70.27530930368273)))"
28950007830000,7,3,4,26.4,"MULTIPOLYGON(((25.528479077558668 70.26764503790173,25.551353554287463 70.31172310155755,25.682029012734834 70.30394596557872,25.658884366072087 70.25988666483435,25.528479077558668 70.26764503790173)))"
29900007830000,23,11,12,58.1,"MULTIPOLYGON(((27.987098402115826 70.10429785076745,28.014980353081615 70.14798385354217,28.143452549157743 70.13844092488394,28.115314793138566 70.0947775810557,27.987098402115826 70.10429785076745)))"
29950007830000,64,30,34,47,"MULTIPOLYGON(((28.115314793138566 70.0947775810557,28.143452549157743 70.13844092488394,28.27179809631331 70.12880653454958,28.243405350769248 70.0851660457079,28.115314793138566 70.0947775810557)))"
30100007830000,2,2,0,0,"MULTIPOLYGON(((28.49920490910355 70.06566980004607,28.528105165365975 70.10926399457294,28.65606466548966 70.09935616073435,28.626911898726952 70.05578540363311,28.49920490910355 70.06566980004607)))"
30150007830000,14,9,5,56.7,"MULTIPOLYGON(((28.626911898726952 70.05578540363311,28.65606466548966 70.09935616073435,28.783893473211368 70.08935749680658,28.75448903286291 70.0458103693659,28.626911898726952 70.05578540363311)))"
30200007830000,19,10,9,58,"MULTIPOLYGON(((28.75448903286291 70.0458103693659,28.783893473211368 70.08935749680658,28.91159059526501 70.07926816358881,28.881935323411412 70.03574485707921,28.75448903286291 70.0458103693659)))"
30300007830000,1,1,0,0,"MULTIPOLYGON(((29.00924978930398 70.02558902774322,29.039155045488535 70.06908832302052,29.16658584485354 70.05881813817112,29.136431456533224 70.01534304345304,29.00924978930398 70.02558902774322)))"
30450007830000,1,1,0,0,"MULTIPOLYGON(((29.39039253444838 69.99458126395395,29.4210426107345 70.03800739349383,29.54806665511648 70.02746716536055,29.51717003267823 69.9840657984674,29.39039253444838 69.99458126395395)))"
30500007830000,1,0,1,0,"MULTIPOLYGON(((29.51717003267823 69.9840657984674,29.54806665511648 70.02746716536055,29.674953204425183 70.01683725631442,29.643810907385575 69.9734608374507,29.51717003267823 69.9840657984674)))"
27650007835000,426,227,199,44.7,"MULTIPOLYGON(((22.120491860107236 70.4804697110036,22.136193278671875 70.52495667481908,22.269489583798176 70.51965704435305,22.253501121755136 70.47518310493635,22.120491860107236 70.4804697110036)))"
28200007835000,1,0,1,0,"MULTIPOLYGON(((23.579303437929386 70.4169919444607,23.598133165213095 70.46132296925795,23.730537554598904 70.45495800584462,23.71142679667441 70.41064252531807,23.579303437929386 70.4169919444607)))"
28250007835000,37,26,11,50.6,"MULTIPOLYGON(((23.71142679667441 70.41064252531807,23.730537554598904 70.45495800584462,23.862853283821867 70.44849681987428,23.84346208995376 70.40419710869068,23.71142679667441 70.41064252531807)))"
28750007835000,25,15,10,52.7,"MULTIPOLYGON(((25.02761518497625 70.34188715302979,25.049502279472225 70.38603493135474,25.180864094591474 70.37861786787147,25.158702928261143 70.33448806932147,25.02761518497625 70.34188715302979)))"
28850007835000,3,2,1,0,"MULTIPOLYGON(((25.289689350362593 70.32699428177517,25.31212391176229 70.37110588371921,25.443280553226337 70.36349910594237,25.420573280605197 70.31940591663742,25.289689350362593 70.32699428177517)))"
28900007835000,51,23,28,57.9,"MULTIPOLYGON(((25.420573280605197 70.31940591663742,25.443280553226337 70.36349910594237,25.57433284726435 70.35579766299598,25.551353554287463 70.31172310155755,25.420573280605197 70.31940591663742)))"
28950007835000,97,53,44,51.3,"MULTIPOLYGON(((25.551353554287463 70.31172310155755,25.57433284726435 70.35579766299598,25.70527962824964 70.34800168473656,25.682029012734834 70.30394596557872,25.551353554287463 70.31172310155755)))"
29950007835000,228,120,108,46.9,"MULTIPOLYGON(((28.143452549157743 70.13844092488394,28.171716955254624 70.18209903632597,28.30031851330913 70.17244169712185,28.27179809631331 70.12880653454958,28.143452549157743 70.13844092488394)))"
30050007835000,36,22,14,39.8,"MULTIPOLYGON(((28.400015973179944 70.11908083867385,28.428791573114868 70.16269285663259,28.557135114864455 70.15285267313088,28.528105165365975 70.10926399457294,28.400015973179944 70.11908083867385)))"
30100007835000,94,53,41,52.5,"MULTIPOLYGON(((28.528105165365975 70.10926399457294,28.557135114864455 70.15285267313088,28.68534812583327 70.14292130606592,28.65606466548966 70.09935616073435,28.528105165365975 70.10926399457294)))"
27650007840000,2,1,1,0,"MULTIPOLYGON(((22.136193278671875 70.52495667481908,22.151968076031668 70.56944188955676,22.28555272466618 70.56412917786481,22.269489583798176 70.51965704435305,22.136193278671875 70.52495667481908)))"
28250007840000,22,10,12,50.7,"MULTIPOLYGON(((23.730537554598904 70.45495800584462,23.749736973575047 70.49927099314056,23.88233437917165 70.49279396983569,23.862853283821867 70.44849681987428,23.730537554598904 70.45495800584462)))"
28400007840000,12,3,9,26.1,"MULTIPOLYGON(((24.127213805497366 70.43528622558642,24.147256422249214 70.47955102582908,24.279578579664737 70.47278533299524,24.25925613336142 70.42853704368433,24.127213805497366 70.43528622558642)))"
28450007840000,33,19,14,51.8,"MULTIPOLYGON(((24.25925613336142 70.42853704368433,24.279578579664737 70.47278533299524,24.41180651688195 70.46592364735335,24.391204872009872 70.42169209203972,24.25925613336142 70.42853704368433)))"
28500007840000,137,74,63,35.9,"MULTIPOLYGON(((24.391204872009872 70.42169209203972,24.41180651688195 70.46592364735335,24.54393900785203 70.45896608657539,24.523058802979055 70.41475148757685,24.391204872009872 70.42169209203972)))"
28550007840000,1,1,0,0,"MULTIPOLYGON(((24.523058802979055 70.41475148757685,24.54393900785203 70.45896608657539,24.67597483222974 70.45191276981333,24.65481671344651 70.40771534869154,24.523058802979055 70.41475148757685)))"
28750007840000,5,4,1,66.6,"MULTIPOLYGON(((25.049502279472225 70.38603493135474,25.07149018916185 70.43017949716246,25.203127259867728 70.42274437728275,25.180864094591474 70.37861786787147,25.049502279472225 70.38603493135474)))"
28900007840000,9,6,3,71.9,"MULTIPOLYGON(((25.443280553226337 70.36349910594237,25.46609217428898 70.40758885039277,25.597417654318207 70.3998687004993,25.57433284726435 70.35579766299598,25.443280553226337 70.36349910594237)))"
29250007840000,1,1,0,0,"MULTIPOLYGON(((26.358390473493213 70.3076084056742,26.383099372810136 70.35156271111143,26.51365705995602 70.34318212944619,26.48868004571171 70.29924801985176,26.358390473493213 70.3076084056742)))"
29300007840000,7,4,3,49.6,"MULTIPOLYGON(((26.48868004571171 70.29924801985176,26.51365705995602 70.34318212944619,26.644100498470536 70.33470775066117,26.61885612039723 70.29079404618054,26.48868004571171 70.29924801985176)))"
29900007840000,566,279,287,42.7,"MULTIPOLYGON(((28.042987925808173 70.19166471715924,28.071121937217995 70.23534040941581,28.20010883391268 70.22575188259344,28.171716955254624 70.18209903632597,28.042987925808173 70.19166471715924)))"
29950007840000,314,163,151,38.4,"MULTIPOLYGON(((28.171716955254624 70.18209903632597,28.20010883391268 70.22575188259344,28.328967429728667 70.21607150004809,28.30031851330913 70.17244169712185,28.171716955254624 70.18209903632597)))"
30050007840000,132,71,61,42.1,"MULTIPOLYGON(((28.428791573114868 70.16269285663259,28.457696692286458 70.2062994198242,28.58629559632961 70.19643580115869,28.557135114864455 70.15285267313088,28.428791573114868 70.16269285663259)))"
30100007840000,234,114,120,44.2,"MULTIPOLYGON(((28.557135114864455 70.15285267313088,28.58629559632961 70.19643580115869,28.71476312375823 70.18648080447036,28.68534812583327 70.14292130606592,28.557135114864455 70.15285267313088)))"
30150007840000,111,63,48,49.7,"MULTIPOLYGON(((28.68534812583327 70.14292130606592,28.71476312375823 70.18648080447036,28.84309826366158 70.17643459134965,28.81342960041191 70.13289891605326,28.68534812583327 70.14292130606592)))"
30200007840000,200,97,103,49.1,"MULTIPOLYGON(((28.81342960041191 70.13289891605326,28.84309826366158 70.17643459134965,28.971300012349754 70.16629732454787,28.941378540137695 70.12278566486418,28.81342960041191 70.13289891605326)))"
30250007840000,13,6,7,55.8,"MULTIPOLYGON(((28.941378540137695 70.12278566486418,28.971300012349754 70.16629732454787,29.099367373384474 70.15606916796678,29.069193953725346 70.11258171541536,28.941378540137695 70.12278566486418)))"
30300007840000,7,3,4,55.7,"MULTIPOLYGON(((29.069193953725346 70.11258171541536,29.099367373384474 70.15606916796678,29.22729935760898 70.14575028664794,29.196874857096724 70.10228723175835,29.069193953725346 70.11258171541536)))"
30350007840000,415,210,205,45.3,"MULTIPOLYGON(((29.196874857096724 70.10228723175835,29.22729935760898 70.14575028664794,29.355094983177068 70.13534084676222,29.324420273409736 70.09190237906904,29.196874857096724 70.10228723175835)))"
30400007840000,172,85,87,45.9,"MULTIPOLYGON(((29.324420273409736 70.09190237906904,29.355094983177068 70.13534084676222,29.482753275581107 70.12484101559893,29.451829233086308 70.08142732363714,29.324420273409736 70.09190237906904)))"
30450007840000,35,23,12,52.1,"MULTIPOLYGON(((29.451829233086308 70.08142732363714,29.482753275581107 70.12484101559893,29.6102732676793 70.1142509615553,29.579100773839496 70.07086223285559,29.451829233086308 70.08142732363714)))"
30500007840000,1065,541,524,41.1,"MULTIPOLYGON(((29.579100773839496 70.07086223285559,29.6102732676793 70.1142509615553,29.737653999722014 70.10357085412575,29.70623394069972 70.06020727520988,29.579100773839496 70.07086223285559)))"
30550007840000,3678,1844,1834,42.8,"MULTIPOLYGON(((29.70623394069972 70.06020727520988,29.737653999722014 70.10357085412575,29.864894519377085 70.09280086389097,29.833227786040084 70.04946262026755,29.70623394069972 70.06020727520988)))"
30600007840000,53,27,26,53.6,"MULTIPOLYGON(((29.833227786040084 70.04946262026755,29.864894519377085 70.09280086389097,29.99199388175447 70.08194116250745,29.960081369600882 70.03862843866739,29.833227786040084 70.04946262026755)))"
30650007840000,75,40,35,44.7,"MULTIPOLYGON(((29.960081369600882 70.03862843866739,29.99199388175447 70.08194116250745,30.118951149429815 70.07099192269641,30.086793758513174 70.02770490210881,29.960081369600882 70.03862843866739)))"
27600007845000,7,5,2,65.3,"MULTIPOLYGON(((22.018309547715102 70.57465693362022,22.033868067276924 70.61915329284278,22.167816753834483 70.61392534512474,22.151968076031668 70.56944188955676,22.018309547715102 70.57465693362022)))"
27650007845000,227,129,98,45.3,"MULTIPOLYGON(((22.151968076031668 70.56944188955676,22.167816753834483 70.61392534512474,22.301691054504662 70.60859949499441,22.28555272466618 70.56412917786481,22.151968076031668 70.56944188955676)))"
27700007845000,90,46,44,43.6,"MULTIPOLYGON(((22.28555272466618 70.56412917786481,22.301691054504662 70.60859949499441,22.435489652201785 70.60317583595779,22.419062185103364 70.55871889144399,22.28555272466618 70.56412917786481)))"
28000007845000,13,9,4,64.3,"MULTIPOLYGON(((23.08543619502464 70.53020720182083,23.10330133054394 70.57459379250615,23.236618319377232 70.5685853335669,23.21846731223571 70.5242135072799,23.08543619502464 70.53020720182083)))"
28100007845000,31,16,15,57.7,"MULTIPOLYGON(((23.351414215517206 70.51812293283572,23.3698505210251 70.56247976506363,23.50299665793255 70.55627719321319,23.484275635443748 70.5119355840221,23.351414215517206 70.51812293283572)))"
28150007845000,28,17,11,51.3,"MULTIPOLYGON(((23.484275635443748 70.5119355840221,23.50299665793255 70.55627719321319,23.636055457798513 70.54997772578693,23.617050307785618 70.50565156791814,23.484275635443748 70.5119355840221)))"
28200007845000,4,2,2,0,"MULTIPOLYGON(((23.617050307785618 70.50565156791814,23.636055457798513 70.54997772578693,23.769025653642718 70.54358147210296,23.749736973575047 70.49927099314056,23.617050307785618 70.50565156791814)))"
28250007845000,13,7,6,41.2,"MULTIPOLYGON(((23.749736973575047 70.49927099314056,23.769025653642718 70.54358147210296,23.901905983871885 70.537088543018,23.88233437917165 70.49279396983569,23.749736973575047 70.49927099314056)))"
28300007845000,408,223,185,47,"MULTIPOLYGON(((23.88233437917165 70.49279396983569,23.901905983871885 70.537088543018,24.034695192344998 70.53049905091929,24.01484127632713 70.4862206096714,23.88233437917165 70.49279396983569)))"
28350007845000,107,58,49,43.3,"MULTIPOLYGON(((24.01484127632713 70.4862206096714,24.034695192344998 70.53049905091929,24.16739202843787 70.52381310971634,24.147256422249214 70.47955102582908,24.01484127632713 70.4862206096714)))"
28400007845000,38,22,16,55.1,"MULTIPOLYGON(((24.147256422249214 70.47955102582908,24.16739202843787 70.52381310971634,24.29999524710686 70.51703083483271,24.279578579664737 70.47278533299524,24.147256422249214 70.47955102582908)))"
28450007845000,5,3,2,68.6,"MULTIPOLYGON(((24.279578579664737 70.47278533299524,24.29999524710686 70.51703083483271,24.432503608951777 70.51015234319748,24.41180651688195 70.46592364735335,24.279578579664737 70.47278533299524)))"
28700007845000,19,10,9,60.9,"MULTIPOLYGON(((24.939751628703558 70.4375193522936,24.961563901061098 70.48167859994041,25.093579589602985 70.47432083058018,25.07149018916185 70.43017949716246,24.939751628703558 70.4375193522936)))"
28750007845000,26,14,12,60.5,"MULTIPOLYGON(((25.07149018916185 70.43017949716246,25.093579589602985 70.47432083058018,25.22549310685067 70.4668675771788,25.203127259867728 70.42274437728275,25.07149018916185 70.43017949716246)))"
28800007845000,11,7,4,57.6,"MULTIPOLYGON(((25.203127259867728 70.42274437728275,25.22549310685067 70.4668675771788,25.357303254599774 70.45931896696203,25.33466164987531 70.41521411907645,25.203127259867728 70.42274437728275)))"
28900007845000,5,2,3,66,"MULTIPOLYGON(((25.46609217428898 70.40758885039277,25.489008840762594 70.45167512859084,25.620608679423356 70.44393619215238,25.597417654318207 70.3998687004993,25.46609217428898 70.40758885039277)))"
28950007845000,2,1,1,0,"MULTIPOLYGON(((25.597417654318207 70.3998687004993,25.620608679423356 70.44393619215238,25.7521015908927 70.43610228915077,25.72863691733152 70.39205380007284,25.597417654318207 70.3998687004993)))"
29250007845000,14,7,7,70.7,"MULTIPOLYGON(((26.383099372810136 70.35156271111143,26.40792139376398 70.39551297634611,26.538748323924953 70.38711211371916,26.51365705995602 70.34318212944619,26.383099372810136 70.35156271111143)))"
29300007845000,6,3,3,70.7,"MULTIPOLYGON(((26.51365705995602 70.34318212944619,26.538748323924953 70.38711211371916,26.669460247796554 70.37861724394185,26.644100498470536 70.33470775066117,26.51365705995602 70.34318212944619)))"
29850007845000,2,1,1,0,"MULTIPOLYGON(((27.942007779112753 70.24483692367356,27.970009315442233 70.28853015350194,28.099383211213933 70.27901089782434,28.071121937217995 70.23534040941581,27.942007779112753 70.24483692367356)))"
29900007845000,263,140,123,43.6,"MULTIPOLYGON(((28.071121937217995 70.23534040941581,28.099383211213933 70.27901089782434,28.228629014630894 70.26939943060867,28.20010883391268 70.22575188259344,28.071121937217995 70.23534040941581)))"
29950007845000,90,40,50,36,"MULTIPOLYGON(((28.20010883391268 70.22575188259344,28.228629014630894 70.26939943060867,28.357745680593577 70.25969590965762,28.328967429728667 70.21607150004809,28.20010883391268 70.22575188259344)))"
30650007845000,33,18,15,48.3,"MULTIPOLYGON(((29.99199388175447 70.08194116250745,30.024048489858185 70.12524720071822,30.15125156623614 70.11427215418252,30.118951149429815 70.07099192269641,29.99199388175447 70.08194116250745)))"
30700007845000,41,23,18,48.2,"MULTIPOLYGON(((30.118951149429815 70.07099192269641,30.15125156623614 70.11427215418252,30.278310705931702 70.10320756001131,30.245765392467202 70.05995331823317,30.118951149429815 70.07099192269641)))"
27550007850000,205,121,84,42.1,"MULTIPOLYGON(((21.89984631653524 70.62428324626404,21.915185918955185 70.66879061666413,22.049499651780113 70.66364793933046,22.033868067276924 70.61915329284278,21.89984631653524 70.62428324626404)))"
28100007850000,2,2,0,0,"MULTIPOLYGON(((23.3698505210251 70.56247976506363,23.388372892149082 70.60683427494764,23.521805018349685 70.60061641390195,23.50299665793255 70.55627719321319,23.3698505210251 70.56247976506363)))"
28150007850000,14,7,7,63.7,"MULTIPOLYGON(((23.50299665793255 70.55627719321319,23.521805018349685 70.60061641390195,23.655149212731 70.59430142807375,23.636055457798513 70.54997772578693,23.50299665793255 70.55627719321319)))"
28200007850000,15,8,7,40.7,"MULTIPOLYGON(((23.636055457798513 70.54997772578693,23.655149212731 70.59430142807375,23.78840420023418 70.58788942748866,23.769025653642718 70.54358147210296,23.636055457798513 70.54997772578693)))"
28300007850000,7,4,3,58.7,"MULTIPOLYGON(((23.901905983871885 70.537088543018,23.921568711247673 70.58138052372006,24.05464148167323 70.57477482988085,24.034695192344998 70.53049905091929,23.901905983871885 70.537088543018)))"
28350007850000,21,12,9,64.2,"MULTIPOLYGON(((24.034695192344998 70.53049905091929,24.05464148167323 70.57477482988085,24.187621252991022 70.56807246061514,24.16739202843787 70.52381310971634,24.034695192344998 70.53049905091929)))"
28400007850000,1,1,0,0,"MULTIPOLYGON(((24.16739202843787 70.52381310971634,24.187621252991022 70.56807246061514,24.320506772324023 70.5612735320899,24.29999524710686 70.51703083483271,24.16739202843787 70.52381310971634)))"
28650007850000,1,1,0,0,"MULTIPOLYGON(((24.82944724548985 70.48894075947818,24.85108147329839 70.53311460155292,24.983477141448606 70.52583467193337,24.961563901061098 70.48167859994041,24.82944724548985 70.48894075947818)))"
28700007850000,59,30,29,55.9,"MULTIPOLYGON(((24.961563901061098 70.48167859994041,24.983477141448606 70.52583467193337,25.115771162348445 70.51845891155338,25.093579589602985 70.47432083058018,24.961563901061098 70.48167859994041)))"
28750007850000,8,4,4,43.1,"MULTIPOLYGON(((25.093579589602985 70.47432083058018,25.115771162348445 70.51845891155338,25.247962324351658 70.51098744699696,25.22549310685067 70.4668675771788,25.093579589602985 70.47432083058018)))"
29300007850000,3,2,1,0,"MULTIPOLYGON(((26.538748323924953 70.38711211371916,26.563954595288305 70.43103794678521,26.69493613254878 70.42252249958233,26.669460247796554 70.37861724394185,26.538748323924953 70.38711211371916)))"
29350007850000,1,1,0,0,"MULTIPOLYGON(((26.669460247796554 70.37861724394185,26.69493613254878 70.42252249958233,26.825800764657487 70.41391297782712,26.800056037354747 70.37002850951312,26.669460247796554 70.37861724394185)))"
29850007850000,17,8,9,41.7,"MULTIPOLYGON(((27.970009315442233 70.28853015350194,27.998137893081353 70.33221824103542,28.127772578752555 70.32267614960985,28.099383211213933 70.27901089782434,27.970009315442233 70.28853015350194)))"
29900007850000,90,53,37,40.5,"MULTIPOLYGON(((28.099383211213933 70.27901089782434,28.127772578752555 70.32267614960985,28.257278333997228 70.31304164700174,28.228629014630894 70.26939943060867,28.099383211213933 70.27901089782434)))"
27750007855000,3,2,1,0,"MULTIPOLYGON(((22.451994135461714 70.64763089493809,22.468576162949947 70.69208405730944,22.60287890467619 70.68653529310029,22.586005639400096 70.64209585639608,22.451994135461714 70.64763089493809)))"
27800007855000,1,1,0,0,"MULTIPOLYGON(((22.586005639400096 70.64209585639608,22.60287890467619 70.68653529310029,22.73710224532438 70.68088844307003,22.719938283746224 70.63646296689888,22.586005639400096 70.64209585639608)))"
28000007855000,1,1,0,0,"MULTIPOLYGON(((23.12124997136042 70.61897819037637,23.139282687670217 70.66336038227328,23.27317527626161 70.65732220121014,23.25485411456856 70.61295490274107,23.12124997136042 70.61897819037637)))"
28150007855000,256,135,121,36.3,"MULTIPOLYGON(((23.521805018349685 70.60061641390195,23.540701311482888 70.6449532316108,23.674332175449532 70.63862265984993,23.655149212731 70.59430142807375,23.521805018349685 70.60061641390195)))"
28200007855000,748,388,360,37,"MULTIPOLYGON(((23.655149212731 70.59430142807375,23.674332175449532 70.63862265984993,23.80787322423421 70.6321948439124,23.78840420023418 70.58788942748866,23.655149212731 70.59430142807375)))"
28350007855000,3,2,1,0,"MULTIPOLYGON(((24.05464148167323 70.57477482988085,24.074680771049696 70.61904793024148,24.20794473048003 70.6123290617382,24.187621252991022 70.56807246061514,24.05464148167323 70.57477482988085)))"
28700007855000,21,11,10,63.5,"MULTIPOLYGON(((24.983477141448606 70.52583467193337,25.005492030098118 70.56998754854173,25.138065595011746 70.56259371984352,25.115771162348445 70.51845891155338,24.983477141448606 70.52583467193337)))"
28950007855000,14,9,5,61.7,"MULTIPOLYGON(((25.643906632766598 70.48800011584079,25.667312230814993 70.53206044924836,25.79935596649379 70.52418829776296,25.77567436611016 70.48014712932974,25.643906632766598 70.48800011584079)))"
29900007855000,126,64,62,43.6,"MULTIPOLYGON(((28.127772578752555 70.32267614960985,28.156290877918163 70.36633613170656,28.28605763576289 70.35667849810703,28.257278333997228 70.31304164700174,28.127772578752555 70.32267614960985)))"
30700007855000,17,9,8,61.6,"MULTIPOLYGON(((30.183695920989233 70.15754555397665,30.216285133332665 70.20081207911981,30.343836851358496 70.18969519096744,30.311000884198485 70.14645486545433,30.183695920989233 70.15754555397665)))"
27900007860000,11,8,3,56.7,"MULTIPOLYGON(((22.871244865064483 70.67514360683535,22.888781009471977 70.71955279648034,23.023132490948306 70.71369558369467,23.005305449086 70.66930088562522,22.871244865064483 70.67514360683535)))"
27950007860000,3,2,1,0,"MULTIPOLYGON(((23.005305449086 70.66930088562522,23.023132490948306 70.71369558369467,23.15740005484517 70.70774035491505,23.139282687670217 70.66336038227328,23.005305449086 70.66930088562522)))"
28000007860000,5,3,2,68.6,"MULTIPOLYGON(((23.139282687670217 70.66336038227328,23.15740005484517 70.70774035491505,23.291582388153152 70.70168721525427,23.27317527626161 70.65732220121014,23.139282687670217 70.66336038227328)))"
28150007860000,3701,1846,1855,42.2,"MULTIPOLYGON(((23.540701311482888 70.6449532316108,23.55968613750068 70.68928763172669,23.693604954268128 70.68294140604732,23.674332175449532 70.63862265984993,23.540701311482888 70.6449532316108)))"
28200007860000,3997,2040,1957,40,"MULTIPOLYGON(((23.674332175449532 70.63862265984993,23.693604954268128 70.68294140604732,23.82743334204119 70.6764977058455,23.80787322423421 70.6321948439124,23.674332175449532 70.63862265984993)))"
28500007860000,14,8,6,48.9,"MULTIPOLYGON(((24.474186717580327 70.59860108597174,24.495174040068573 70.64282109724104,24.62843305072428 70.63579497766645,24.60716224107566 70.59159221710313,24.474186717580327 70.59860108597174)))"
28550007860000,89,47,42,53.4,"MULTIPOLYGON(((24.60716224107566 70.59159221710313,24.62843305072428 70.63579497766645,24.76159275214725 70.62867220716188,24.740039124869224 70.58448692235591,24.60716224107566 70.59159221710313)))"
28750007860000,2,1,1,0,"MULTIPOLYGON(((25.138065595011746 70.56259371984352,25.16046358133394 70.60672523502608,25.29321365680506 70.59921711320489,25.27053560729896 70.55510396598613,25.138065595011746 70.56259371984352)))"
29000007860000,4,4,0,0,"MULTIPOLYGON(((25.79935596649379 70.52418829776296,25.823147121955593 70.56822577139522,25.95535775715485 70.56023888883612,25.931290148173083 70.51622087980897,25.79935596649379 70.52418829776296)))"
29400007860000,10,8,2,50.6,"MULTIPOLYGON(((26.851663526070006 70.45779309406983,26.87764510571555 70.5016688307537,27.00893120488197 70.49292312043572,26.9826793114741 70.44906855766013,26.851663526070006 70.45779309406983)))"
29450007860000,17,9,8,30.1,"MULTIPOLYGON(((26.9826793114741 70.44906855766013,27.00893120488197 70.49292312043572,27.14009656200305 70.48408320792736,27.11357515230776 70.44025002864672,26.9826793114741 70.44906855766013)))"
29500007860000,3,2,1,0,"MULTIPOLYGON(((27.11357515230776 70.44025002864672,27.14009656200305 70.48408320792736,27.27114005008798 70.47514924245382,27.244349928001846 70.43133765532583,27.11357515230776 70.44025002864672)))"
29750007860000,5,4,1,52.8,"MULTIPOLYGON(((27.766216212409375 70.39475273066793,27.79407301928398 70.4384758814185,27.924490504959063 70.4290739353578,27.896369098873173 70.3853734058846,27.766216212409375 70.39475273066793)))"
29850007860000,11,2,9,63,"MULTIPOLYGON(((28.02639434437244 70.37590115380512,28.054779508824055 70.41957885905313,28.184938953997865 70.40999081075486,28.156290877918163 70.36633613170656,28.02639434437244 70.37590115380512)))"
29900007860000,175,93,82,45,"MULTIPOLYGON(((28.156290877918163 70.36633613170656,28.184938953997865 70.40999081075486,28.314967770917644 70.40030994996032,28.28605763576289 70.35667849810703,28.156290877918163 70.36633613170656)))"
30700007860000,3,1,2,0,"MULTIPOLYGON(((30.216285133332665 70.20081207911981,30.24902013057329 70.24407168628058,30.376819539187053 70.23292849257864,30.343836851358496 70.18969519096744,30.216285133332665 70.20081207911981)))"
27950007865000,2,2,0,0,"MULTIPOLYGON(((23.023132490948306 70.71369558369467,23.041043451260393 70.75808811375674,23.17560265349119 70.75211809489448,23.15740005484517 70.70774035491505,23.023132490948306 70.71369558369467)))"
28000007865000,5,2,3,57,"MULTIPOLYGON(((23.15740005484517 70.70774035491505,23.17560265349119 70.75211809489448,23.31007603924388 70.74604993102437,23.291582388153152 70.70168721525427,23.15740005484517 70.70774035491505)))"
28050007865000,5,2,3,56.8,"MULTIPOLYGON(((23.291582388153152 70.70168721525427,23.31007603924388 70.74604993102437,23.444462292336862 70.73988372955603,23.425678183155906 70.69553627142402,23.291582388153152 70.70168721525427)))"
28150007865000,557,272,285,36,"MULTIPOLYGON(((23.55968613750068 70.68928763172669,23.5787601020129 70.73361959949942,23.712968163009545 70.72725765145671,23.693604954268128 70.68294140604732,23.55968613750068 70.68928763172669)))"
28200007865000,794,400,394,33.1,"MULTIPOLYGON(((23.693604954268128 70.68294140604732,23.712968163009545 70.72725765145671,23.84708517562881 70.72079799761393,23.82743334204119 70.6764977058455,23.693604954268128 70.68294140604732)))"
28400007865000,6,6,0,59.7,"MULTIPOLYGON(((24.228363101182868 70.65658289614228,24.248877011147766 70.7008339467266,24.38261694695644 70.69398462292546,24.36181697122075 70.64975044364253,24.228363101182868 70.65658289614228)))"
28550007865000,4,2,2,0,"MULTIPOLYGON(((24.62843305072428 70.63579497766645,24.649803170609594 70.67999473260602,24.783246934689227 70.67285441063017,24.76159275214725 70.62867220716188,24.62843305072428 70.63579497766645)))"
29000007865000,2,1,1,0,"MULTIPOLYGON(((25.823147121955593 70.56822577139522,25.847048568879664 70.61225952696044,25.97953684576258 70.6042530964358,25.95535775715485 70.56023888883612,25.823147121955593 70.56822577139522)))"
29400007865000,3,3,0,0,"MULTIPOLYGON(((26.87764510571555 70.5016688307537,26.903746294585247 70.54554016014278,27.035303841499765 70.53677318626367,27.00893120488197 70.49292312043572,26.87764510571555 70.5016688307537)))"
29450007865000,4,2,2,0,"MULTIPOLYGON(((27.00893120488197 70.49292312043572,27.035303841499765 70.53677318626367,27.166739841906516 70.52791179985573,27.14009656200305 70.48408320792736,27.00893120488197 70.49292312043572)))"
29750007865000,11,5,6,51.6,"MULTIPOLYGON(((27.79407301928398 70.4384758814185,27.82205722501423 70.48219398179222,27.95274039406844 70.47276931970481,27.924490504959063 70.4290739353578,27.79407301928398 70.4384758814185)))"
29800007865000,22,13,9,57.6,"MULTIPOLYGON(((27.924490504959063 70.4290739353578,27.95274039406844 70.47276931970481,28.0832942331866 70.4632513237295,28.054779508824055 70.41957885905313,27.924490504959063 70.4290739353578)))"
29850007865000,5,2,3,63.4,"MULTIPOLYGON(((28.054779508824055 70.41957885905313,28.0832942331866 70.4632513237295,28.213717659557506 70.45364015309808,28.184938953997865 70.40999081075486,28.054779508824055 70.41957885905313)))"
29900007865000,129,69,60,45.3,"MULTIPOLYGON(((28.184938953997865 70.40999081075486,28.213717659557506 70.45364015309808,28.34400959776585 70.44393596829524,28.314967770917644 70.40030994996032,28.184938953997865 70.40999081075486)))"
30000007865000,34,21,13,49.8,"MULTIPOLYGON(((28.44486489737589 70.390536437403,28.474168979829507 70.43413893104766,28.60419474523587 70.42424920431316,28.574629278556554 70.38067043504185,28.44486489737589 70.390536437403)))"
30750007865000,2,2,0,0,"MULTIPOLYGON(((30.376819539187053 70.23292849257864,30.40994988722135 70.27615472593455,30.53784932042027 70.26489501520759,30.50447128890181 70.22169537805502,30.376819539187053 70.23292849257864)))"
27950007870000,6,4,2,31,"MULTIPOLYGON(((23.041043451260393 70.75808811375674,23.059038907396122 70.80247846271753,23.193891069507522 70.79649358867785,23.17560265349119 70.75211809489448,23.041043451260393 70.75808811375674)))"
28050007870000,1,1,0,0,"MULTIPOLYGON(((23.31007603924388 70.74604993102437,23.32865682389839 70.79041033454082,23.463334845850586 70.78422880842027,23.444462292336862 70.73988372955603,23.31007603924388 70.74604993102437)))"
28200007870000,18,11,7,41.6,"MULTIPOLYGON(((23.712968163009545 70.72725765145671,23.732422421067238 70.77157138072603,23.866829352608796 70.7650957033969,23.84708517562881 70.72079799761393,23.712968163009545 70.72725765145671)))"
28500007870000,13,8,5,64.2,"MULTIPOLYGON(((24.51625942174253 70.68703817771538,24.537443530340187 70.73125230914788,24.671273276297477 70.72419146317378,24.649803170609594 70.67999473260602,24.51625942174253 70.68703817771538)))"
29400007870000,108,56,52,43.3,"MULTIPOLYGON(((26.903746294585247 70.54554016014278,26.92996789061225 70.5894070542499,27.06179802580247 70.58061872657554,27.035303841499765 70.53677318626367,26.903746294585247 70.54554016014278)))"
29800007870000,14,9,5,53.4,"MULTIPOLYGON(((27.95274039406844 70.47276931970481,27.981119614340148 70.51645952618881,28.11193937152906 70.50691851448879,28.0832942331866 70.4632513237295,27.95274039406844 70.47276931970481)))"
29900007870000,32,17,15,41.6,"MULTIPOLYGON(((28.213717659557506 70.45364015309808,28.242627854518595 70.4972841247792,28.37318398200368 70.48755651854023,28.34400959776585 70.44393596829524,28.213717659557506 70.45364015309808)))"
29950007870000,17,10,7,63.2,"MULTIPOLYGON(((28.34400959776585 70.44393596829524,28.37318398200368 70.48755651854023,28.50360668019126 70.4777358585,28.474168979829507 70.43413893104766,28.34400959776585 70.44393596829524)))"
30000007870000,121,76,45,44,"MULTIPOLYGON(((28.474168979829507 70.43413893104766,28.50360668019126 70.4777358585,28.633894882836792 70.46782230862347,28.60419474523587 70.42424920431316,28.474168979829507 70.43413893104766)))"
30050007870000,9,4,5,49.2,"MULTIPOLYGON(((28.60419474523587 70.42424920431316,28.633894882836792 70.46782230862347,28.764047531279818 70.45781603410147,28.734085840977162 70.41426695226971,28.60419474523587 70.42424920431316)))"
30900007870000,8,6,2,64.3,"MULTIPOLYGON(((30.79319862857566 70.2421060046395,30.827220561622973 70.28524446357939,30.95491431482015 70.27368827781164,30.920646653674858 70.23057707019696,30.79319862857566 70.2421060046395)))"
28000007875000,13,6,7,30.8,"MULTIPOLYGON(((23.193891069507522 70.79649358867785,23.21226589414675 70.84086682260322,23.347325341905893 70.83476841169184,23.32865682389839 70.79041033454082,23.193891069507522 70.79649358867785)))"
28050007875000,77,36,41,41.7,"MULTIPOLYGON(((23.32865682389839 70.79041033454082,23.347325341905893 70.83476841169184,23.482296451961393 70.82857149344935,23.463334845850586 70.78422880842027,23.32865682389839 70.79041033454082)))"
28450007875000,6,2,4,78.5,"MULTIPOLYGON(((24.4035143847088 70.73821592759938,24.42450995028607 70.78244433974768,24.55872703962793 70.77546347312169,24.537443530340187 70.73125230914788,24.4035143847088 70.73821592759938)))"
29250007875000,14,9,5,53.8,"MULTIPOLYGON(((26.53375484333663 70.61520280470141,26.559271600035274 70.65912828858889,26.6917380496277 70.6506039215159,26.665945141656046 70.60669924103688,26.53375484333663 70.61520280470141)))"
29500007875000,25,15,10,47,"MULTIPOLYGON(((27.193505802959564 70.57173577527826,27.22039526321175 70.61555510477773,27.35225163387221 70.60655581359482,27.325090082114986 70.56275835146484,27.193505802959564 70.57173577527826)))"
29950007875000,7,5,2,65.3,"MULTIPOLYGON(((28.37318398200368 70.48755651854023,28.40249179679715 70.5311715658151,28.53317887735911 70.52132718425737,28.50360668019126 70.4777358585,28.37318398200368 70.48755651854023)))"
30950007875000,194,101,93,52.6,"MULTIPOLYGON(((30.95491431482015 70.27368827781164,30.989335255857874 70.31679189049234,31.11712139511032 70.30511860823185,31.082454789470727 70.26204253763794,30.95491431482015 70.27368827781164)))"
28450007880000,1,0,1,0,"MULTIPOLYGON(((24.42450995028607 70.78244433974768,24.445604315528055 70.82666984128619,24.580110629467857 70.81967165104791,24.55872703962793 70.77546347312169,24.42450995028607 70.78244433974768)))"
28500007880000,16,9,7,67.8,"MULTIPOLYGON(((24.55872703962793 70.77546347312169,24.580110629467857 70.81967165104791,24.71451617786797 70.81257577532796,24.6928440494449 70.76838515044737,24.55872703962793 70.77546347312169)))"
28850007880000,4,1,3,0,"MULTIPOLYGON(((25.495373493860335 70.72387572353254,25.518762003401438 70.76795625805781,25.65242663364116 70.7601801819979,25.628754608163145 70.71611878336088,25.495373493860335 70.72387572353254)))"
28900007880000,18,12,6,53.2,"MULTIPOLYGON(((25.628754608163145 70.71611878336088,25.65242663364116 70.7601801819979,25.785980416329174 70.75230746660641,25.762025623081787 70.70826542656256,25.628754608163145 70.71611878336088)))"
29200007880000,12,10,2,56.9,"MULTIPOLYGON(((26.426686631539553 70.66755722556908,26.45204378323168 70.71149916310556,26.584906876807874 70.70304955003198,26.559271600035274 70.65912828858889,26.426686631539553 70.66755722556908)))"
29250007880000,12,9,3,60.4,"MULTIPOLYGON(((26.559271600035274 70.65912828858889,26.584906876807874 70.70304955003198,26.717650652788922 70.69450429047606,26.6917380496277 70.6506039215159,26.559271600035274 70.65912828858889)))"
29600007880000,3,2,1,0,"MULTIPOLYGON(((27.483982542046512 70.59746199239576,27.511541949275838 70.64123251500267,27.64341780932363 70.63202193781837,27.61558685577842 70.5882737959113,27.483982542046512 70.59746199239576)))"
30900007885000,2,1,1,0,"MULTIPOLYGON(((30.895722492308202 70.37149887909877,30.930204451019844 70.41461474023995,31.058640908544096 70.40297613791778,31.02391045748233 70.35988786006007,30.895722492308202 70.37149887909877)))"
30950007885000,1727,888,839,45.8,"MULTIPOLYGON(((31.02391045748233 70.35988786006007,31.058640908544096 70.40297613791778,31.186921120928893 70.39124743733385,31.15194317459218 70.34818692455369,31.02391045748233 70.35988786006007)))"
29700007890000,21,11,10,55.7,"MULTIPOLYGON(((27.803396442165667 70.66643740098003,27.831758347074153 70.71015275244967,27.963918968899524 70.70070759324692,27.935284989368704 70.65701523254566,27.803396442165667 70.66643740098003)))"
28250007895000,2,2,0,0,"MULTIPOLYGON(((23.9467422475952 70.94226034502279,23.96695775753402 70.98654487830699,24.102737757203048 70.9798890241276,24.082226395077093 70.93562110694832,23.9467422475952 70.94226034502279)))"
28900007895000,5,4,1,71,"MULTIPOLYGON(((25.700103985517128 70.84829202211523,25.724110828519525 70.89234241691248,25.858520328353713 70.88441112010211,25.834227003134444 70.840380337279,25.700103985517128 70.84829202211523)))"
29750007895000,7,2,5,71.6,"MULTIPOLYGON(((27.963918968899524 70.70070759324692,27.9926855114325 70.74439470639115,28.12498588746846 70.73483172414657,28.095947029009302 70.6911679084172,27.963918968899524 70.70070759324692)))"
30550007895000,1,0,1,0,"MULTIPOLYGON(((30.059717079560876 70.53684338931744,30.092730162463564 70.58013338590962,30.222747498214062 70.56907781109894,30.189477087273655 70.5258143110736,30.059717079560876 70.53684338931744)))"
28200007900000,45,23,22,43.7,"MULTIPOLYGON(((23.83108152780612 70.99310173745224,23.851095409005424 71.03740003928696,23.987269498548443 71.0308267275009,23.96695775753402 70.98654487830699,23.83108152780612 70.99310173745224)))"
28250007900000,16,9,7,50.8,"MULTIPOLYGON(((23.96695775753402 70.98654487830699,23.987269498548443 71.0308267275009,24.123346689140554 71.024154183504,24.102737757203048 70.9798890241276,23.96695775753402 70.98654487830699)))"
28300007900000,25,15,10,36.9,"MULTIPOLYGON(((24.102737757203048 70.9798890241276,24.123346689140554 71.024154183504,24.25932563341917 71.01738252802902,24.238420188089123 70.97313429485403,24.102737757203048 70.9798890241276)))"
28450007900000,208,107,101,50.6,"MULTIPOLYGON(((24.509487019544085 70.95932869884825,24.530983424866363 71.00354237368803,24.66665960880237 70.9964741243716,24.644868773802518 70.9522780800322,24.509487019544085 70.95932869884825)))"
28500007900000,103,68,35,39,"MULTIPOLYGON(((24.644868773802518 70.9522780800322,24.66665960880237 70.9964741243716,24.802232220098674 70.9893072626572,24.780147666794722 70.94512908193546,24.644868773802518 70.9522780800322)))"
28900007900000,2,1,1,0,"MULTIPOLYGON(((25.724110828519525 70.89234241691248,25.74823080537363 70.93638909671813,25.88292804072697 70.92843810234251,25.858520328353713 70.88441112010211,25.724110828519525 70.89234241691248)))"
30350007900000,1116,573,543,41.4,"MULTIPOLYGON(((29.57116571566914 70.62343425740643,29.603286215127103 70.66682179494735,29.734161800960546 70.65610932371804,29.70177906490898 70.61274761597122,29.57116571566914 70.62343425740643)))"
30400007900000,994,522,472,42.6,"MULTIPOLYGON(((29.70177906490898 70.61274761597122,29.734161800960546 70.65610932371804,29.864888938472387 70.64530415226989,29.832244935940498 70.60196847005594,29.70177906490898 70.61274761597122)))"
30750007900000,1,1,0,0,"MULTIPOLYGON(((30.61188645183968 70.5353611598457,30.646077397100786 70.57853664062871,30.775737097180386 70.56708770217061,30.74129181630521 70.5239395858575,30.61188645183968 70.5353611598457)))"
28250007905000,4,4,0,0,"MULTIPOLYGON(((23.987269498548443 71.0308267275009,24.007678139542165 71.07510587570735,24.14405386843193 71.06841656767543,24.123346689140554 71.024154183504,23.987269498548443 71.0308267275009)))"
28450007905000,494,264,230,45.8,"MULTIPOLYGON(((24.530983424866363 71.00354237368803,24.55258208193067 71.04775304491645,24.688554017528595 71.04066708707047,24.66665960880237 70.9964741243716,24.530983424866363 71.00354237368803)))"
28500007905000,116,65,51,49.8,"MULTIPOLYGON(((24.66665960880237 70.9964741243716,24.688554017528595 71.04066708707047,24.82442166259335 71.03348228277467,24.802232220098674 70.9893072626572,24.66665960880237 70.9964741243716)))"
28600007905000,44,28,16,58.3,"MULTIPOLYGON(((24.9376999433021 70.98204191730451,24.960183693325114 71.0261987616362,25.095838792585656 71.01881665484791,25.073061469546328 70.97467821864976,24.9376999433021 70.98204191730451)))"
28850007905000,2,1,1,0,"MULTIPOLYGON(((25.613419661814405 70.9442425523574,25.63736376901026 70.98830504999219,25.77246469160499 70.9804320376441,25.74823080537363 70.93638909671813,25.613419661814405 70.9442425523574)))"
28900007905000,11,8,3,60.5,"MULTIPOLYGON(((25.74823080537363 70.93638909671813,25.77246469160499 70.9804320376441,25.90745092345324 70.97246125953848,25.88292804072697 70.92843810234251,25.74823080537363 70.93638909671813)))"
29650007905000,2,2,0,0,"MULTIPOLYGON(((27.756035975508215 70.80696429933315,27.784518458597283 70.85068717567023,27.917636200043184 70.84126777450942,27.888877341226586 70.79756797264399,27.756035975508215 70.80696429933315)))"
29700007905000,10,5,5,65.4,"MULTIPOLYGON(((27.888877341226586 70.79756797264399,27.917636200043184 70.84126777450942,28.050619842250015 70.83175305405581,28.021585504203248 70.78807653806722,27.888877341226586 70.79756797264399)))"
29750007905000,74,38,36,43.4,"MULTIPOLYGON(((28.021585504203248 70.78807653806722,28.050619842250015 70.83175305405581,28.183468237584485 70.82214317905641,28.154159323218355 70.77849015931325,28.021585504203248 70.78807653806722)))"
30200007905000,32,17,15,58.5,"MULTIPOLYGON(((29.209779167289245 70.6984012138631,29.24125144606451 70.74185881682656,29.372832304478184 70.73140017925047,29.341093850036696 70.68796791818413,29.209779167289245 70.6984012138631)))"
28250007910000,23,15,8,51.1,"MULTIPOLYGON(((24.007678139542165 71.07510587570735,24.02818435558924 71.1193823058681,24.164859978861735 71.1126761590743,24.14405386843193 71.06841656767543,24.007678139542165 71.07510587570735)))"
28850007910000,2,1,1,0,"MULTIPOLYGON(((25.63736376901026 70.98830504999219,25.661421292322117 71.03236387050181,25.796813269767288 71.02447121557908,25.77246469160499 70.9804320376441,25.63736376901026 70.98830504999219)))"
28950007910000,2642,1406,1236,44.1,"MULTIPOLYGON(((25.90745092345324 70.97246125953848,25.932089766818603 71.01648056700003,26.067249506986084 71.0083920676993,26.042321195856744 70.96439285768396,25.90745092345324 70.97246125953848)))"
29400007910000,67,35,32,38.7,"MULTIPOLYGON(((27.11695898255421 70.89634872013661,27.14417341970406 70.94017909337428,27.278226120445712 70.93121661550703,27.25072972970352 70.8874083394646,27.11695898255421 70.89634872013661)))"
29450007910000,8,5,3,49.8,"MULTIPOLYGON(((27.25072972970352 70.8874083394646,27.278226120445712 70.93121661550703,27.41214970731179 70.92215779761608,27.384372233839468 70.87837183604236,27.25072972970352 70.8874083394646)))"
29500007910000,1,0,1,0,"MULTIPOLYGON(((27.384372233839468 70.87837183604236,27.41214970731179 70.92215779761608,27.54594298658237 70.91300279866232,27.517885308125617 70.86923936781943,27.384372233839468 70.87837183604236)))"
29950007910000,2,1,1,0,"MULTIPOLYGON(((28.581190585843107 70.79274429405554,28.611457507485607 70.83631981725058,28.744025608675063 70.82630656740406,28.71348667740154 70.78275547466387,28.581190585843107 70.79274429405554)))"
28900007915000,80,48,32,47.8,"MULTIPOLYGON(((25.796813269767288 71.02447121557908,25.821277329521173 71.06850660618603,25.956845368275573 71.06049599980649,25.932089766818603 71.01648056700003,25.796813269767288 71.02447121557908)))"
29400007915000,18,9,9,35,"MULTIPOLYGON(((27.14417341970406 70.94017909337428,27.171515770512674 70.98400476767091,27.305851626361278 70.97502009691567,27.278226120445712 70.93121661550703,27.14417341970406 70.94017909337428)))"
29450007915000,887,485,402,44.8,"MULTIPOLYGON(((27.278226120445712 70.93121661550703,27.305851626361278 70.97502009691567,27.440057489685376 70.96593886807366,27.41214970731179 70.92215779761608,27.278226120445712 70.93121661550703)))"
29500007915000,3,2,1,0,"MULTIPOLYGON(((27.41214970731179 70.92215779761608,27.440057489685376 70.96593886807366,27.574132159833596 70.95676124112593,27.54594298658237 70.91300279866232,27.41214970731179 70.92215779761608)))"
28700007920000,96,57,39,54.6,"MULTIPOLYGON(((25.277855354281254 71.0995653916726,25.30125642758841 71.14367484727335,25.437577791010742 71.13603885701693,25.413880723532838 71.09194852289103,25.277855354281254 71.0995653916726)))"
28850007920000,54,30,24,59.1,"MULTIPOLYGON(((25.685593013539 71.0764189901281,25.70987972157569 71.12047038488981,25.845857667714093 71.11253818489973,25.821277329521173 71.06850660618603,25.685593013539 71.0764189901281)))"
29450007920000,1,1,0,0,"MULTIPOLYGON(((27.305851626361278 70.97502009691567,27.333607126113392 71.01881875239953,27.468096466554975 71.00971501548766,27.440057489685376 70.96593886807366,27.305851626361278 70.97502009691567)))"
30100007920000,871,465,406,46,"MULTIPOLYGON(((29.039959415279494 70.84949219874615,29.071328516069233 70.89298155992721,29.20400949463341 70.88263487370156,29.17236904465477 70.83917076962217,29.039959415279494 70.84949219874615)))"
28850007925000,13,10,3,38.5,"MULTIPOLYGON(((25.70987972157569 71.12047038488981,25.734282212553023 71.16451803057987,25.870555088461032 71.15656592692395,25.845857667714093 71.11253818489973,25.70987972157569 71.12047038488981)))"
29450007925000,1,1,0,0,"MULTIPOLYGON(((27.333607126113392 71.01881875239953,27.361493506237817 71.06261255037815,27.496267531436228 71.05348620763569,27.468096466554975 71.00971501548766,27.333607126113392 71.01881875239953)))"
29600007925000,8,5,3,71.6,"MULTIPOLYGON(((27.736677687783548 70.99121785627742,27.765415410711135 71.03494318196104,27.899786859803857 71.02552682734492,27.87076717737875 70.98182476019805,27.736677687783548 70.99121785627742)))"
29600007930000,700,366,334,44.5,"MULTIPOLYGON(((27.765415410711135 71.03494318196104,27.794288528173652 71.07866332067408,27.92894312700081 71.06922360676344,27.899786859803857 71.02552682734492,27.765415410711135 71.03494318196104)))"
29750007935000,228,137,91,45.9,"MULTIPOLYGON(((28.197838594846214 71.05005467899495,28.227698248046092 71.09369856455191,28.362218258715895 71.08394558101473,28.33207709481362 71.04032580389573,28.197838594846214 71.05005467899495)))"
